gene-chr,gene-start,gene-end,mRNA-start,mRNA-end,gene-ID,Genbank,Product,mRNALength
NC_035780.1,10785536,10814686,10785536,10814002,111111942,XM_022449155.1,very-long-chain (3R)-3-hydroxyacyl-CoA dehydratase 2-like,28466
NC_035782.1,64715621,64739616,64715621,64739616,111124377,XM_022467228.1,ATP-dependent (S)-NAD(P)H-hydrate dehydratase-like,23995
NC_035783.1,51347620,51350342,51347620,51350110,111127924,XM_022473254.1,tRNA (adenine(37)-N6)-methyltransferase-like,2490
NC_035783.1,51347620,51350342,51347620,51350342,111127924,XM_022473255.1,tRNA (adenine(37)-N6)-methyltransferase-like,2722
NC_035783.1,51314301,51320640,51316252,51320639,111130188,XM_022476954.1,tRNA (adenine(37)-N6)-methyltransferase-like,4387
NC_035783.1,51314301,51320640,51314301,51320640,111130188,XM_022476955.1,tRNA (adenine(37)-N6)-methyltransferase-like,6339
NC_035783.1,11164297,11167516,11164297,11167516,111128289,XM_022473839.1,tRNA (adenine(58)-N(1))-methyltransferase catalytic subunit TRMT61A-like,3219
NC_035784.1,25482674,25504010,25482674,25504010,111135283,XM_022485212.1,tRNA (cytosine(34)-C(5))-methyltransferase-like,21336
NC_035780.1,56436752,56446529,56436752,56446529,111127566,XM_022472789.1,tRNA (cytosine(38)-C(5))-methyltransferase-like,9777
NC_035780.1,56622111,56631929,56622111,56631929,111125611,XM_022470002.1,tRNA (cytosine(38)-C(5))-methyltransferase-like,9818
NC_035781.1,3122488,3133722,3122488,3133722,111122163,XM_022463766.1,DNA (cytosine-5)-methyltransferase 3C-like,11234
NC_035780.1,8684142,8692057,8684142,8692057,111100372,XM_022432152.1,tRNA (guanine(10)-N2)-methyltransferase homolog,7915
NC_035783.1,34417618,34423570,34417618,34423570,111128379,XM_022473965.1,tRNA (guanine(26)-N(2))-dimethyltransferase-like,5952
NC_035783.1,44110506,44116480,44110506,44116480,111127752,XM_022472993.1,tRNA (guanine(26)-N(2))-dimethyltransferase-like,5974
NC_035783.1,50922691,50925615,50922691,50925615,111129736,XM_022476206.1,tRNA (guanine(37)-N1)-methyltransferase-like,2924
NC_035780.1,51144663,51183634,51144663,51183634,111104489,XM_022438475.1,tRNA (guanine-N(7)-)-methyltransferase non-catalytic subunit wdr4-like,38971
NC_035780.1,7540759,7549675,7540759,7549675,111110900,XM_022447566.1,tRNA (guanine-N(7)-)-methyltransferase-like,8916
NC_035784.1,9998359,10021473,9998359,10021473,111099097,XM_022430457.1,tRNA (uracil-5-)-methyltransferase homolog A-like,23114
NC_035780.1,34853203,34863530,34853203,34863530,111105084,XM_022439259.1,meiosis 1 arrest protein-like,10327
NC_035785.1,10787787,10804941,10787787,10804941,111100575,XM_022432595.1,mannosyl-oligosaccharide 1,17154
NC_035785.1,8493439,8520448,8493439,8520448,111100720,XM_022432802.1,mannosyl-oligosaccharide 1,27009
NC_035784.1,25774492,25810087,25774492,25810087,111138392,XM_022490327.1,inositol 1,35595
NC_035788.1,1734289,1737909,1734289,1737909,111115928,XM_022454852.1,lysozyme 1,3620
NC_035784.1,54814110,54876292,54839605,54876292,111135721,XM_022486026.1,inositol 1,36687
NC_035780.1,55032924,55036714,55032924,55036714,111121154,XM_022462304.1,lipoyltransferase 1,3790
NC_035784.1,54814110,54876292,54831576,54876292,111135721,XM_022486020.1,inositol 1,44716
NC_035784.1,54814110,54876292,54831012,54876292,111135721,XM_022486022.1,inositol 1,45280
NC_035787.1,57627809,57632495,57627809,57632495,111105834,XM_022440260.1,ruvB-like 1,4686
NC_035784.1,79618719,79666955,79618719,79666955,111132623,XM_022480451.1,inositol 1,48236
NC_035784.1,54814110,54876292,54824712,54876292,111135721,XM_022486025.1,inositol 1,51580
NC_035784.1,54814110,54876292,54820541,54876292,111135721,XM_022486024.1,inositol 1,55751
NC_035784.1,54814110,54876292,54814110,54876292,111135721,XM_022486021.1,inositol 1,62182
NC_035787.1,56224028,56287563,56224286,56287560,111106119,XM_022440664.1,inositol 1,63274
NC_035787.1,56224028,56287563,56224286,56287563,111106119,XM_022440662.1,inositol 1,63277
NC_035787.1,56224028,56287563,56224028,56287558,111106119,XM_022440663.1,inositol 1,63530
NC_035787.1,56224028,56287563,56224028,56287560,111106119,XM_022440665.1,inositol 1,63532
NC_035787.1,56224028,56287563,56224028,56287561,111106119,XM_022440652.1,inositol 1,63533
NC_035787.1,56224028,56287563,56224028,56287562,111106119,XM_022440658.1,inositol 1,63534
NC_035785.1,6101716,6108407,6101716,6108407,111101219,XM_022433623.1,xylan 1,6691
NC_035784.1,93352400,93443037,93352400,93443037,111138112,XM_022489925.1,inositol 1,90637
NC_035783.1,10905610,10913182,10905610,10913182,111127926,XM_022473256.1,beclin 1-associated autophagy-related key regulator-like,7572
NC_035787.1,72549047,72562884,72549047,72560597,111110098,XM_022446455.1,glucose-6-phosphate 1-dehydrogenase-like,11550
NC_035787.1,72549047,72562884,72549047,72562884,111110098,XM_022446456.1,glucose-6-phosphate 1-dehydrogenase-like,13837
NC_035784.1,3827756,3843035,3827757,3839852,111135159,XM_022484956.1,aldose 1-epimerase-like,12095
NC_035784.1,3827756,3843035,3827756,3842988,111135159,XM_022484954.1,aldose 1-epimerase-like,15232
NC_035784.1,3827756,3843035,3827756,3843035,111135159,XM_022484955.1,aldose 1-epimerase-like,15279
NC_035783.1,20166623,20169705,20166623,20169705,111131530,XM_022479119.1,aldose 1-epimerase-like,3082
NC_035783.1,20266444,20270276,20266444,20270276,111129194,XM_022475438.1,aldose 1-epimerase-like,3832
NC_035783.1,9707517,9714488,9710570,9714488,111128136,XM_022473601.1,aldose 1-epimerase-like,3918
NC_035783.1,20161415,20166025,20161415,20166025,111131531,XM_022479120.1,aldose 1-epimerase-like,4610
NC_035783.1,18094773,18105195,18094773,18105195,111130239,XM_022477026.1,inositol-tetrakisphosphate 1-kinase-like,10422
NC_035782.1,62480586,62490790,62480586,62490790,111125632,XM_022469620.1,dolichyldiphosphatase 1-like,10204
NC_035782.1,53543303,53553519,53543303,53553519,111126728,XM_022471562.1,gamma-glutamyltranspeptidase 1-like,10216
NC_035782.1,37147484,37158662,37148209,37158662,111126043,XM_022470424.1,beta-secretase 1-like,10453
NC_035783.1,9336967,9347862,9336967,9347862,111130347,XM_022477311.1,stress-induced-phosphoprotein 1-like,10895
NC_035788.1,63324331,63335268,63324331,63335268,111115621,XM_022454432.1,dipeptidase 1-like,10937
NC_035782.1,37147484,37158662,37147582,37158662,111126043,XM_022470426.1,beta-secretase 1-like,11080
NC_035782.1,37147484,37158662,37147484,37158662,111126043,XM_022470423.1,beta-secretase 1-like,11178
NC_035780.1,485479,500367,485859,500367,111102064,XM_022434725.1,gamma-glutamyltranspeptidase 1-like,14508
NC_035780.1,485479,500367,485479,500367,111102064,XM_022434719.1,gamma-glutamyltranspeptidase 1-like,14888
NC_035788.1,917917,932951,917917,932951,111115801,XM_022454661.1,dipeptidase 1-like,15034
NC_035780.1,28330675,28345941,28330675,28345941,111100381,XM_022432175.1,choline/ethanolaminephosphotransferase 1-like,15266
NC_035788.1,63119897,63299088,63119897,63299088,111113278,XM_022451404.1,dipeptidase 1-like,179191
NC_035788.1,2216060,2235464,2216060,2235464,111114591,XM_022452962.1,dipeptidase 1-like,19404
NC_035788.1,1528678,1532236,1528678,1532236,111113118,XM_022451105.1,lysozyme 1-like,3558
NC_035788.1,1450492,1454139,1450492,1454139,111111303,XM_022448192.1,lysozyme 1-like,3647
NC_035788.1,1770088,1773753,1770088,1773753,111111273,XM_022448140.1,lysozyme 1-like,3665
NC_035783.1,41318181,41322505,41318181,41322505,111128253,XM_022473781.1,pyroglutamyl-peptidase 1-like,4324
NC_035783.1,40411568,40417413,40411568,40417185,111128158,XM_022473632.1,pyroglutamyl-peptidase 1-like,5617
NC_035781.1,29838527,29844174,29838527,29844174,111121318,XM_022462534.1,ethanolaminephosphotransferase 1-like,5647
NC_035782.1,61454055,61459755,61454055,61459755,111124675,XM_022467772.1,gamma-glutamyltranspeptidase 1-like,5700
NC_035783.1,40411568,40417413,40411569,40417413,111128158,XM_022473631.1,pyroglutamyl-peptidase 1-like,5844
NC_035786.1,43477354,43483956,43477354,43483956,111105088,XM_022439261.1,dipeptidase 1-like,6602
NC_035783.1,18544122,18551219,18544122,18551219,111128151,XM_022473622.1,exonuclease 1-like,7097
NC_035781.1,19326473,19333842,19326473,19333842,111120157,XM_022460884.1,acetylcholinesterase 1-like,7369
NC_035784.1,23136808,23144299,23136808,23144299,111137394,XM_022488839.1,metallophosphoesterase 1-like,7491
NC_035788.1,1512324,1519838,1512324,1519838,111113117,XM_022451104.1,lysozyme 1-like,7514
NC_035784.1,23344852,23352383,23344852,23352383,111133439,XM_022481866.1,metallophosphoesterase 1-like,7531
NC_035788.1,1479503,1487128,1479503,1487128,111113119,XM_022451106.1,lysozyme 1-like,7625
NC_035782.1,61443284,61452025,61443830,61452025,111124674,XM_022467771.1,gamma-glutamyltranspeptidase 1-like,8195
NC_035784.1,86956175,86956997,86956175,86956997,111138317,XM_022490216.1,lysozyme 1-like,822
NC_035782.1,61443284,61452025,61443407,61452025,111124674,XM_022467769.1,gamma-glutamyltranspeptidase 1-like,8618
NC_035782.1,61443284,61452025,61443384,61452025,111124674,XM_022467768.1,gamma-glutamyltranspeptidase 1-like,8641
NC_035782.1,36217622,36226755,36218091,36226755,111126408,XM_022471024.1,beta-secretase 1-like,8664
NC_035782.1,61443284,61452025,61443284,61452025,111124674,XM_022467767.1,gamma-glutamyltranspeptidase 1-like,8741
NC_035782.1,36217622,36226755,36217748,36226755,111126408,XM_022471026.1,beta-secretase 1-like,9007
NC_035782.1,36217622,36226755,36217623,36226755,111126408,XM_022471022.1,beta-secretase 1-like,9132
NC_035782.1,36217622,36226755,36217622,36226755,111126408,XM_022471023.1,beta-secretase 1-like,9133
NC_035782.1,62480586,62490790,62481109,62490790,111125632,XM_022469619.1,dolichyldiphosphatase 1-like,9681
NC_035782.1,37147484,37158662,37148959,37158662,111126043,XM_022470427.1,beta-secretase 1-like,9703
NC_035784.1,18840484,18850254,18840484,18850254,111136420,XM_022487258.1,gamma-glutamyltranspeptidase 1-like,9770
NC_035781.1,6544669,6551586,6544669,6551586,111121638,XM_022462996.1,sphingosine 1-phosphate receptor 2-like,6917
NC_035787.1,63000080,63018077,63000080,63018077,111108616,XM_022444604.1,cytosolic 10-formyltetrahydrofolate dehydrogenase-like,17997
NC_035787.1,73793289,73798485,73793289,73798485,111108509,XM_022444456.1,N-alpha-acetyltransferase 11-like,5196
NC_035787.1,3142656,3150509,3142656,3150507,111106051,XM_022440574.1,N-alpha-acetyltransferase 11-like,7851
NC_035787.1,3142656,3150509,3142656,3150509,111106051,XM_022440573.1,N-alpha-acetyltransferase 11-like,7853
NC_035786.1,25664196,25674966,25664196,25674966,111104958,XM_022439136.1,arachidonate 12-lipoxygenase,10770
NC_035786.1,25706233,25723640,25706233,25723640,111104170,XM_022437977.1,arachidonate 12-lipoxygenase,17407
NC_035786.1,24975708,24995990,24975708,24995990,111104956,XM_022439133.1,arachidonate 12-lipoxygenase,20282
NC_035784.1,18735490,18755756,18735490,18755756,111136008,XM_022486557.1,dynamin-like 120 kDa protein,20266
NC_035784.1,27745041,27754283,27745041,27754283,111135672,XM_022485941.1,all-trans-retinol 13,9242
NC_035784.1,57683252,57689516,57683252,57689516,111134018,XM_022482782.1,endoglucanase 14-like,6264
NC_035782.1,62610328,62626338,62610328,62626338,111124991,XM_022468368.1,N-alpha-acetyltransferase 15,16010
NC_035784.1,75925610,75936108,75925610,75936108,111137567,XM_022489065.1,steroid 17-alpha-hydroxylase/17,10498
NC_035780.1,33931729,33945324,33934356,33945322,111131167,XM_022478575.1,steroid 17-alpha-hydroxylase/17,10966
NC_035780.1,33931729,33945324,33934356,33945324,111131167,XM_022478582.1,steroid 17-alpha-hydroxylase/17,10968
NC_035784.1,75947701,75961383,75948945,75961373,111135493,XM_022485611.1,steroid 17-alpha-hydroxylase/17,12428
NC_035780.1,33931729,33945324,33931729,33944235,111131167,XM_022478591.1,steroid 17-alpha-hydroxylase/17,12506
NC_035784.1,75947701,75961383,75947701,75961383,111135493,XM_022485612.1,steroid 17-alpha-hydroxylase/17,13682
NC_035784.1,40304228,40321856,40304228,40321856,111135711,XM_022486009.1,steroid 17-alpha-hydroxylase/17,17628
NC_035784.1,40304228,40321856,40304231,40308032,111135711,XM_022486008.1,steroid 17-alpha-hydroxylase/17,3801
NC_035787.1,28747950,28753438,28747950,28752330,111107266,XM_022442379.1,steroid 17-alpha-hydroxylase/17,4380
NC_035785.1,37296232,37301039,37296232,37301039,111100281,XM_022431975.1,steroid 17-alpha-hydroxylase/17,4807
NC_035784.1,72405593,72410698,72405593,72410698,111135334,XM_022485299.1,steroid 17-alpha-hydroxylase/17,5105
NC_035787.1,28747950,28753438,28747950,28753247,111107266,XM_022442380.1,steroid 17-alpha-hydroxylase/17,5297
NC_035787.1,28747950,28753438,28747950,28753438,111107266,XM_022442377.1,steroid 17-alpha-hydroxylase/17,5488
NC_035785.1,37288141,37294679,37288141,37294679,111100280,XM_022431974.1,steroid 17-alpha-hydroxylase/17,6538
NC_035784.1,75925610,75936108,75925610,75933888,111137567,XM_022489066.1,steroid 17-alpha-hydroxylase/17,8278
NC_035785.1,5386745,5395631,5386745,5395631,111101403,XM_022433876.1,steroid 17-alpha-hydroxylase/17,8886
NC_035785.1,146489,155405,146489,155405,111101451,XM_022433939.1,steroid 17-alpha-hydroxylase/17,8916
NC_035784.1,75925610,75936108,75925610,75934577,111137567,XM_022489064.1,steroid 17-alpha-hydroxylase/17,8967
NC_035780.1,22618227,22630886,22618227,22630886,111099826,XM_022431293.1,estradiol 17-beta-dehydrogenase 11-like,12659
NC_035781.1,34122098,34123369,34122098,34123369,111119445,XM_022459634.1,interleukin 17-like protein,1271
NC_035784.1,5220554,5236667,5220554,5236667,111135974,XM_022486485.1,probable 18S rRNA (guanine-N(7))-methyltransferase,16113
NC_035780.1,28922617,28927515,28922617,28927515,111114743,XM_022453207.1,sulfotransferase 1A1-like,4898
NC_035780.1,28991773,28996680,28991773,28996680,111125332,XM_022469003.1,sulfotransferase 1A1-like,4907
NC_035780.1,28945659,28950613,28945659,28950613,111136753,XM_022487852.1,sulfotransferase 1A1-like,4954
NC_035780.1,28968775,28973730,28968775,28973730,111125327,XM_022468987.1,sulfotransferase 1A1-like,4955
NC_035780.1,29003429,29007690,29003429,29007690,111106823,XM_022441652.1,sulfotransferase 1A3-like,4261
NC_035781.1,3023104,3025601,3023104,3025601,111121705,XM_022463074.1,carboxylesterase 1C-like,2497
NC_035786.1,49415235,49421440,49416147,49420408,111104316,XM_022438195.1,carboxylesterase 1C-like,4261
NC_035788.1,68246089,68251120,68246089,68251120,111112948,XM_022450842.1,carboxylesterase 1C-like,5031
NC_035786.1,49415235,49421440,49415297,49420408,111104316,XM_022438194.1,carboxylesterase 1C-like,5111
NC_035786.1,49415235,49421440,49415235,49420408,111104316,XM_022438193.1,carboxylesterase 1C-like,5173
NC_035788.1,87333959,87339256,87333959,87339256,111113400,XM_022451647.1,carboxylesterase 1C-like,5297
NC_035788.1,86696355,86701692,86696355,86701692,111112314,XM_022449755.1,carboxylesterase 1C-like,5337
NC_035786.1,49415235,49421440,49415235,49421440,111104316,XM_022438196.1,carboxylesterase 1C-like,6205
NC_035788.1,86728162,86735419,86728162,86734586,111112312,XM_022449751.1,carboxylesterase 1C-like,6424
NC_035788.1,86728162,86735419,86728162,86734587,111112312,XM_022449752.1,carboxylesterase 1C-like,6425
NC_035788.1,86728162,86735419,86728162,86734588,111112312,XM_022449753.1,carboxylesterase 1C-like,6426
NC_035788.1,86728162,86735419,86728162,86735419,111112312,XM_022449750.1,carboxylesterase 1C-like,7257
NC_035788.1,87350344,87359033,87350344,87357888,111115566,XM_022454352.1,carboxylesterase 1C-like,7544
NC_035788.1,87350344,87359033,87350344,87359033,111115566,XM_022454351.1,carboxylesterase 1C-like,8689
NC_035784.1,83124710,83129928,83124710,83129928,111136302,XM_022487058.1,sulfotransferase 1C4-like,5218
NC_035780.1,245532,253042,245532,253042,111109452,XM_022445568.1,sulfotransferase 1C4-like,7510
NC_035780.1,35103197,35111016,35103197,35111016,111099643,XM_022431011.1,sulfotransferase 1C4-like,7819
NC_035781.1,48017672,48028969,48017672,48028969,111121846,XM_022463299.1,glucosidase 2 subunit beta-like,11297
NC_035782.1,63768603,63773214,63768603,63773214,111123381,XM_022465681.1,rRNA 2'-O-methyltransferase fibrillarin-like,4611
NC_035785.1,37551197,37556712,37551197,37556712,111101237,XM_022433664.1,putative 2'-deoxynucleoside 5'-phosphate N-hydrolase 1,5515
NC_035782.1,26095811,26108088,26095811,26108088,111123132,XM_022465270.1,tRNA 2'-phosphotransferase 1-like,12277
NC_035782.1,11971948,11988028,11975209,11988028,111123201,XM_022465372.1,tryptophan 2,12819
NC_035782.1,11619510,11637023,11622769,11637023,111122750,XM_022464640.1,tryptophan 2,14254
NC_035782.1,11971948,11988028,11971948,11988028,111123201,XM_022465371.1,tryptophan 2,16080
NC_035782.1,11619510,11637023,11619510,11637023,111122750,XM_022464639.1,tryptophan 2,17513
NC_035784.1,61883598,61885429,61883598,61885429,111137008,XM_022488230.1,lysozyme 2,1831
NC_035782.1,15556572,15592300,15556572,15592300,111125187,XM_022468724.1,tryptophan 2,35728
NC_035784.1,5909874,5913529,5909874,5913529,111133165,XM_022481288.1,alpha-ketoglutarate-dependent 2,3655
NC_035781.1,16648576,16652511,16648576,16652511,111122122,XM_022463704.1,peroxisomal 2,3935
NC_035784.1,6854675,6858881,6854675,6858881,111133329,XM_022481629.1,alpha-ketoglutarate-dependent 2,4206
NC_035782.1,14926751,14933447,14926751,14933447,111124043,XM_022466904.1,tryptophan 2,6696
NC_035780.1,49787302,49794465,49787302,49794465,111118359,XM_022457766.1,ruvB-like 2,7163
NC_035780.1,48031002,48039699,48031002,48039699,111099792,XM_022431255.1,ruvB-like 2,8697
NC_035782.1,15609779,15618489,15609779,15618489,111125818,XM_022469975.1,tryptophan 2,8710
NC_035781.1,30858809,30876878,30858809,30876878,111120678,XM_022461583.1,galactoside 2-alpha-L-fucosyltransferase 2-like,18069
NC_035788.1,31695231,31700543,31695231,31700543,111111219,XM_022448056.1,gibberellin 2-beta-dioxygenase 4-like,5312
NC_035784.1,55440426,55451299,55440426,55451299,111134060,XM_022482857.1,myo-inositol 2-dehydrogenase-like,10873
NC_035784.1,76670164,76675466,76670164,76675466,111137566,XM_022489063.1,inositol 2-dehydrogenase-like,5302
NC_035787.1,60192010,60197950,60192010,60197930,111107413,XM_022442607.1,N-acylglucosamine 2-epimerase-like,5920
NC_035787.1,60192010,60197950,60192010,60197950,111107413,XM_022442608.1,N-acylglucosamine 2-epimerase-like,5940
NC_035787.1,14386007,14426048,14386007,14426048,111106648,XM_022441400.1,inositol-pentakisphosphate 2-kinase-like,40041
NC_035787.1,45880445,45881453,45880445,45881453,111109100,XM_022445188.1,galactose-3-O-sulfotransferase 2-like,1008
NC_035783.1,32411180,32424850,32411180,32424850,111128909,XM_022474862.1,alpha-mannosidase 2-like,13670
NC_035782.1,24432953,24446631,24432953,24446631,111123326,XM_022465585.1,galactose-3-O-sulfotransferase 2-like,13678
NC_035780.1,29381040,29382410,29381040,29382410,111106833,XM_022441679.1,galactose-3-O-sulfotransferase 2-like,1370
NC_035781.1,25101874,25115698,25101874,25115698,111118293,XM_022457678.1,xylosyltransferase 2-like,13824
NC_035783.1,1352065,1368821,1352065,1368821,111128282,XM_022473832.1,alpha-mannosidase 2-like,16756
NC_035784.1,75555473,75572587,75555473,75572587,111135844,XM_022486248.1,tripeptidyl-peptidase 2-like,17114
NC_035783.1,36557656,36559499,36557656,36559499,111128947,XM_022474923.1,galactose-3-O-sulfotransferase 2-like,1843
NC_035781.1,25656014,25674809,25656014,25674809,111121408,XM_022462687.1,xylosyltransferase 2-like,18795
NC_035786.1,13296926,13302316,13297332,13302314,111102836,XM_022435735.1,glucose-6-phosphatase 2-like,4982
NC_035786.1,13296926,13302316,13296926,13302316,111102836,XM_022435734.1,glucose-6-phosphatase 2-like,5390
NC_035782.1,32488705,32494232,32488705,32494232,111127162,XM_022472221.1,mitoguardin 2-like,5527
NC_035784.1,57661795,57667338,57661795,57667338,111134019,XM_022482783.1,endoglucanase 2-like,5543
NC_035785.1,29147542,29153194,29147542,29153175,111101224,XM_022433633.1,glucose-6-phosphatase 2-like,5633
NC_035785.1,29147542,29153194,29147542,29153194,111101224,XM_022433631.1,glucose-6-phosphatase 2-like,5652
NC_035787.1,332887,333578,332887,333578,111107436,XM_022442636.1,osteocalcin 2-like,691
NC_035784.1,4521799,4522606,4521799,4522606,111136441,XM_022487291.1,osteocalcin 2-like,807
NC_035781.1,49351431,49361080,49352252,49361080,111119558,XM_022459817.1,alpha-mannosidase 2-like,8828
NC_035781.1,48511255,48520908,48511255,48520122,111118581,XM_022458124.1,alpha-mannosidase 2-like,8867
NC_035781.1,49351431,49361080,49351431,49361079,111119558,XM_022459816.1,alpha-mannosidase 2-like,9648
NC_035781.1,48511255,48520908,48511256,48520908,111118581,XM_022458123.1,alpha-mannosidase 2-like,9652
NC_035783.1,16670401,16674646,16670401,16674646,111128023,XM_022473389.1,mitochondrial 2-oxodicarboxylate carrier-like,4245
NC_035783.1,5420075,5434012,5420075,5434012,111130627,XM_022477792.1,probable 2-oxoglutarate dehydrogenase E1 component DHKTD1,13937
NC_035784.1,38074782,38081393,38074782,38081393,111136412,XM_022487244.1,mitochondrial 2-oxoglutarate/malate carrier protein-like,6611
NC_035781.1,29573713,29577168,29573713,29577168,111118965,XM_022458697.1,tRNA 2-selenouridine synthase-like,3455
NC_035782.1,35739384,35748450,35739385,35748429,111125726,XM_022469792.1,iduronate 2-sulfatase-like,9044
NC_035782.1,35739384,35748450,35739384,35748450,111125726,XM_022469793.1,iduronate 2-sulfatase-like,9066
NC_035783.1,50172945,50188862,50172945,50188862,111131729,XM_022479395.1,N-alpha-acetyltransferase 20-like,15917
NC_035781.1,31169999,31175508,31169999,31175508,111121267,XM_022462456.1,N-alpha-acetyltransferase 25,5509
NC_035783.1,56256617,56259713,56256617,56259713,111131290,XM_022478739.1,cholesterol 25-hydroxylase-like protein 1,3096
NC_035781.1,9163566,9166799,9163566,9166062,111119201,XM_022459127.1,cholesterol 25-hydroxylase-like,2496
NC_035781.1,9163566,9166799,9163568,9166799,111119201,XM_022459126.1,cholesterol 25-hydroxylase-like,3231
NC_035781.1,49290180,49293167,49290202,49293167,111121128,XM_022462262.1,methyltransferase-like 26,2965
NC_035781.1,49290180,49293167,49290187,49293167,111121128,XM_022462261.1,methyltransferase-like 26,2980
NC_035781.1,49290180,49293167,49290180,49293167,111121128,XM_022462263.1,methyltransferase-like 26,2987
NC_035781.1,48584002,48587027,48584002,48587011,111120871,XM_022461878.1,methyltransferase-like 26,3009
NC_035781.1,48584002,48587027,48584002,48587026,111120871,XM_022461879.1,methyltransferase-like 26,3024
NC_035781.1,48584002,48587027,48584002,48587027,111120871,XM_022461880.1,methyltransferase-like 26,3025
NC_035784.1,75337953,75341400,75337953,75341400,111132591,XM_022480421.1,snaclec 27-like,3447
NC_035784.1,96958239,96963465,96958239,96963465,111136646,XM_022487650.1,probable 28S ribosomal protein S26,5226
NC_035786.1,40295661,40315670,40295661,40315627,111102612,XM_022435431.1,alpha-mannosidase 2C1-like,19966
NC_035786.1,40295661,40315670,40295661,40315670,111102612,XM_022435430.1,alpha-mannosidase 2C1-like,20009
NC_035786.1,36739827,36763218,36739828,36763218,111104792,XM_022438929.1,alpha-mannosidase 2C1-like,23390
NC_035786.1,36739827,36763218,36739827,36763218,111104792,XM_022438930.1,alpha-mannosidase 2C1-like,23391
NC_035788.1,47685901,47707983,47685901,47707983,111113429,XM_022451713.1,alpha-mannosidase 2x-like,22082
NC_035782.1,8161973,8206541,8161973,8206541,111125577,XM_022469539.1,band 3 anion transport protein-like,44568
NC_035784.1,60622695,60637107,60622695,60637107,111135694,XM_022485976.1,pre-mRNA 3' end processing protein WDR33-like,14412
NC_035782.1,43015955,43060465,43017620,43028627,111124666,XM_022467753.1,cGMP-dependent 3',11007
NC_035781.1,27907084,27970692,27959373,27970692,111122342,XM_022464074.1,cAMP-specific 3',11319
NC_035782.1,44046229,44093913,44047898,44059588,111123979,XM_022466768.1,cGMP-dependent 3',11690
NC_035782.1,43015955,43060465,43015955,43028627,111124666,XM_022467750.1,cGMP-dependent 3',12672
NC_035782.1,44046229,44093913,44046229,44059588,111123979,XM_022466767.1,cGMP-dependent 3',13359
NC_035781.1,29025314,29073319,29059176,29073318,111122016,XM_022463539.1,cAMP-specific 3',14142
NC_035781.1,27907084,27970692,27953255,27970692,111122342,XM_022464073.1,cAMP-specific 3',17437
NC_035785.1,42120084,42145574,42127895,42145574,111099771,XM_022431221.1,probable 3',17679
NC_035781.1,15929258,15956377,15938389,15956377,111119630,XM_022460005.1,probable 3',17988
NC_035785.1,42120084,42145574,42126202,42145574,111099771,XM_022431220.1,probable 3',19372
NC_035781.1,29025314,29073319,29052837,29073318,111122016,XM_022463538.1,cAMP-specific 3',20481
NC_035785.1,42120084,42145574,42123419,42145574,111099771,XM_022431218.1,probable 3',22155
NC_035781.1,15929258,15956377,15933894,15956377,111119630,XM_022460004.1,probable 3',22483
NC_035782.1,51420528,51512453,51488481,51512453,111126455,XM_022471134.1,calcium/calmodulin-dependent 3',23972
NC_035785.1,42120084,42145574,42120090,42145574,111099771,XM_022431214.1,probable 3',25484
NC_035785.1,42120084,42145574,42120086,42145574,111099771,XM_022431216.1,probable 3',25488
NC_035785.1,42120084,42145574,42120085,42145574,111099771,XM_022431212.1,probable 3',25489
NC_035785.1,42120084,42145574,42120084,42145574,111099771,XM_022431213.1,probable 3',25490
NC_035781.1,15929258,15956377,15930568,15956377,111119630,XM_022459996.1,probable 3',25809
NC_035781.1,15929258,15956377,15930559,15956377,111119630,XM_022460000.1,probable 3',25818
NC_035781.1,15929258,15956377,15930558,15956377,111119630,XM_022460002.1,probable 3',25819
NC_035781.1,15929258,15956377,15930557,15956377,111119630,XM_022460001.1,probable 3',25820
NC_035781.1,15929258,15956377,15930556,15956377,111119630,XM_022459999.1,probable 3',25821
NC_035781.1,15929258,15956377,15930553,15956377,111119630,XM_022459997.1,probable 3',25824
NC_035781.1,15929258,15956377,15929368,15956377,111119630,XM_022459995.1,probable 3',27009
NC_035781.1,15929258,15956377,15929366,15956377,111119630,XM_022459998.1,probable 3',27011
NC_035781.1,15929258,15956377,15929258,15956377,111119630,XM_022459993.1,probable 3',27119
NC_035782.1,51420528,51512453,51484844,51512453,111126455,XM_022471133.1,calcium/calmodulin-dependent 3',27609
NC_035784.1,62013633,62050048,62022272,62050048,111134772,XM_022484119.1,cGMP-specific 3',27776
NC_035784.1,62013633,62050048,62020768,62048947,111134772,XM_022484127.1,cGMP-specific 3',28179
NC_035784.1,62013633,62050048,62020769,62048951,111134772,XM_022484126.1,cGMP-specific 3',28182
NC_035784.1,62013633,62050048,62020772,62050046,111134772,XM_022484128.1,cGMP-specific 3',29274
NC_035784.1,62013633,62050048,62020765,62050047,111134772,XM_022484124.1,cGMP-specific 3',29282
NC_035784.1,62013633,62050048,62020763,62050047,111134772,XM_022484123.1,cGMP-specific 3',29284
NC_035784.1,62013633,62050048,62020762,62050047,111134772,XM_022484121.1,cGMP-specific 3',29285
NC_035784.1,62013633,62050048,62020761,62050048,111134772,XM_022484115.1,cGMP-specific 3',29287
NC_035784.1,62013633,62050048,62020736,62050048,111134772,XM_022484122.1,cGMP-specific 3',29312
NC_035784.1,62013633,62050048,62020734,62050048,111134772,XM_022484120.1,cGMP-specific 3',29314
NC_035781.1,27907084,27970692,27941357,27970692,111122342,XM_022464067.1,cAMP-specific 3',29335
NC_035782.1,51420528,51512453,51480946,51512453,111126455,XM_022471132.1,calcium/calmodulin-dependent 3',31507
NC_035781.1,47208391,47245757,47208391,47240036,111119490,XM_022459694.1,dual 3',31645
NC_035781.1,47208391,47245757,47208391,47240070,111119490,XM_022459693.1,dual 3',31679
NC_035781.1,29025314,29073319,29040934,29073319,111122016,XM_022463533.1,cAMP-specific 3',32385
NC_035780.1,56765499,56799583,56765499,56799583,111099151,XM_022430551.1,dual 3',34084
NC_035781.1,27907084,27970692,27936221,27970692,111122342,XM_022464068.1,cAMP-specific 3',34471
NC_035781.1,29025314,29073319,29037646,29073319,111122016,XM_022463534.1,cAMP-specific 3',35673
NC_035784.1,62013633,62050048,62013633,62050048,111134772,XM_022484116.1,cGMP-specific 3',36415
NC_035781.1,47208391,47245757,47208391,47245756,111119490,XM_022459692.1,dual 3',37365
NC_035781.1,47208391,47245757,47208391,47245757,111119490,XM_022459691.1,dual 3',37366
NC_035781.1,50668564,50706175,50668564,50706175,111119398,XM_022459527.1,dual 3',37611
NC_035781.1,27907084,27970692,27932669,27970692,111122342,XM_022464072.1,cAMP-specific 3',38023
NC_035782.1,51420528,51512453,51473865,51512453,111126455,XM_022471124.1,calcium/calmodulin-dependent 3',38588
NC_035782.1,51420528,51512453,51473678,51512453,111126455,XM_022471122.1,calcium/calmodulin-dependent 3',38775
NC_035781.1,29025314,29073319,29034146,29073319,111122016,XM_022463537.1,cAMP-specific 3',39173
NC_035782.1,43015955,43060465,43015955,43058136,111124666,XM_022467754.1,cGMP-dependent 3',42181
NC_035782.1,51420528,51512453,51469593,51512453,111126455,XM_022471131.1,calcium/calmodulin-dependent 3',42860
NC_035781.1,27907084,27970692,27927042,27970692,111122342,XM_022464070.1,cAMP-specific 3',43650
NC_035782.1,44046229,44093913,44046229,44090299,111123979,XM_022466769.1,cGMP-dependent 3',44070
NC_035782.1,44046229,44093913,44046229,44090300,111123979,XM_022466770.1,cGMP-dependent 3',44071
NC_035782.1,43015955,43060465,43015955,43060465,111124666,XM_022467756.1,cGMP-dependent 3',44510
NC_035781.1,29025314,29073319,29028556,29073319,111122016,XM_022463535.1,cAMP-specific 3',44763
NC_035781.1,27907084,27970692,27924412,27970692,111122342,XM_022464071.1,cAMP-specific 3',46280
NC_035782.1,44046229,44093913,44046229,44092715,111123979,XM_022466772.1,cGMP-dependent 3',46486
NC_035782.1,44046229,44093913,44046229,44093913,111123979,XM_022466771.1,cGMP-dependent 3',47684
NC_035781.1,29025314,29073319,29025314,29073319,111122016,XM_022463536.1,cAMP-specific 3',48005
NC_035782.1,51420528,51512453,51463209,51512453,111126455,XM_022471121.1,calcium/calmodulin-dependent 3',49244
NC_035782.1,51420528,51512453,51451657,51512453,111126455,XM_022471127.1,calcium/calmodulin-dependent 3',60796
NC_035781.1,27907084,27970692,27907084,27970692,111122342,XM_022464069.1,cAMP-specific 3',63608
NC_035782.1,51420528,51512453,51445107,51512453,111126455,XM_022471120.1,calcium/calmodulin-dependent 3',67346
NC_035782.1,51420528,51512453,51445105,51512453,111126455,XM_022471116.1,calcium/calmodulin-dependent 3',67348
NC_035782.1,51420528,51512453,51445104,51512453,111126455,XM_022471119.1,calcium/calmodulin-dependent 3',67349
NC_035782.1,51420528,51512453,51445103,51512453,111126455,XM_022471117.1,calcium/calmodulin-dependent 3',67350
NC_035786.1,38942166,39014277,38942166,39014277,111103309,XM_022436485.1,cGMP-inhibited 3',72111
NC_035782.1,51420528,51512453,51420534,51512453,111126455,XM_022471130.1,calcium/calmodulin-dependent 3',91919
NC_035782.1,51420528,51512453,51420533,51512453,111126455,XM_022471128.1,calcium/calmodulin-dependent 3',91920
NC_035782.1,51420528,51512453,51420528,51512453,111126455,XM_022471129.1,calcium/calmodulin-dependent 3',91925
NC_035784.1,70565695,70595318,70565695,70595318,111132560,XM_022480384.1,exonuclease 3'-5' domain-containing protein 2-like,29623
NC_035782.1,56293785,56302183,56293785,56302183,111122970,XM_022465018.1,pre-mRNA 3'-end-processing factor FIP1-like,8398
NC_035781.1,40230512,40232202,40230512,40232202,111122273,XM_022463925.1,polynucleotide 3'-phosphatase ZDP-like,1690
NC_035781.1,1340342,1350253,1340342,1350253,111121012,XM_022462094.1,adenosine 3'-phospho 5'-phosphosulfate transporter 2-like,9911
NC_035781.1,56811183,56820572,56811183,56820572,111119950,XM_022460540.1,bifunctional 3'-phosphoadenosine 5'-phosphosulfate synthase-like,9389
NC_035781.1,11811670,11817523,11811670,11817523,111121130,XM_022462267.1,RNA 3'-terminal phosphate cyclase-like protein,5853
NC_035780.1,2413119,2424450,2413119,2424450,111132349,XM_022480162.1,galactoside 3(4)-L-fucosyltransferase-like,11331
NC_035784.1,7887226,7888613,7887226,7888613,111134962,XM_022484577.1,galactoside 3(4)-L-fucosyltransferase-like,1387
NC_035780.1,2413119,2424450,2419776,2424450,111132349,XM_022480155.1,galactoside 3(4)-L-fucosyltransferase-like,4674
NC_035784.1,72131899,72141987,72131899,72141987,111138402,XM_022490343.1,protocatechuate 3,10088
NC_035782.1,50588026,50600389,50588877,50600389,111125643,XM_022469649.1,phosphatidylinositol 3,11512
NC_035783.1,31181409,31193224,31181409,31193224,111130649,XM_022477820.1,3-hydroxyanthranilate 3,11815
NC_035782.1,50588026,50600389,50588026,50599916,111125643,XM_022469648.1,phosphatidylinositol 3,11890
NC_035784.1,91633839,91649588,91637590,91649588,111135505,XM_022485638.1,phosphatidylinositol 3,11998
NC_035784.1,91832645,91846948,91834485,91846948,111135503,XM_022485636.1,phosphatidylinositol 3,12463
NC_035784.1,91883477,91896121,91883477,91896121,111135502,XM_022485634.1,phosphatidylinositol 3,12644
NC_035784.1,91832645,91846948,91832645,91846948,111135503,XM_022485635.1,phosphatidylinositol 3,14303
NC_035784.1,91633839,91649588,91633839,91649588,111135505,XM_022485637.1,phosphatidylinositol 3,15749
NC_035784.1,91763205,91779190,91763205,91779190,111135506,XM_022485639.1,phosphatidylinositol 3,15985
NC_035780.1,30232545,30249571,30232545,30249571,111126456,XM_022471126.1,exostosin-like 3,17026
NC_035781.1,38278669,38296461,38278669,38296461,111119254,XM_022459249.1,phosphatidylinositol 3,17792
NC_035784.1,72621928,72667343,72638458,72667343,111132057,XM_022479697.1,phosphatidylinositol 3,28885
NC_035784.1,72621928,72667343,72634079,72667343,111132057,XM_022479698.1,phosphatidylinositol 3,33264
NC_035784.1,72621928,72667343,72634070,72667343,111132057,XM_022479696.1,phosphatidylinositol 3,33273
NC_035784.1,72621928,72667343,72624223,72667343,111132057,XM_022479701.1,phosphatidylinositol 3,43120
NC_035784.1,72621928,72667343,72621932,72667343,111132057,XM_022479700.1,phosphatidylinositol 3,45411
NC_035784.1,72621928,72667343,72621928,72667343,111132057,XM_022479699.1,phosphatidylinositol 3,45415
NC_035780.1,9489348,9494188,9489348,9494188,111100849,XM_022433002.1,lysozyme 3,4840
NC_035783.1,31479189,31485193,31479189,31485193,111131775,XM_022479479.1,3-hydroxyanthranilate 3,6004
NC_035783.1,31181409,31193224,31181409,31188195,111130649,XM_022477819.1,3-hydroxyanthranilate 3,6786
NC_035780.1,2428485,2437730,2428485,2437729,111132366,XM_022480172.1,glycoprotein 3-alpha-L-fucosyltransferase A-like,9244
NC_035780.1,6431294,6437528,6431294,6437528,111125589,XM_022469556.1,glycoprotein-N-acetylgalactosamine 3-beta-galactosyltransferase 1-like,6234
NC_035783.1,56660168,56666187,56660168,56666187,111129954,XM_022476511.1,galactosylgalactosylxylosylprotein 3-beta-glucuronosyltransferase 1-like,6019
NC_035781.1,794541,807511,794541,807106,111120495,XM_022461235.1,L-threonine 3-dehydrogenase,12565
NC_035781.1,794541,807511,794542,807511,111120495,XM_022461236.1,L-threonine 3-dehydrogenase,12969
NC_035781.1,48678420,48681844,48678420,48681844,111119079,XM_022458897.1,L-threonine 3-dehydrogenase-like,3424
NC_035780.1,99840,106460,99840,106460,111120752,XM_022461698.1,ribulose-phosphate 3-epimerase-like,6620
NC_035781.1,24628881,24655092,24628881,24655092,111121405,XM_022462680.1,phosphoinositide 3-kinase adapter protein 1-like,26211
NC_035782.1,53965053,53980887,53965053,53980886,111124525,XM_022467452.1,ribonuclease 3-like,15833
NC_035782.1,53965053,53980887,53965053,53980887,111124525,XM_022467453.1,ribonuclease 3-like,15834
NC_035780.1,6878053,6880695,6878053,6880695,111130831,XM_022478078.1,lysozyme 3-like,2642
NC_035781.1,10296923,10783376,10780047,10783376,111119896,XM_022460468.1,glyoxalase 3-like,3329
NC_035780.1,12754366,12758045,12754366,12758045,111110293,XM_022446722.1,lysozyme 3-like,3679
NC_035781.1,10796282,10800302,10796284,10800302,111119897,XM_022460472.1,glyoxalase 3-like,4018
NC_035781.1,10796282,10800302,10796282,10800302,111119897,XM_022460471.1,glyoxalase 3-like,4020
NC_035781.1,10787736,10791778,10787744,10791778,111119898,XM_022460474.1,glyoxalase 3-like,4034
NC_035781.1,10787736,10791778,10787736,10791778,111119898,XM_022460473.1,glyoxalase 3-like,4042
NC_035781.1,10296923,10783376,10296923,10783376,111119896,XM_022460469.1,glyoxalase 3-like,486453
NC_035781.1,33227591,33229800,33227591,33229800,111120573,XM_022461377.1,putative 3-methyladenine DNA glycosylase,2209
NC_035783.1,42735773,42747779,42735773,42747779,111127901,XM_022473200.1,kynurenine 3-monooxygenase-like,12006
NC_035785.1,15651420,15670675,15651420,15670675,111100427,XM_022432317.1,tyrosine 3-monooxygenase-like,19255
NC_035785.1,15213894,15237151,15213894,15237151,111100428,XM_022432318.1,tyrosine 3-monooxygenase-like,23257
NC_035783.1,22983143,22992284,22983143,22992078,111131016,XM_022478336.1,kynurenine 3-monooxygenase-like,8935
NC_035783.1,22983143,22992284,22983143,22992284,111131016,XM_022478335.1,kynurenine 3-monooxygenase-like,9141
NC_035780.1,30209227,30214127,30209227,30214127,111126467,XM_022471150.1,very-long-chain 3-oxoacyl-CoA reductase-like,4900
NC_035781.1,33603020,33609907,33603020,33608206,111118137,XM_022457456.1,CDP-diacylglycerol--glycerol-3-phosphate 3-phosphatidyltransferase,5186
NC_035781.1,33603020,33609907,33603020,33608284,111118137,XM_022457457.1,CDP-diacylglycerol--glycerol-3-phosphate 3-phosphatidyltransferase,5264
NC_035781.1,33603020,33609907,33603021,33609907,111118137,XM_022457455.1,CDP-diacylglycerol--glycerol-3-phosphate 3-phosphatidyltransferase,6886
NC_035784.1,37173829,37178663,37173829,37178663,111138290,XM_022490167.1,CDP-diacylglycerol--inositol 3-phosphatidyltransferase-like,4834
NC_035783.1,25341813,25347112,25341813,25347112,111129286,XM_022475571.1,N-alpha-acetyltransferase 30-like,5299
NC_035780.1,54012133,54031312,54012133,54031312,111125834,XM_022470004.1,N-alpha-acetyltransferase 35,19179
NC_035784.1,31813534,31815270,31813534,31815270,111137594,XM_022489114.1,N-alpha-acetyltransferase 38,1736
NC_035784.1,30876655,30878942,30876655,30878942,111137221,XM_022488585.1,N-alpha-acetyltransferase 38,2287
NC_035782.1,26043888,26048328,26043888,26048328,111126778,XM_022471636.1,probable 39S ribosomal protein L24,4440
NC_035784.1,35832151,35847728,35832151,35842639,111135557,XM_022485715.1,phosphatidylinositol 4,10488
NC_035784.1,51034411,51046269,51034411,51045162,111132137,XM_022479866.1,phosphatidylinositol 4,10751
NC_035784.1,51055382,51066535,51055382,51066535,111132138,XM_022479868.1,phosphatidylinositol 4,11153
NC_035784.1,35832151,35847728,35832151,35843361,111135557,XM_022485714.1,phosphatidylinositol 4,11210
NC_035784.1,35832151,35847728,35832151,35843381,111135557,XM_022485716.1,phosphatidylinositol 4,11230
NC_035785.1,32185350,32314761,32201898,32314761,111100148,XM_022431783.1,1-phosphatidylinositol 4,112863
NC_035784.1,51034411,51046269,51034411,51046269,111132137,XM_022479865.1,phosphatidylinositol 4,11858
NC_035785.1,32185350,32314761,32185350,32314761,111100148,XM_022431782.1,1-phosphatidylinositol 4,129411
NC_035784.1,35832151,35847728,35832151,35847728,111135557,XM_022485713.1,phosphatidylinositol 4,15577
NC_035780.1,34699951,34730314,34699952,34719088,111101050,XM_022433371.1,1-phosphatidylinositol 4,19136
NC_035780.1,34699951,34730314,34699954,34722128,111101050,XM_022433346.1,1-phosphatidylinositol 4,22174
NC_035780.1,34699951,34730314,34699953,34722130,111101050,XM_022433339.1,1-phosphatidylinositol 4,22177
NC_035780.1,34699951,34730314,34699952,34722132,111101050,XM_022433329.1,1-phosphatidylinositol 4,22180
NC_035780.1,34699951,34730314,34699951,34722133,111101050,XM_022433311.1,1-phosphatidylinositol 4,22182
NC_035780.1,34699951,34730314,34699952,34725103,111101050,XM_022433362.1,1-phosphatidylinositol 4,25151
NC_035780.1,34699951,34730314,34699953,34730314,111101050,XM_022433353.1,1-phosphatidylinositol 4,30361
NC_035784.1,52998515,53034526,52998515,53034525,111138520,XM_022490537.1,GDP-mannose 4,36010
NC_035784.1,52998515,53034526,52998515,53034526,111138520,XM_022490536.1,GDP-mannose 4,36011
NC_035783.1,17608692,17652039,17614589,17652039,111128349,XM_022473925.1,1-phosphatidylinositol 4,37450
NC_035783.1,17608692,17652039,17608692,17646191,111128349,XM_022473928.1,1-phosphatidylinositol 4,37499
NC_035783.1,17608692,17652039,17608692,17652039,111128349,XM_022473924.1,1-phosphatidylinositol 4,43347
NC_035784.1,3044405,3091526,3044405,3088019,111132178,XM_022479949.1,1-phosphatidylinositol 4,43614
NC_035784.1,3044405,3091526,3044406,3091526,111132178,XM_022479950.1,1-phosphatidylinositol 4,47120
NC_035784.1,3044405,3091526,3044405,3091526,111132178,XM_022479943.1,1-phosphatidylinositol 4,47121
NC_035785.1,32185350,32314761,32254338,32314761,111100148,XM_022431789.1,1-phosphatidylinositol 4,60423
NC_035783.1,11654259,11715082,11654259,11715082,111131147,XM_022478527.1,1-phosphatidylinositol 4,60823
NC_035785.1,32185350,32314761,32252959,32314761,111100148,XM_022431787.1,1-phosphatidylinositol 4,61802
NC_035785.1,32185350,32314761,32246144,32314761,111100148,XM_022431786.1,1-phosphatidylinositol 4,68617
NC_035784.1,35832151,35847728,35832151,35842111,111135557,XM_022485717.1,phosphatidylinositol 4,9960
NC_035780.1,46567645,46570658,46567645,46570658,111125200,XM_022468782.1,3-oxo-5-alpha-steroid 4-dehydrogenase 2-like,3013
NC_035788.1,34581808,34693882,34581808,34693882,111115277,XM_022453960.1,GDP-6-deoxy-D-talose 4-dehydrogenase-like,112074
NC_035788.1,34581808,34693882,34581808,34607409,111115277,XM_022453959.1,GDP-6-deoxy-D-talose 4-dehydrogenase-like,25601
NC_035781.1,29529720,29534988,29529720,29534919,111122398,XM_022464171.1,UDP-glucose 4-epimerase-like,5199
NC_035781.1,29529720,29534988,29529720,29534988,111122398,XM_022464172.1,UDP-glucose 4-epimerase-like,5268
NC_035780.1,63447429,63464164,63447429,63464164,111127387,XM_022472549.1,prolyl 4-hydroxylase subunit alpha-1-like,16735
NC_035780.1,50991007,51003642,50991007,51003642,111124467,XM_022467331.1,phosphatidylinositol 4-kinase beta-like,12635
NC_035784.1,67505531,67522736,67505531,67515710,111135634,XM_022485875.1,proteoglycan 4-like,10179
NC_035783.1,53720080,53731435,53720080,53731435,111127811,XM_022473070.1,endoglucanase 4-like,11355
NC_035784.1,67505531,67522736,67505531,67516895,111135634,XM_022485874.1,proteoglycan 4-like,11364
NC_035781.1,36935386,36946999,36935386,36946999,111120062,XM_022460709.1,proteoglycan 4-like,11613
NC_035784.1,67505531,67522736,67505531,67519080,111135634,XM_022485873.1,proteoglycan 4-like,13549
NC_035782.1,18617246,18633812,18617246,18630796,111124815,XM_022468017.1,proteoglycan 4-like,13550
NC_035782.1,53780219,53795715,53780219,53795715,111125808,XM_022469957.1,proteoglycan 4-like,15496
NC_035783.1,54777715,54793730,54777715,54793730,111128373,XM_022473960.1,endoglucanase 4-like,16015
NC_035782.1,18617246,18633812,18617246,18633812,111124815,XM_022468018.1,proteoglycan 4-like,16566
NC_035784.1,67505531,67522736,67505531,67522730,111135634,XM_022485869.1,proteoglycan 4-like,17199
NC_035784.1,67505531,67522736,67505531,67522732,111135634,XM_022485866.1,proteoglycan 4-like,17201
NC_035784.1,67505531,67522736,67505531,67522736,111135634,XM_022485870.1,proteoglycan 4-like,17205
NC_035782.1,64150609,64152378,64150609,64152378,111124370,XM_022467221.1,proteoglycan 4-like,1769
NC_035780.1,37375561,37377510,37375563,37377510,111114103,XM_022452394.1,proteoglycan 4-like,1947
NC_035780.1,37375561,37377510,37375561,37377510,111114103,XM_022452402.1,proteoglycan 4-like,1949
NC_035784.1,24287596,24308251,24287596,24308251,111136207,XM_022486885.1,proteoglycan 4-like,20655
NC_035786.1,34650875,34653326,34650881,34653326,111105396,XM_022439673.1,proteoglycan 4-like,2445
NC_035786.1,34650875,34653326,34650875,34653326,111105396,XM_022439674.1,proteoglycan 4-like,2451
NC_035780.1,60966318,60969173,60966318,60969173,111113389,XM_022451639.1,galactose-3-O-sulfotransferase 4-like,2855
NC_035780.1,57548197,57551058,57548197,57551058,111125461,XM_022469298.1,proteoglycan 4-like,2861
NC_035788.1,84867342,85344299,84893355,84924157,111112011,XM_022449283.1,proteoglycan 4-like,30802
NC_035784.1,70661425,70664836,70661425,70664836,111133427,XM_022481851.1,proteoglycan 4-like,3411
NC_035788.1,8128079,8131523,8128079,8131523,111112554,XM_022450080.1,proteoglycan 4-like,3444
NC_035784.1,57885271,57893450,57889853,57893450,111137960,XM_022489690.1,proteoglycan 4-like,3597
NC_035785.1,47736264,47739912,47736264,47739912,111099697,XM_022431107.1,proteoglycan 4-like,3648
NC_035788.1,84867342,85344299,84929693,85344299,111112011,XM_022449285.1,proteoglycan 4-like,414606
NC_035789.1,20708916,20713364,20708916,20713364,111116954,XM_022456011.1,proteoglycan 4-like,4448
NC_035784.1,57885271,57893450,57888715,57893450,111137960,XM_022489693.1,proteoglycan 4-like,4735
NC_035788.1,84867342,85344299,84867342,85344292,111112011,XM_022449284.1,proteoglycan 4-like,476950
NC_035781.1,59671943,59676757,59671943,59676757,111118160,XM_022457484.1,proteoglycan 4-like,4814
NC_035784.1,57885271,57893450,57886859,57893450,111137960,XM_022489694.1,proteoglycan 4-like,6591
NC_035784.1,57885271,57893450,57886850,57893450,111137960,XM_022489692.1,proteoglycan 4-like,6600
NC_035784.1,67505531,67522736,67505531,67512781,111135634,XM_022485872.1,proteoglycan 4-like,7250
NC_035784.1,67505531,67522736,67505531,67513685,111135634,XM_022485871.1,proteoglycan 4-like,8154
NC_035784.1,57885271,57893450,57885271,57893450,111137960,XM_022489691.1,proteoglycan 4-like,8179
NC_035784.1,67673349,67682452,67673353,67682452,111137133,XM_022488444.1,enolase 4-like,9099
NC_035784.1,67673349,67682452,67673351,67682452,111137133,XM_022488443.1,enolase 4-like,9101
NC_035784.1,67673349,67682452,67673350,67682452,111137133,XM_022488442.1,enolase 4-like,9102
NC_035784.1,67673349,67682452,67673349,67682452,111137133,XM_022488440.1,enolase 4-like,9103
NC_035780.1,29959864,29998370,29959864,29998370,111126338,XM_022470901.1,phosphatidylinositol 4-phosphate 3-kinase C2 domain-containing subunit alpha-like,38506
NC_035781.1,57988605,58011538,57988605,58011538,111119586,XM_022459897.1,band 4.1-like protein 2,22933
NC_035783.1,19193972,19224174,19214073,19224174,111128805,XM_022474678.1,N-alpha-acetyltransferase 40-like,10101
NC_035783.1,19193972,19224174,19193972,19224174,111128805,XM_022474677.1,N-alpha-acetyltransferase 40-like,30202
NC_035787.1,27144745,27153207,27144745,27153207,111110292,XM_022446718.1,polynucleotide 5'-hydroxyl-kinase NOL9-like,8462
NC_035780.1,63409221,63417606,63409221,63417606,111132766,XM_022480587.1,uridine 5'-monophosphate synthase-like,8385
NC_035780.1,48469436,48474767,48469436,48474767,111110454,XM_022446960.1,pyridoxal 5'-phosphate synthase subunit PdxS-like,5331
NC_035787.1,65472720,65479024,65472720,65479024,111108617,XM_022444607.1,deoxyuridine 5'-triphosphate nucleotidohydrolase,6304
NC_035780.1,8116419,8120996,8116419,8120996,111129259,XM_022475531.1,delta(7)-sterol 5(6)-desaturase erg32-like,4577
NC_035784.1,85118651,85131314,85118651,85131314,111134247,XM_022483136.1,tryptophan 5-hydroxylase 1-like,12663
NC_035785.1,8295592,8310427,8295592,8310427,111100560,XM_022432557.1,arachidonate 5-lipoxygenase-like,14835
NC_035782.1,61047119,61064697,61047533,61064695,111125061,XM_022468516.1,arachidonate 5-lipoxygenase-like,17162
NC_035782.1,61047119,61064697,61047121,61064697,111125061,XM_022468515.1,arachidonate 5-lipoxygenase-like,17576
NC_035782.1,61047119,61064697,61047119,61055349,111125061,XM_022468517.1,arachidonate 5-lipoxygenase-like,8230
NC_035785.1,8295592,8310427,8295592,8303969,111100560,XM_022432558.1,arachidonate 5-lipoxygenase-like,8377
NC_035782.1,61047119,61064697,61047121,61056665,111125061,XM_022468518.1,arachidonate 5-lipoxygenase-like,9544
NC_035788.1,79175945,79202011,79175945,79202011,111112578,XM_022450114.1,phosphatidylinositol 5-phosphate 4-kinase type-2 alpha-like,26066
NC_035782.1,11308773,11314068,11308773,11314068,111126364,XM_022470930.1,N-alpha-acetyltransferase 50-like,5295
NC_035782.1,10837777,10844156,10837777,10844156,111126042,XM_022470422.1,N-alpha-acetyltransferase 50-like,6379
NC_035788.1,87361262,87377323,87361262,87377323,111113411,XM_022451667.1,carboxylesterase 5A-like,16061
NC_035780.1,25445430,25448015,25445430,25448015,111119661,XM_022460073.1,carboxylesterase 5A-like,2585
NC_035781.1,24515767,24518434,24515767,24518434,111120468,XM_022461187.1,carboxylesterase 5A-like,2667
NC_035788.1,86737705,86741034,86737705,86741034,111112313,XM_022449754.1,carboxylesterase 5A-like,3329
NC_035788.1,87361262,87377323,87372726,87377323,111113411,XM_022451665.1,carboxylesterase 5A-like,4597
NC_035788.1,87361262,87377323,87361266,87366270,111113411,XM_022451666.1,carboxylesterase 5A-like,5004
NC_035783.1,12782245,12786416,12782245,12786416,111131815,XM_022479532.1,transmembrane 6 superfamily member 1-like,4171
NC_035784.1,66542860,66551576,66542860,66551576,111136074,XM_022486665.1,heparan-sulfate 6-O-sulfotransferase 2-like,8716
NC_035782.1,3974335,3986505,3974354,3985983,111124599,XM_022467589.1,UDP-glucose 6-dehydrogenase-like,11629
NC_035782.1,3974335,3986505,3974398,3986505,111124599,XM_022467591.1,UDP-glucose 6-dehydrogenase-like,12107
NC_035782.1,3974335,3986505,3974335,3986505,111124599,XM_022467590.1,UDP-glucose 6-dehydrogenase-like,12170
NC_035782.1,3351009,3370251,3351009,3367810,111124535,XM_022467472.1,UDP-glucose 6-dehydrogenase-like,16801
NC_035782.1,3351009,3370251,3351009,3368023,111124535,XM_022467473.1,UDP-glucose 6-dehydrogenase-like,17014
NC_035782.1,3351009,3370251,3351009,3368032,111124535,XM_022467471.1,UDP-glucose 6-dehydrogenase-like,17023
NC_035782.1,3351009,3370251,3351009,3370233,111124535,XM_022467475.1,UDP-glucose 6-dehydrogenase-like,19224
NC_035782.1,3351009,3370251,3351009,3370241,111124535,XM_022467476.1,UDP-glucose 6-dehydrogenase-like,19232
NC_035782.1,3351009,3370251,3351009,3370251,111124535,XM_022467474.1,UDP-glucose 6-dehydrogenase-like,19242
NC_035782.1,3974335,3986505,3976832,3985983,111124599,XM_022467588.1,UDP-glucose 6-dehydrogenase-like,9151
NC_035782.1,3974335,3986505,3976608,3986505,111124599,XM_022467586.1,UDP-glucose 6-dehydrogenase-like,9897
NC_035783.1,29649541,29661152,29650729,29661152,111130802,XM_022478045.1,N-acetyltransferase 6-like,10423
NC_035783.1,29074661,29086815,29074661,29086815,111129598,XM_022476052.1,N-acetyltransferase 6-like,12154
NC_035783.1,29649541,29661152,29649541,29655096,111130802,XM_022478044.1,N-acetyltransferase 6-like,5555
NC_035783.1,29649541,29661152,29654848,29661152,111130802,XM_022478047.1,N-acetyltransferase 6-like,6304
NC_035783.1,19824796,19833098,19824796,19833098,111127976,XM_022473305.1,glucosamine 6-phosphate N-acetyltransferase-like,8302
NC_035780.1,24475867,24492538,24475867,24492538,111124867,XM_022468112.1,ATP-dependent 6-phosphofructokinase-like,16671
NC_035781.1,5276808,5283005,5276808,5283005,111121674,XM_022463039.1,N-alpha-acetyltransferase 60-like,6197
NC_035781.1,21026211,21032546,21026211,21032546,111120619,XM_022461471.1,probable 60S ribosomal protein L37-A,6335
NC_035780.1,63417816,63425836,63417816,63425836,111132786,XM_022480608.1,transmembrane 7 superfamily member 3-like,8020
NC_035786.1,52062584,52076076,52062584,52076076,111104134,XM_022437921.1,24-hydroxycholesterol 7-alpha-hydroxylase-like,13492
NC_035787.1,7435015,7438221,7435015,7438221,111110573,XM_022447129.1,cholesterol 7-alpha-monooxygenase-like,3206
NC_035787.1,6749330,6752552,6749330,6752552,111110307,XM_022446744.1,cholesterol 7-alpha-monooxygenase-like,3222
NC_035782.1,32064978,32075469,32064978,32075469,111126872,XM_022471779.1,cholesterol 7-desaturase-like,10491
NC_035782.1,31722732,31734698,31722732,31734698,111123314,XM_022465569.1,cholesterol 7-desaturase-like,11966
NC_035782.1,32056462,32061849,32056462,32061849,111127059,XM_022472056.1,cholesterol 7-desaturase-like,5387
NC_035782.1,31713845,31719395,31713845,31719395,111123313,XM_022465568.1,cholesterol 7-desaturase-like,5550
NC_035783.1,35716844,35726548,35716844,35726548,111128035,XM_022473426.1,N-acetylgalactosaminyltransferase 7-like,9704
NC_035783.1,56195643,56202440,56195643,56202440,111127898,XM_022473198.1,endonuclease 8-like 1,6797
NC_035780.1,52564200,52609271,52564200,52609271,111133511,XM_022481983.1,transmembrane 9 superfamily member 1-like,45071
NC_035782.1,37439050,37457827,37441317,37457827,111127091,XM_022472109.1,N-acetylneuraminate 9-O-acetyltransferase-like,16510
NC_035782.1,36513495,36533501,36515266,36533501,111127539,XM_022472751.1,N-acetylneuraminate 9-O-acetyltransferase-like,18235
NC_035782.1,37439050,37457827,37439050,37457826,111127091,XM_022472110.1,N-acetylneuraminate 9-O-acetyltransferase-like,18776
NC_035782.1,37439050,37457827,37439050,37457827,111127091,XM_022472108.1,N-acetylneuraminate 9-O-acetyltransferase-like,18777
NC_035782.1,36513495,36533501,36513495,36533492,111127539,XM_022472752.1,N-acetylneuraminate 9-O-acetyltransferase-like,19997
NC_035782.1,36513495,36533501,36513496,36533501,111127539,XM_022472750.1,N-acetylneuraminate 9-O-acetyltransferase-like,20005
NC_035781.1,3545494,3557296,3545494,3557296,111118473,XM_022457975.1,N-acetyltransferase 9-like,11802
NC_035780.1,48522512,48532175,48522512,48532175,111115508,XM_022454278.1,kinesin-II 95 kDa subunit-like,9663
NC_035780.1,5794526,5795387,5794526,5795387,111103397,XM_022436661.1,alpha-crystallin A chain-like,861
NC_035781.1,35072851,35080187,35072851,35080187,111118121,XM_022457436.1,phospholipase A-2-activating protein-like,7336
NC_035787.1,16556424,16569324,16556424,16569324,111106667,XM_022441435.1,leukotriene A-4 hydrolase-like,12900
NC_035781.1,24363019,24383599,24363019,24383599,111120187,XM_022460916.1,brefeldin A-inhibited guanine nucleotide-exchange protein 1-like,20580
NC_035782.1,35607385,35617693,35607385,35617693,111123901,XM_022466579.1,filamin A-interacting protein 1-like,10308
NC_035784.1,27192189,27195749,27192189,27195749,111135192,XM_022485028.1,adenosylhomocysteinase A-like,3560
NC_035785.1,6119996,6125572,6120000,6125572,111101241,XM_022433669.1,endochitinase A-like,5572
NC_035785.1,6119996,6125572,6119996,6125572,111101241,XM_022433670.1,endochitinase A-like,5576
NC_035780.1,19692651,19698981,19692651,19698981,111106241,XM_022440835.1,exoglucanase A-like,6330
NC_035784.1,27199337,27206788,27199337,27206788,111135193,XM_022485029.1,adenosylhomocysteinase A-like,7451
NC_035788.1,19191099,19211646,19191099,19211646,111113586,XM_022451881.1,carboxypeptidase A1-like,20547
NC_035789.1,21290528,21311093,21290528,21311093,111116469,XM_022455465.1,carboxypeptidase A1-like,20565
NC_035781.1,39468532,39472986,39468532,39472986,111121260,XM_022462440.1,annexin A13-like,4454
NC_035781.1,54890084,54893103,54890084,54893103,111118501,XM_022458016.1,thromboxane A2 receptor-like,3019
NC_035787.1,60028376,60061362,60028376,60061362,111106193,XM_022440756.1,plexin A3-like,32986
NC_035782.1,25589389,25595111,25589389,25595111,111125917,XM_022470159.1,maltase A3-like,5722
NC_035781.1,24704342,24717949,24704342,24717949,111119648,XM_022460050.1,annexin A4-like,13607
NC_035781.1,20746600,20761539,20746600,20761539,111121229,XM_022462400.1,annexin A4-like,14939
NC_035782.1,24062746,24079035,24062746,24078790,111126580,XM_022471323.1,annexin A4-like,16044
NC_035782.1,24062746,24079035,24062746,24079035,111126580,XM_022471325.1,annexin A4-like,16289
NC_035781.1,53762881,53781857,53762881,53781857,111120390,XM_022461106.1,annexin A4-like,18976
NC_035783.1,14297254,14300444,14297254,14300436,111128927,XM_022474889.1,carboxypeptidase A4-like,3182
NC_035783.1,14297254,14300444,14297254,14300444,111128927,XM_022474890.1,carboxypeptidase A4-like,3190
NC_035781.1,38734498,38738923,38734501,38738751,111121288,XM_022462487.1,annexin A4-like,4250
NC_035781.1,38734498,38738923,38734501,38738752,111121288,XM_022462488.1,annexin A4-like,4251
NC_035781.1,38734498,38738923,38734498,38738923,111121288,XM_022462486.1,annexin A4-like,4425
NC_035781.1,53809797,53815002,53809797,53815002,111120561,XM_022461365.1,annexin A4-like,5205
NC_035780.1,31550042,31561209,31550042,31561209,111128122,XM_022473585.1,annexin A6-like,11167
NC_035781.1,53784421,53807048,53796116,53807048,111120559,XM_022461364.1,annexin A7-like,10932
NC_035787.1,58861077,58873161,58861077,58873087,111106837,XM_022441681.1,annexin A7-like,12010
NC_035787.1,58861077,58873161,58861077,58873122,111106837,XM_022441682.1,annexin A7-like,12045
NC_035787.1,58861077,58873161,58861077,58873161,111106837,XM_022441680.1,annexin A7-like,12084
NC_035781.1,53784421,53807048,53793805,53807048,111120559,XM_022461361.1,annexin A7-like,13243
NC_035787.1,58861077,58873161,58861077,58863297,111106837,XM_022441683.1,annexin A7-like,2220
NC_035781.1,53784421,53807048,53784441,53807048,111120559,XM_022461363.1,annexin A7-like,22607
NC_035781.1,53784421,53807048,53784421,53807048,111120559,XM_022461362.1,annexin A7-like,22627
NC_035781.1,26028618,26032931,26028618,26032931,111120199,XM_022460929.1,annexin A7-like,4313
NC_035785.1,31060613,31065064,31060613,31065064,111101828,XM_022434446.1,annexin A7-like,4451
NC_035787.1,32474341,32480173,32474341,32480173,111106286,XM_022440900.1,annexin A7-like,5832
NC_035787.1,33442747,33450095,33442747,33450095,111106162,XM_022440716.1,annexin A7-like,7348
NC_035780.1,13067921,13075805,13067921,13075805,111110741,XM_022447346.1,annexin A7-like,7884
NC_035784.1,53504819,53514285,53504819,53514226,111135670,XM_022485938.1,annexin A7-like,9407
NC_035784.1,53504819,53514285,53504819,53514284,111135670,XM_022485937.1,annexin A7-like,9465
NC_035784.1,53504819,53514285,53504819,53514285,111135670,XM_022485936.1,annexin A7-like,9466
NC_035782.1,39457566,39462323,39457566,39462323,111125852,XM_022470038.1,protein AAR2 homolog,4757
NC_035780.1,32810531,32816679,32810531,32816677,111132803,XM_022480642.1,protein AATF-like,6146
NC_035780.1,32810531,32816679,32810531,32816679,111132803,XM_022480651.1,protein AATF-like,6148
NC_035784.1,38116810,38122405,38116822,38122405,111135308,XM_022485254.1,protein ABHD11-like,5583
NC_035784.1,38116810,38122405,38116810,38122405,111135308,XM_022485253.1,protein ABHD11-like,5595
NC_035785.1,45920655,45927602,45920655,45927602,111101142,XM_022433480.1,protein ABHD13-like,6947
NC_035780.1,50969777,50978804,50969777,50978804,111124481,XM_022467356.1,protein ABHD13-like,9027
NC_035782.1,75021356,75024078,75021356,75024078,111123086,XM_022465183.1,protein ABHD14B-like,2722
NC_035782.1,75008775,75015821,75008936,75015821,111124732,XM_022467880.1,protein ABHD14B-like,6885
NC_035782.1,75008775,75015821,75008923,75015821,111124732,XM_022467883.1,protein ABHD14B-like,6898
NC_035782.1,75008775,75015821,75008775,75015821,111124732,XM_022467882.1,protein ABHD14B-like,7046
NC_035782.1,73190030,73197766,73190030,73197389,111125658,XM_022469679.1,protein ABHD14B-like,7359
NC_035782.1,73190030,73197766,73190030,73197766,111125658,XM_022469678.1,protein ABHD14B-like,7736
NC_035784.1,28614982,28632121,28615850,28632121,111137942,XM_022489656.1,protein ABHD15-like,16271
NC_035784.1,28614982,28632121,28614982,28632121,111137942,XM_022489657.1,protein ABHD15-like,17139
NC_035784.1,50346230,50348823,50346230,50348823,111133719,XM_022482337.1,protein ABHD15-like,2593
NC_035784.1,28614982,28632121,28628777,28632121,111137942,XM_022489655.1,protein ABHD15-like,3344
NC_035784.1,28614982,28632121,28628344,28632121,111137942,XM_022489654.1,protein ABHD15-like,3777
NC_035782.1,61071497,61080582,61071674,61080582,111125297,XM_022468916.1,protein ABHD16A-like,8908
NC_035782.1,61071497,61080582,61071497,61080582,111125297,XM_022468914.1,protein ABHD16A-like,9085
NC_035783.1,6659037,6663647,6659037,6663647,111130508,XM_022477652.1,protein ABHD17B-like,4610
NC_035783.1,4426271,4435214,4426271,4435214,111130216,XM_022476999.1,protein ABHD17B-like,8943
NC_035782.1,47273903,47281270,47273903,47281270,111126065,XM_022470457.1,protein ABHD18-like,7367
NC_035780.1,62649872,62656297,62649872,62656297,111133709,XM_022482330.1,phospholipase ABHD3-like,6425
NC_035784.1,61334618,61339561,61334618,61339305,111132172,XM_022479931.1,protein ABHD4-like,4687
NC_035784.1,61334618,61339561,61334618,61339462,111132172,XM_022479934.1,protein ABHD4-like,4844
NC_035784.1,61334618,61339561,61334618,61339504,111132172,XM_022479933.1,protein ABHD4-like,4886
NC_035784.1,61334618,61339561,61334618,61339561,111132172,XM_022479932.1,protein ABHD4-like,4943
NC_035783.1,42660651,42677375,42660651,42677375,111129670,XM_022476131.1,probable ADP-dependent glucokinase,16724
NC_035781.1,7352343,7354761,7352343,7354761,111117911,XM_022457144.1,manganese-dependent ADP-ribose/CDP-alcohol diphosphatase-like,2418
NC_035788.1,56610315,56620501,56610315,56620501,111115838,XM_022454700.1,protein AF-10-like,10186
NC_035783.1,2552850,2571190,2552850,2571190,111130564,XM_022477722.1,protein AF-9-like,18340
NC_035781.1,45237955,45238983,45237955,45238983,111120339,XM_022461062.1,protein ALP1-like,1028
NC_035782.1,9279032,9280090,9279032,9280090,111122826,XM_022464816.1,protein ALP1-like,1058
NC_035788.1,83145679,83146773,83145679,83146773,111114214,XM_022452498.1,protein ALP1-like,1094
NC_035786.1,44367161,44368459,44367161,44368459,111105093,XM_022439266.1,protein ALP1-like,1298
NC_035784.1,74473594,74474914,74473594,74474914,111132585,XM_022480413.1,protein ALP1-like,1320
NC_035789.1,16695072,16696412,16695072,16696412,111116390,XM_022455379.1,protein ALP1-like,1340
NC_035788.1,23494512,23495889,23494512,23495889,111113628,XM_022451921.1,protein ALP1-like,1377
NC_035789.1,6289004,6290956,6289004,6290809,111116628,XM_022455625.1,protein ALP1-like,1805
NC_035789.1,6289004,6290956,6289004,6290956,111116628,XM_022455626.1,protein ALP1-like,1952
NC_035788.1,101826587,101846355,101826587,101846355,111114425,XM_022452716.1,protein ALP1-like,19768
NC_035780.1,20386897,20389701,20387639,20389701,111122496,XM_022464281.1,protein ALP1-like,2062
NC_035788.1,83388705,83390856,83388705,83390856,111115945,XM_022454872.1,protein ALP1-like,2151
NC_035780.1,30864554,30867010,30864554,30867010,111106892,XM_022441776.1,protein ALP1-like,2456
NC_035780.1,20386897,20389701,20386897,20389701,111122496,XM_022464272.1,protein ALP1-like,2804
NC_035786.1,30201584,30202405,30201584,30202405,111104997,XM_022439175.1,protein ALP1-like,821
NC_035789.1,22355708,22358989,22355708,22358989,111116488,XM_022455483.1,protein AMBP-like,3281
NC_035785.1,40059253,40063020,40059253,40063020,111101483,XM_022433992.1,protein AMN1 homolog,3767
NC_035783.1,39574901,39580291,39574901,39580291,111129658,XM_022476119.1,cyclic AMP receptor-like protein A,5390
NC_035780.1,8189591,8196705,8189591,8196705,111100957,XM_022433140.1,cyclic AMP-dependent transcription factor ATF-7-like,7114
NC_035783.1,619079,625429,619079,625429,111128897,XM_022474844.1,cyclic AMP-responsive element-binding protein 3-like protein 3,6350
NC_035780.1,164820,166793,164820,166793,111105685,XM_022440042.1,protein ANTAGONIST OF LIKE HETEROCHROMATIN PROTEIN 1-like,1973
NC_035782.1,63120655,63127879,63120655,63127879,111126706,XM_022471528.1,suppressor APC domain-containing protein 2-like,7224
NC_035784.1,2173118,2183817,2173118,2183817,111136847,XM_022487976.1,protein APCDD1-like,10699
NC_035780.1,30877592,30879749,30877592,30879749,111103708,XM_022437155.1,aquaporin AQPAe.a-like,2157
NC_035780.1,30880243,30882534,30880243,30882534,111102415,XM_022435126.1,aquaporin AQPAe.a-like,2291
NC_035784.1,22243073,22247099,22243073,22246656,111136677,XM_022487711.1,aquaporin AQPAe.a-like,3583
NC_035784.1,22243073,22247099,22243075,22247099,111136677,XM_022487713.1,aquaporin AQPAe.a-like,4024
NC_035780.1,35914675,35930906,35914675,35930906,111137861,XM_022489566.1,aquaporin AQPAn.G-like,16231
NC_035780.1,35914675,35930906,35914675,35921787,111137861,XM_022489559.1,aquaporin AQPAn.G-like,7112
NC_035784.1,80951826,80970849,80951826,80970849,111132146,XM_022479879.1,helicase ARIP4-like,19023
NC_035787.1,38044159,38064188,38044159,38064188,111107910,XM_022443316.1,helicase ARIP4-like,20029
NC_035783.1,34342921,34346467,34342921,34346456,111128071,XM_022473483.1,protein ARV1-like,3535
NC_035783.1,34342921,34346467,34342921,34346467,111128071,XM_022473482.1,protein ARV1-like,3546
NC_035783.1,44027740,44031330,44027740,44031321,111130291,XM_022477142.1,protein ARV1-like,3581
NC_035783.1,44027740,44031330,44027740,44031330,111130291,XM_022477143.1,protein ARV1-like,3590
NC_035781.1,30350323,30356277,30350323,30356277,111120831,XM_022461819.1,ATPase ASNA1 homolog,5954
NC_035781.1,1501971,1508876,1501971,1508876,111118217,XM_022457557.1,BRCA1-associated ATM activator 1-like,6905
NC_035781.1,33931565,33936596,33931565,33936596,111119450,XM_022459638.1,putative ATP synthase subunit f,5031
NC_035781.1,39425731,39430622,39425731,39430622,111120288,XM_022461014.1,retinal-specific ATP-binding cassette transporter-like,4891
NC_035780.1,7504984,7518262,7504984,7518262,111111488,XM_022448499.1,probable ATP-dependent RNA helicase DDX58,13278
NC_035780.1,39318757,39327922,39318757,39327922,111128113,XM_022473573.1,sodium/potassium-transporting ATPase subunit beta-1-interacting protein 3-like,9165
NC_035785.1,574773,584774,574773,584774,111100275,XM_022431962.1,AFG1-like ATPase,10001
NC_035785.1,16679529,16699890,16679529,16699890,111099723,XM_022431140.1,proteasomal ATPase-associated factor 1-like,20361
NC_035781.1,12706898,12708405,12706898,12708405,111121384,XM_022462652.1,protein Asterix-like,1507
NC_035783.1,19837962,19842499,19837962,19842499,111130180,XM_022476945.1,calcineurin B homologous protein 1-like,4537
NC_035781.1,34042691,34053730,34042691,34053730,111119429,XM_022459617.1,phospholipase B-like 1,11039
NC_035784.1,36871981,36882607,36871981,36882607,111137717,XM_022489330.1,carboxypeptidase B-like,10626
NC_035784.1,36884997,36895832,36885008,36895804,111137716,XM_022489328.1,carboxypeptidase B-like,10796
NC_035784.1,36884997,36895832,36884997,36895832,111137716,XM_022489329.1,carboxypeptidase B-like,10835
NC_035782.1,22196226,22207259,22196226,22207259,111126259,XM_022470770.1,arylsulfatase B-like,11033
NC_035783.1,4687718,4699719,4687718,4699719,111128025,XM_022473392.1,arylsulfatase B-like,12001
NC_035783.1,6378769,6391593,6378769,6391593,111128443,XM_022474049.1,arylsulfatase B-like,12824
NC_035784.1,17747783,17761138,17747783,17761138,111137258,XM_022488648.1,carboxypeptidase B-like,13355
NC_035782.1,47788055,47789625,47788055,47789625,111122624,XM_022464441.1,neurocalcin-delta B-like,1570
NC_035782.1,17644473,17674474,17644633,17674474,111127587,XM_022472820.1,arylsulfatase B-like,29841
NC_035782.1,17644473,17674474,17644473,17674474,111127587,XM_022472819.1,arylsulfatase B-like,30001
NC_035789.1,8839338,8881477,8839338,8881477,111117904,XM_022457140.1,protogenin B-like,42139
NC_035782.1,39012453,39017363,39012453,39017363,111123113,XM_022465225.1,arylsulfatase B-like,4910
NC_035782.1,52117964,52123011,52117964,52123011,111126375,XM_022470946.1,chymotrypsinogen B-like,5047
NC_035784.1,25950491,25956220,25950491,25956220,111134946,XM_022484544.1,carboxypeptidase B-like,5729
NC_035780.1,6618151,6624011,6618151,6624011,111111564,XM_022448615.1,cathepsin B-like,5860
NC_035784.1,17747783,17761138,17755114,17761138,111137258,XM_022488649.1,carboxypeptidase B-like,6024
NC_035789.1,926108,932562,926108,932562,111117753,XM_022456984.1,carboxypeptidase B-like,6454
NC_035782.1,38390610,38397272,38390610,38397272,111126700,XM_022471522.1,arylsulfatase B-like,6662
NC_035782.1,39003617,39010927,39003617,39010927,111122842,XM_022464850.1,arylsulfatase B-like,7310
NC_035782.1,38380997,38388902,38380997,38388902,111126699,XM_022471520.1,arylsulfatase B-like,7905
NC_035782.1,17644473,17674474,17644633,17653802,111127587,XM_022472821.1,arylsulfatase B-like,9169
NC_035784.1,51202650,51212323,51202650,51212323,111135087,XM_022484819.1,arylsulfatase B-like,9673
NC_035782.1,21907620,21917462,21907620,21917462,111126258,XM_022470769.1,arylsulfatase B-like,9842
NC_035788.1,62916194,62926407,62916194,62926407,111111363,XM_022448304.1,phospholipase B1,10213
NC_035787.1,36986853,36989304,36986853,36989304,111108796,XM_022444879.1,serpin B6-like,2451
NC_035786.1,47881777,47886145,47881777,47886145,111104594,XM_022438615.1,snaclec B6-like,4368
NC_035784.1,83981926,83986308,83981926,83986308,111134011,XM_022482777.1,snaclec B6-like,4382
NC_035781.1,26043103,26047489,26043103,26047489,111121056,XM_022462159.1,annexin B9-like,4386
NC_035782.1,22948482,22953687,22948482,22953687,111125921,XM_022470164.1,maternal B9.10 protein-like,5205
NC_035784.1,47202806,47213122,47202806,47213122,111135050,XM_022484743.1,protein BANP-like,10316
NC_035785.1,13998560,14006002,13998560,14006002,111101157,XM_022433503.1,protein BCCIP homolog,7442
NC_035784.1,31252586,31257677,31252586,31257677,111133920,XM_022482654.1,alkyl/aryl-sulfatase BDS1-like,5091
NC_035784.1,31465099,31470808,31465099,31470808,111132996,XM_022481014.1,alkyl/aryl-sulfatase BDS1-like,5709
NC_035784.1,15417968,15425749,15417968,15425689,111136256,XM_022486966.1,alkyl/aryl-sulfatase BDS1-like,7721
NC_035784.1,15417968,15425749,15417968,15425749,111136256,XM_022486967.1,alkyl/aryl-sulfatase BDS1-like,7781
NC_035784.1,61164207,61167865,61164867,61167482,111133421,XM_022481839.1,lectin BRA-3-like,2615
NC_035784.1,61164207,61167865,61164816,61167482,111133421,XM_022481833.1,lectin BRA-3-like,2666
NC_035780.1,8583544,8586379,8583544,8586379,111123981,XM_022466776.1,lectin BRA-3-like,2835
NC_035784.1,61164207,61167865,61164407,61167482,111133421,XM_022481840.1,lectin BRA-3-like,3075
NC_035784.1,61164207,61167865,61164376,61167482,111133421,XM_022481834.1,lectin BRA-3-like,3106
NC_035784.1,61164207,61167865,61164207,61167482,111133421,XM_022481831.1,lectin BRA-3-like,3275
NC_035780.1,8602090,8605789,8602090,8605371,111123967,XM_022466738.1,lectin BRA-3-like,3281
NC_035784.1,60693579,60697063,60693579,60697063,111137083,XM_022488334.1,lectin BRA-3-like,3484
NC_035784.1,61164207,61167865,61164376,61167865,111133421,XM_022481841.1,lectin BRA-3-like,3489
NC_035789.1,31987775,31991394,31987775,31991394,111116210,XM_022455194.1,lectin BRA-3-like,3619
NC_035780.1,8602090,8605789,8602090,8605789,111123967,XM_022466748.1,lectin BRA-3-like,3699
NC_035789.1,8555149,8559107,8555149,8559107,111116251,XM_022455238.1,lectin BRA-3-like,3958
NC_035784.1,61169333,61175113,61169333,61175113,111133420,XM_022481830.1,lectin BRA-3-like,5780
NC_035783.1,58305162,58311500,58305162,58311500,111130973,XM_022478282.1,lectin BRA-3-like,6338
NC_035783.1,482936,489751,482936,489751,111130752,XM_022477978.1,lectin BRA-3-like,6815
NC_035788.1,10929289,10936495,10929289,10936495,111112831,XM_022450672.1,lectin BRA-3-like,7206
NC_035784.1,41767958,41775508,41767958,41775508,111135458,XM_022485549.1,lectin BRA-3-like,7550
NC_035787.1,32270927,32273344,32270927,32273344,111109780,XM_022446013.1,protein BRICK1-like,2417
NC_035787.1,33601517,33605435,33601517,33605435,111108074,XM_022443597.1,protein BRICK1-like,3918
NC_035784.1,80150659,80184534,80150659,80184534,111138340,XM_022490257.1,rho-related BTB domain-containing protein 1-like,33875
NC_035787.1,14421784,14423117,14421784,14423117,111106649,XM_022441401.1,protein BTG1-like,1333
NC_035781.1,56586193,56588414,56586193,56588414,111119654,XM_022460056.1,protein BUD31 homolog,2221
NC_035784.1,40759688,40762272,40759688,40762272,111137941,XM_022489653.1,prokineticin Bm8-f-like,2584
NC_035782.1,295809,297761,295809,297761,111125266,XM_022468864.1,fibrinogen C domain-containing protein 1-like,1952
NC_035781.1,5175917,5180971,5175917,5180971,111121913,XM_022463399.1,troponin C-like,5054
NC_035786.1,49597349,49622146,49597349,49622146,111104359,XM_022438262.1,probable C-mannosyltransferase DPY19L3,24797
NC_035782.1,61092497,61098547,61092497,61098547,111125801,XM_022469935.1,box C/D snoRNA protein 1-like,6050
NC_035780.1,380454,392035,380454,392035,111117743,XM_022457001.1,Niemann-Pick C1 protein-like,11581
NC_035782.1,50887696,50892180,50887696,50892180,111123061,XM_022465151.1,protein C10-like,4484
NC_035781.1,7410559,7432544,7410559,7432544,111121297,XM_022462508.1,protein C12orf4 homolog,21985
NC_035780.1,17423636,17425500,17423636,17425500,111109589,XM_022445775.1,complement C1q tumor necrosis factor-related protein 3-like,1864
NC_035780.1,17674733,17677979,17674733,17677979,111106075,XM_022440600.1,complement C1q-like protein 2,3246
NC_035783.1,47701012,47755135,47701012,47755129,111129483,XM_022475891.1,multiple C2 and transmembrane domain-containing protein 1-like,54117
NC_035784.1,55415759,55440339,55415759,55440339,111134059,XM_022482849.1,double C2-like domain-containing protein beta,24580
NC_035780.1,44678485,44683379,44678485,44683379,111120614,XM_022461465.1,protein C21orf2-like,4894
NC_035780.1,45258909,45264055,45258909,45264055,111120130,XM_022460847.1,protein C21orf2-like,5146
NC_035781.1,13219550,13230271,13219550,13230271,111118435,XM_022457914.1,ras-related C3 botulinum toxin substrate 1-like,10721
NC_035784.1,60246924,60269307,60246924,60269307,111138123,XM_022489943.1,complement C3-like,22383
NC_035784.1,41225993,41249582,41238769,41249582,111135825,XM_022486214.1,D-glucuronyl C5-epimerase-like,10813
NC_035784.1,41196745,41208814,41196745,41208814,111135541,XM_022485685.1,D-glucuronyl C5-epimerase-like,12069
NC_035784.1,41225993,41249582,41233894,41249582,111135825,XM_022486215.1,D-glucuronyl C5-epimerase-like,15688
NC_035784.1,41225993,41249582,41233793,41249582,111135825,XM_022486209.1,D-glucuronyl C5-epimerase-like,15789
NC_035784.1,41225993,41249582,41232537,41249582,111135825,XM_022486210.1,D-glucuronyl C5-epimerase-like,17045
NC_035784.1,41225993,41249582,41225993,41249582,111135825,XM_022486211.1,D-glucuronyl C5-epimerase-like,23589
NC_035784.1,41196745,41208814,41203685,41208814,111135541,XM_022485693.1,D-glucuronyl C5-epimerase-like,5129
NC_035784.1,41196745,41208814,41203312,41208814,111135541,XM_022485691.1,D-glucuronyl C5-epimerase-like,5502
NC_035784.1,41196745,41208814,41203030,41208814,111135541,XM_022485689.1,D-glucuronyl C5-epimerase-like,5784
NC_035784.1,41196745,41208814,41202998,41208814,111135541,XM_022485692.1,D-glucuronyl C5-epimerase-like,5816
NC_035784.1,41196745,41208814,41202544,41208814,111135541,XM_022485688.1,D-glucuronyl C5-epimerase-like,6270
NC_035784.1,41225993,41249582,41242511,41249582,111135825,XM_022486216.1,D-glucuronyl C5-epimerase-like,7071
NC_035784.1,41225993,41249582,41239803,41249582,111135825,XM_022486212.1,D-glucuronyl C5-epimerase-like,9779
NC_035784.1,4407328,4410911,4407328,4410911,111136417,XM_022487254.1,protein C8orf37 homolog,3583
NC_035782.1,15344220,15354917,15344220,15354917,111125832,XM_022469995.1,protein CASC3-like,10697
NC_035782.1,14679081,14687519,14679081,14687519,111123630,XM_022466084.1,protein CASC3-like,8438
NC_035784.1,41004346,41008924,41004346,41008924,111137144,XM_022488456.1,protein CASP-like,4578
NC_035784.1,36621681,36652256,36642072,36652256,111134966,XM_022484585.1,protein CBFA2T1-like,10184
NC_035784.1,36621681,36652256,36637160,36652256,111134966,XM_022484588.1,protein CBFA2T1-like,15096
NC_035784.1,36621681,36652256,36621681,36652256,111134966,XM_022484589.1,protein CBFA2T1-like,30575
NC_035784.1,36621681,36652256,36646230,36652256,111134966,XM_022484582.1,protein CBFA2T1-like,6026
NC_035784.1,36621681,36652256,36646143,36652256,111134966,XM_022484583.1,protein CBFA2T1-like,6113
NC_035784.1,36621681,36652256,36644972,36652256,111134966,XM_022484586.1,protein CBFA2T1-like,7284
NC_035784.1,36621681,36652256,36644971,36652256,111134966,XM_022484584.1,protein CBFA2T1-like,7285
NC_035784.1,83939202,83941140,83939202,83941140,111133931,XM_022482674.1,neuropeptide CCHamide-1 receptor-like,1938
NC_035784.1,7943134,7963549,7943135,7963549,111136858,XM_022487993.1,activated CDC42 kinase 1-like,20414
NC_035780.1,27842437,27852440,27842437,27852440,111131806,XM_022479523.1,protein CDV3 homolog,10003
NC_035786.1,56165213,56185482,56165213,56185482,111104487,XM_022438469.1,protein CIP2A homolog,20269
NC_035781.1,3473166,3517985,3473166,3517985,111119775,XM_022460253.1,protein CLEC16A-like,44819
NC_035780.1,46828425,46842217,46828425,46842217,111126146,XM_022470574.1,B-cell CLL/lymphoma 9 protein-like,13792
NC_035787.1,72643552,72648926,72643552,72648920,111108535,XM_022444502.1,protein CLN8-like,5368
NC_035787.1,72643552,72648926,72643552,72648926,111108535,XM_022444504.1,protein CLN8-like,5374
NC_035786.1,42486923,42490978,42486923,42490978,111103893,XM_022437481.1,protein CMSS1-like,4055
NC_035782.1,57775189,57780238,57775189,57780238,111123208,XM_022465386.1,protein CNPPD1-like,5049
NC_035781.1,7989073,7992079,7989073,7992079,111121899,XM_022463379.1,small COPII coat GTPase SAR1-like,3006
NC_035784.1,67113126,67124110,67113126,67124110,111134536,XM_022483659.1,protein CREBRF homolog,10984
NC_035784.1,13580300,13594528,13580300,13594528,111136506,XM_022487399.1,phosphorylated CTD-interacting factor 1-like,14228
NC_035784.1,66439282,66444194,66439282,66444194,111134501,XM_022483583.1,protein CWC15 homolog A-like,4912
NC_035784.1,74844029,74856978,74844029,74856978,111135461,XM_022485553.1,telomerase Cajal body protein 1-like,12949
NC_035781.1,27869628,27873315,27869628,27873315,111119834,XM_022460351.1,ATP-dependent Clp protease proteolytic subunit-like,3687
NC_035787.1,34126716,34138912,34126716,34138912,111110266,XM_022446688.1,succinate--hydroxymethylglutarate CoA-transferase-like,12196
NC_035787.1,39481407,39488769,39481407,39488769,111109501,XM_022445648.1,succinate--hydroxymethylglutarate CoA-transferase-like,7362
NC_035781.1,53221939,53232501,53221939,53232501,111119941,XM_022460522.1,proteoglycan Cow-like,10562
NC_035785.1,41461045,41478185,41461272,41478185,111100366,XM_022432141.1,putative D-cysteine desulfhydrase 1,16913
NC_035782.1,70783011,70797241,70783011,70797241,111125305,XM_022468926.1,kinase D-interacting substrate of 220 kDa-like,14230
NC_035784.1,32989280,33001136,32989280,33001136,111137877,XM_022489574.1,probable D-lactate dehydrogenase,11856
NC_035784.1,31988304,32008498,31988304,31998320,111134694,XM_022483977.1,carboxypeptidase D-like,10016
NC_035784.1,31988304,32008498,31988304,31998347,111134694,XM_022483979.1,carboxypeptidase D-like,10043
NC_035784.1,30671838,30694986,30684086,30694986,111138443,XM_022490414.1,carboxypeptidase D-like,10900
NC_035784.1,23079741,23081043,23079741,23081043,111137403,XM_022488851.1,apolipoprotein D-like,1302
NC_035784.1,30738412,30739797,30738412,30739797,111137293,XM_022488698.1,apolipoprotein D-like,1385
NC_035782.1,69181168,69182562,69181168,69182562,111126959,XM_022471915.1,apolipoprotein D-like,1394
NC_035784.1,31988304,32008498,31988304,32002402,111134694,XM_022483975.1,carboxypeptidase D-like,14098
NC_035784.1,31950212,31951624,31950212,31951624,111099048,XM_022430391.1,apolipoprotein D-like,1412
NC_035782.1,69653366,69654802,69653366,69654802,111126880,XM_022471791.1,apolipoprotein D-like,1436
NC_035784.1,31988304,32008498,31988304,32003636,111134694,XM_022483976.1,carboxypeptidase D-like,15332
NC_035784.1,23064446,23066010,23064446,23066010,111137400,XM_022488848.1,apolipoprotein D-like,1564
NC_035784.1,23276596,23278215,23276596,23278215,111137402,XM_022488850.1,apolipoprotein D-like,1619
NC_035784.1,37988333,38004696,37988333,38004696,111134706,XM_022484012.1,carboxypeptidase D-like,16363
NC_035781.1,13873037,13874700,13873037,13874700,111118010,XM_022457277.1,apolipoprotein D-like,1663
NC_035784.1,31988304,32008498,31988304,32007368,111134694,XM_022483974.1,carboxypeptidase D-like,19064
NC_035784.1,31988304,32008498,31988304,32008498,111134694,XM_022483973.1,carboxypeptidase D-like,20194
NC_035784.1,30671838,30694986,30673430,30694986,111138443,XM_022490412.1,carboxypeptidase D-like,21556
NC_035784.1,30671838,30694986,30673429,30694986,111138443,XM_022490410.1,carboxypeptidase D-like,21557
NC_035781.1,33517522,33541919,33519111,33541919,111119539,XM_022459785.1,hexosaminidase D-like,22808
NC_035784.1,30671838,30694986,30671845,30694986,111138443,XM_022490411.1,carboxypeptidase D-like,23141
NC_035784.1,30671838,30694986,30671838,30694986,111138443,XM_022490408.1,carboxypeptidase D-like,23148
NC_035781.1,33517522,33541919,33517522,33541919,111119539,XM_022459784.1,hexosaminidase D-like,24397
NC_035784.1,56269003,56273628,56269003,56273628,111134325,XM_022483255.1,apolipoprotein D-like,4625
NC_035788.1,102347222,102352788,102347222,102352788,111110837,XM_022447470.1,apolipoprotein D-like,5566
NC_035784.1,23255240,23261381,23255240,23261381,111137401,XM_022488849.1,apolipoprotein D-like,6141
NC_035788.1,28894495,28900994,28894495,28900994,111110808,XM_022447420.1,apolipoprotein D-like,6499
NC_035784.1,38094095,38104145,38094095,38104145,111099196,XM_022430624.1,bicaudal D-related protein homolog,10050
NC_035783.1,20029376,20031050,20029376,20031050,111129835,XM_022476311.1,probable D-tyrosyl-tRNA(Tyr) deacylase 2,1674
NC_035786.1,46230132,46258578,46230132,46251901,111103356,XM_022436563.1,phospholipase D1-like,21769
NC_035786.1,46230132,46258578,46230132,46251902,111103356,XM_022436561.1,phospholipase D1-like,21770
NC_035786.1,46230132,46258578,46230132,46251903,111103356,XM_022436560.1,phospholipase D1-like,21771
NC_035786.1,46230132,46258578,46230132,46258578,111103356,XM_022436562.1,phospholipase D1-like,28446
NC_035782.1,68159627,68164150,68159627,68164150,111124402,XM_022467253.1,prostaglandin D2 receptor-like,4523
NC_035782.1,53149072,53159658,53149072,53159658,111123192,XM_022465361.1,dopamine D2-like receptor,10586
NC_035780.1,39163621,39168921,39163621,39168921,111132204,XM_022480339.1,vitamin D3 receptor A-like,5300
NC_035783.1,48181499,48201778,48181499,48201778,111130425,XM_022477495.1,phospholipase D3-like,20279
NC_035780.1,60632370,60642556,60632370,60642556,111137858,XM_022489588.1,protein D7-like,10186
NC_035787.1,14222342,14236065,14222342,14236065,111107514,XM_022442740.1,protein DD3-3-like,13723
NC_035787.1,14204134,14222108,14204134,14222108,111107512,XM_022442739.1,protein DD3-3-like,17974
NC_035781.1,26973277,26977309,26973277,26977309,111122090,XM_022463646.1,protein DDB_G0287365-like,4032
NC_035781.1,31447294,31455360,31447294,31455360,111120237,XM_022460963.1,protein DDB_G0287365-like,8066
NC_035788.1,52262230,52277264,52262230,52277264,111114520,XM_022452859.1,phospholipase DDHD1-like,15034
NC_035785.1,44045676,44056190,44045676,44056190,111100371,XM_022432147.1,phospholipase DDHD2-like,10514
NC_035784.1,19604663,19610348,19604663,19610348,111132361,XM_022480165.1,protein DDI1 homolog 2-like,5685
NC_035782.1,45442858,45451324,45442858,45451324,111125160,XM_022468691.1,protein DEFECTIVE IN EXINE FORMATION 1-like,8466
NC_035781.1,46254285,46264453,46254285,46264453,111122250,XM_022463896.1,protein DEK-like,10168
NC_035781.1,46505461,46517331,46505461,46517331,111121908,XM_022463395.1,protein DEK-like,11870
NC_035787.1,69806925,69820975,69806925,69820969,111108534,XM_022444499.1,protein DENND6A-like,14044
NC_035787.1,69806925,69820975,69806925,69820975,111108534,XM_022444500.1,protein DENND6A-like,14050
NC_035787.1,71796126,71811118,71796126,71811093,111108782,XM_022444859.1,protein DENND6A-like,14967
NC_035787.1,71796126,71811118,71796126,71811118,111108782,XM_022444858.1,protein DENND6A-like,14992
NC_035784.1,48390265,48398887,48390265,48398887,111136119,XM_022486748.1,protein DGCR14-like,8622
NC_035785.1,24874391,24890136,24874391,24889336,111100571,XM_022432589.1,protein DGCR6-like,14945
NC_035785.1,49367511,49371759,49367511,49371759,111100062,XM_022431654.1,protein DGCR6-like,4248
NC_035785.1,24874391,24890136,24880147,24889985,111100571,XM_022432587.1,protein DGCR6-like,9838
NC_035785.1,24874391,24890136,24880147,24890131,111100571,XM_022432586.1,protein DGCR6-like,9984
NC_035785.1,24874391,24890136,24880147,24890136,111100571,XM_022432588.1,protein DGCR6-like,9989
NC_035780.1,27838009,27841914,27838009,27841914,111101925,XM_022434582.1,protein DJ-1-like,3905
NC_035780.1,3590620,3602303,3590620,3602303,111129935,XM_022476490.1,ATP-dependent DNA helicase Q1-like,11683
NC_035780.1,6276925,6279500,6276925,6279500,111137514,XM_022489028.1,myb/SANT-like DNA-binding domain-containing protein 4,2575
NC_035784.1,80688929,80695732,80688929,80695732,111133963,XM_022482709.1,DNA-directed DNA/RNA polymerase mu-like,6803
NC_035784.1,63579247,63582020,63579247,63582010,111134186,XM_022483026.1,protein DPCD-like,2763
NC_035784.1,63579247,63582020,63579247,63582020,111134186,XM_022483025.1,protein DPCD-like,2773
NC_035788.1,101337634,101341038,101337634,101341038,111112150,XM_022449516.1,exonuclease DPD1,3404
NC_035787.1,6654162,6666092,6654162,6666092,111106699,XM_022441479.1,cysteine-rich DPF motif domain-containing protein 1-like,11930
NC_035788.1,86834545,86841240,86834545,86841240,111115323,XM_022454003.1,isopentenyl-diphosphate Delta-isomerase 1-like,6695
NC_035783.1,15036330,15052449,15036330,15052449,111129524,XM_022475975.1,endoribonuclease Dicer-like,16119
NC_035783.1,26037425,26044555,26037425,26044555,111130864,XM_022478123.1,lamin Dm0-like,7130
NC_035787.1,69285765,69288821,69285765,69288821,111109889,XM_022446150.1,putative Dol-P-Glc:Glc(2)Man(9)GlcNAc(2)-PP-Dol alpha-1,3056
NC_035782.1,51244226,51248331,51244226,51248275,111123735,XM_022466275.1,protein Dr1-like,4049
NC_035782.1,51244226,51248331,51244226,51248331,111123735,XM_022466274.1,protein Dr1-like,4105
NC_035781.1,23256672,23257991,23256672,23257991,111122227,XM_022463868.1,class E basic helix-loop-helix protein 23-like,1319
NC_035784.1,24045936,24057348,24045936,24057348,111132618,XM_022480445.1,endoglucanase E-4-like,11412
NC_035781.1,20766403,20774066,20766403,20774066,111120630,XM_022461490.1,carboxypeptidase E-like,7663
NC_035784.1,76394589,76395710,76394589,76395710,111132605,XM_022480434.1,enolase-phosphatase E1-like,1121
NC_035783.1,20913624,20917284,20913624,20917284,111131439,XM_022478975.1,enolase-phosphatase E1-like,3660
NC_035783.1,43081929,43090636,43081929,43090636,111129675,XM_022476137.1,enolase-phosphatase E1-like,8707
NC_035784.1,85673448,85683888,85673448,85683888,111134642,XM_022483870.1,BCL2/adenovirus E1B 19 kDa protein-interacting protein 3-like,10440
NC_035781.1,1411747,1416541,1411747,1416541,111121460,XM_022462756.1,prostaglandin E2 receptor EP4 subtype-like,4794
NC_035780.1,21859725,21863490,21859725,21863490,111101725,XM_022434495.1,probable E3 ubiquitin-protein ligase MID2,3765
NC_035781.1,706423,722389,706423,722389,111120128,XM_022460836.1,kelch-like ECH-associated protein 1,15966
NC_035785.1,41556806,41569385,41556806,41568655,111100962,XM_022433142.1,protein ECT2-like,11849
NC_035785.1,41556806,41569385,41556806,41569385,111100962,XM_022433141.1,protein ECT2-like,12579
NC_035784.1,12497195,12503862,12497195,12503862,111133892,XM_022482615.1,N-terminal EF-hand calcium-binding protein 1-like,6667
NC_035781.1,5980806,5987853,5980806,5987853,111118941,XM_022458664.1,cadherin EGF LAG seven-pass G-type receptor 3-like,7047
NC_035784.1,3447387,3467267,3447387,3467267,111137601,XM_022489124.1,protein ELYS-like,19880
NC_035786.1,42491056,42496291,42491056,42496291,111104670,XM_022438740.1,bis(5'-adenosyl)-triphosphatase ENPP4-like,5235
NC_035788.1,10778867,10890866,10778867,10890866,111112828,XM_022450667.1,protein ERGIC-53-like,111999
NC_035789.1,31939910,31952558,31939910,31952558,111117689,XM_022456853.1,protein ERGIC-53-like,12648
NC_035788.1,10778867,10890866,10778867,10802990,111112828,XM_022450666.1,protein ERGIC-53-like,24123
NC_035781.1,49778065,49784412,49778065,49784412,111118633,XM_022458193.1,N-acetyltransferase ESCO2-like,6347
NC_035781.1,48109132,48118349,48109132,48117218,111118225,XM_022457566.1,N-acetyltransferase ESCO2-like,8086
NC_035781.1,48109132,48118349,48109132,48118349,111118225,XM_022457567.1,N-acetyltransferase ESCO2-like,9217
NC_035788.1,87921353,87924695,87921353,87924695,111111845,XM_022449015.1,nuclease EXOG,3342
NC_035788.1,89385311,89390432,89385311,89390432,111111711,XM_022448844.1,nuclease EXOG,5121
NC_035784.1,83990738,84031054,83990738,84031054,111133327,XM_022481614.1,CUGBP Elav-like family member 2,40316
NC_035786.1,41453825,41472852,41453825,41472852,111103994,XM_022437669.1,ralBP1-associated Eps domain-containing protein 1-like,19027
NC_035784.1,27912906,27925218,27912906,27925218,111135312,XM_022485257.1,GTPase Era,12312
NC_035782.1,69149210,69156322,69149210,69156322,111123287,XM_022465530.1,prostamide/prostaglandin F synthase-like,7112
NC_035784.1,77030054,77054666,77030054,77054666,111134579,XM_022483733.1,uncharacterized F-box/LRR-repeat protein C02F5.7-like,24612
NC_035783.1,13432765,13434863,13432765,13434863,111128185,XM_022473670.1,selenoprotein F-like,2098
NC_035782.1,68142477,68145809,68142477,68145809,111124401,XM_022467252.1,prostaglandin F2-alpha receptor-like,3332
NC_035780.1,43539495,43543434,43539495,43543434,111113657,XM_022451952.1,uncharacterized FAD-linked oxidoreductase ARB_02478-like,3939
NC_035783.1,28911067,28912855,28911067,28912855,111129423,XM_022475796.1,acylpyruvase FAHD1,1788
NC_035785.1,32156000,32160358,32156216,32160301,111100973,XM_022433154.1,acylpyruvase FAHD1,4085
NC_035785.1,32156000,32160358,32156000,32160358,111100973,XM_022433153.1,acylpyruvase FAHD1,4358
NC_035782.1,61310775,61325880,61310775,61325880,111123998,XM_022466827.1,protein FAM102A-like,15105
NC_035787.1,54247634,54275236,54261596,54275236,111107765,XM_022443112.1,protein FAM107B-like,13640
NC_035787.1,54247634,54275236,54256958,54275236,111107765,XM_022443111.1,protein FAM107B-like,18278
NC_035787.1,54247634,54275236,54247634,54275236,111107765,XM_022443110.1,protein FAM107B-like,27602
NC_035781.1,39486511,39496569,39486554,39496569,111121373,XM_022462637.1,protein FAM110B-like,10015
NC_035781.1,39486511,39496569,39486511,39496569,111121373,XM_022462635.1,protein FAM110B-like,10058
NC_035781.1,39376931,39387730,39376931,39387730,111121291,XM_022462494.1,protein FAM110B-like,10799
NC_035781.1,39376931,39387730,39376931,39382693,111121291,XM_022462491.1,protein FAM110B-like,5762
NC_035781.1,39376931,39387730,39376931,39383706,111121291,XM_022462492.1,protein FAM110B-like,6775
NC_035781.1,39486511,39496569,39489786,39496569,111121373,XM_022462638.1,protein FAM110B-like,6783
NC_035781.1,39486511,39496569,39489779,39496569,111121373,XM_022462634.1,protein FAM110B-like,6790
NC_035781.1,39486511,39496569,39489190,39496569,111121373,XM_022462636.1,protein FAM110B-like,7379
NC_035782.1,29194375,29203800,29194375,29203800,111126499,XM_022471186.1,protein FAM114A2-like,9425
NC_035784.1,92380907,92387726,92380907,92387701,111134605,XM_022483775.1,protein FAM122A-like,6794
NC_035784.1,92380907,92387726,92380907,92387726,111134605,XM_022483776.1,protein FAM122A-like,6819
NC_035784.1,73055688,73071671,73055688,73071671,111135462,XM_022485554.1,protein FAM124A-like,15983
NC_035784.1,73055688,73071671,73055688,73057807,111135462,XM_022485557.1,protein FAM124A-like,2119
NC_035780.1,2836338,2838568,2836338,2838568,111099831,XM_022431333.1,protein FAM124A-like,2230
NC_035784.1,73055688,73071671,73055688,73058070,111135462,XM_022485558.1,protein FAM124A-like,2382
NC_035784.1,73055688,73071671,73055689,73062016,111135462,XM_022485556.1,protein FAM124A-like,6327
NC_035784.1,73055688,73071671,73055689,73064151,111135462,XM_022485555.1,protein FAM124A-like,8462
NC_035782.1,8316787,8322400,8316787,8322400,111122718,XM_022464597.1,protein FAM126B-like,5613
NC_035780.1,11106484,11109550,11106484,11109550,111131159,XM_022478564.1,protein FAM133B-like,3066
NC_035784.1,45818228,45827813,45818228,45827813,111134865,XM_022484350.1,protein FAM133B-like,9585
NC_035781.1,4339171,4361128,4339177,4361128,111118654,XM_022458211.1,protein FAM135A-like,21951
NC_035781.1,4339171,4361128,4339171,4361128,111118654,XM_022458212.1,protein FAM135A-like,21957
NC_035783.1,30859339,30861125,30859339,30861020,111130791,XM_022478029.1,protein FAM136A-like,1681
NC_035783.1,30859339,30861125,30859339,30861117,111130791,XM_022478030.1,protein FAM136A-like,1778
NC_035783.1,30859339,30861125,30859340,30861125,111130791,XM_022478031.1,protein FAM136A-like,1785
NC_035783.1,30862457,30866601,30862457,30866601,111131044,XM_022478373.1,protein FAM136A-like,4144
NC_035781.1,48684541,48709329,48684541,48704668,111119077,XM_022458893.1,protein FAM13A-like,20127
NC_035781.1,48684541,48709329,48684541,48704794,111119077,XM_022458894.1,protein FAM13A-like,20253
NC_035781.1,48684541,48709329,48684541,48709329,111119077,XM_022458895.1,protein FAM13A-like,24788
NC_035781.1,49167988,49196227,49167988,49196227,111119253,XM_022459248.1,protein FAM13A-like,28239
NC_035781.1,48983080,49017599,48985343,49000124,111118823,XM_022458466.1,protein FAM149B1-like,14781
NC_035781.1,48983080,49017599,48985314,49000124,111118823,XM_022458464.1,protein FAM149B1-like,14810
NC_035781.1,48983080,49017599,48983080,49000117,111118823,XM_022458467.1,protein FAM149B1-like,17037
NC_035781.1,48983080,49017599,48983080,49000118,111118823,XM_022458461.1,protein FAM149B1-like,17038
NC_035781.1,48983080,49017599,48983080,49000119,111118823,XM_022458460.1,protein FAM149B1-like,17039
NC_035781.1,48983080,49017599,48983080,49000123,111118823,XM_022458469.1,protein FAM149B1-like,17043
NC_035781.1,48983080,49017599,48983080,49000124,111118823,XM_022458462.1,protein FAM149B1-like,17044
NC_035781.1,48983080,49017599,48983080,49008766,111118823,XM_022458468.1,protein FAM149B1-like,25686
NC_035781.1,48983080,49017599,48983080,49017599,111118823,XM_022458470.1,protein FAM149B1-like,34519
NC_035784.1,96086825,96130827,96086825,96130827,111135972,XM_022486480.1,protein FAM160B1-like,44002
NC_035783.1,42292989,42298521,42292989,42298521,111130378,XM_022477399.1,protein FAM161A-like,5532
NC_035782.1,69881132,69886208,69881132,69886208,111123791,XM_022466361.1,protein FAM166B-like,5076
NC_035782.1,36953970,36961181,36953970,36961181,111127099,XM_022472120.1,protein FAM166B-like,7211
NC_035782.1,36040314,36047574,36040314,36047574,111126374,XM_022470945.1,protein FAM166B-like,7260
NC_035780.1,33769615,33779869,33769615,33779869,111119612,XM_022459968.1,protein FAM167A-like,10254
NC_035780.1,32721224,32734817,32721224,32731620,111137110,XM_022488389.1,protein FAM167A-like,10396
NC_035781.1,6532927,6534103,6532927,6534103,111118313,XM_022457705.1,protein FAM167A-like,1176
NC_035780.1,32721224,32734817,32721224,32733077,111137110,XM_022488410.1,protein FAM167A-like,11853
NC_035780.1,32721224,32734817,32721224,32734817,111137110,XM_022488400.1,protein FAM167A-like,13593
NC_035781.1,6615598,6617762,6615598,6617762,111120627,XM_022461485.1,protein FAM167A-like,2164
NC_035780.1,33765496,33768351,33765496,33768351,111126308,XM_022471260.1,protein FAM167A-like,2855
NC_035786.1,33493911,33497765,33493911,33497765,111104619,XM_022438642.1,protein FAM167A-like,3854
NC_035780.1,33769615,33779869,33769615,33777739,111119612,XM_022459963.1,protein FAM167A-like,8124
NC_035780.1,32721224,32734817,32721224,32731034,111137110,XM_022488378.1,protein FAM167A-like,9810
NC_035783.1,15194221,15204807,15194225,15204807,111131113,XM_022478487.1,protein FAM172A-like,10582
NC_035783.1,15194221,15204807,15194224,15204807,111131113,XM_022478486.1,protein FAM172A-like,10583
NC_035783.1,15194221,15204807,15194221,15204807,111131113,XM_022478488.1,protein FAM172A-like,10586
NC_035782.1,56978631,56987876,56978631,56987876,111122846,XM_022464853.1,protein FAM173B-like,9245
NC_035783.1,41123376,41126925,41123376,41126925,111128145,XM_022473610.1,protein FAM177A1-like,3549
NC_035783.1,40615554,40619193,40615554,40619193,111128202,XM_022473693.1,protein FAM177A1-like,3639
NC_035781.1,845886,847910,845886,847910,111120088,XM_022460751.1,protein FAM183B-like,2024
NC_035784.1,65720998,65731741,65720998,65731741,111136162,XM_022486813.1,protein FAM184A-like,10743
NC_035788.1,25349035,25424365,25349035,25383360,111112260,XM_022449672.1,protein FAM184A-like,34325
NC_035788.1,25349035,25424365,25349035,25391058,111112260,XM_022449670.1,protein FAM184A-like,42023
NC_035788.1,25349035,25424365,25349035,25410088,111112260,XM_022449673.1,protein FAM184A-like,61053
NC_035788.1,25349035,25424365,25349035,25424365,111112260,XM_022449666.1,protein FAM184A-like,75330
NC_035787.1,52098410,52105481,52098410,52105481,111108786,XM_022444866.1,protein FAM185A-like,7071
NC_035784.1,23467130,23482589,23467130,23482589,111133012,XM_022481043.1,protein FAM192A-like,15459
NC_035784.1,69361685,69380539,69361685,69380539,111135586,XM_022485785.1,protein FAM193A-like,18854
NC_035780.1,4528857,4535657,4528857,4535657,111118316,XM_022457722.1,protein FAM199X-like,6800
NC_035780.1,3696069,3702892,3696069,3702892,111118727,XM_022458328.1,protein FAM199X-like,6823
NC_035782.1,63691743,63692969,63691743,63692969,111124364,XM_022467213.1,protein FAM200B-like,1226
NC_035782.1,63683498,63684179,63683498,63684179,111124363,XM_022467212.1,protein FAM200B-like,681
NC_035784.1,82518183,82566248,82536685,82547216,111138265,XM_022490144.1,protein FAM204A-like,10531
NC_035784.1,82518183,82566248,82537762,82566248,111138265,XM_022490143.1,protein FAM204A-like,28486
NC_035784.1,82518183,82566248,82518183,82547216,111138265,XM_022490145.1,protein FAM204A-like,29033
NC_035784.1,82506057,82527732,82506057,82513444,111138264,XM_022490141.1,protein FAM204A-like,7387
NC_035784.1,82506057,82527732,82506057,82514534,111138264,XM_022490139.1,protein FAM204A-like,8477
NC_035784.1,82518183,82566248,82537763,82547216,111138265,XM_022490142.1,protein FAM204A-like,9453
NC_035784.1,82506057,82527732,82506057,82515694,111138264,XM_022490140.1,protein FAM204A-like,9637
NC_035784.1,36743644,36747147,36743644,36747147,111136550,XM_022487483.1,protein FAM210A-like,3503
NC_035788.1,45349285,45350187,45349285,45350187,111113204,XM_022451302.1,protein FAM210B-like,902
NC_035788.1,47635298,47658721,47635298,47658721,111112886,XM_022450748.1,protein FAM214A-like,23423
NC_035783.1,29299885,29303355,29299885,29303355,111129430,XM_022475805.1,protein FAM219A-like,3470
NC_035783.1,28723409,28728437,28723409,28728437,111129429,XM_022475804.1,protein FAM219A-like,5028
NC_035784.1,43965304,43974415,43965304,43974415,111133385,XM_022481742.1,protein FAM221A-like,9111
NC_035783.1,20293998,20300851,20293998,20300851,111128096,XM_022473546.1,protein FAM221B-like,6853
NC_035781.1,38470278,38478770,38471550,38478770,111117882,XM_022457124.1,protein FAM227B-like,7220
NC_035781.1,38470278,38478770,38470278,38478770,111117882,XM_022457128.1,protein FAM227B-like,8492
NC_035783.1,20774163,20783239,20774163,20783239,111129914,XM_022476452.1,protein FAM227B-like,9076
NC_035786.1,53678864,53698655,53678864,53689270,111105366,XM_022439619.1,protein FAM228B-like,10406
NC_035786.1,53678864,53698655,53678864,53689427,111105366,XM_022439609.1,protein FAM228B-like,10563
NC_035786.1,53678864,53698655,53678864,53689455,111105366,XM_022439611.1,protein FAM228B-like,10591
NC_035786.1,53678864,53698655,53678864,53692005,111105366,XM_022439607.1,protein FAM228B-like,13141
NC_035786.1,53678864,53698655,53678864,53692121,111105366,XM_022439621.1,protein FAM228B-like,13257
NC_035786.1,53678864,53698655,53678864,53692122,111105366,XM_022439618.1,protein FAM228B-like,13258
NC_035786.1,53678864,53698655,53678864,53692126,111105366,XM_022439614.1,protein FAM228B-like,13262
NC_035786.1,53678864,53698655,53678864,53692127,111105366,XM_022439615.1,protein FAM228B-like,13263
NC_035786.1,53678864,53698655,53678864,53692128,111105366,XM_022439606.1,protein FAM228B-like,13264
NC_035786.1,53678864,53698655,53678864,53692129,111105366,XM_022439617.1,protein FAM228B-like,13265
NC_035786.1,53678864,53698655,53678864,53692130,111105366,XM_022439613.1,protein FAM228B-like,13266
NC_035786.1,53678864,53698655,53678864,53692139,111105366,XM_022439622.1,protein FAM228B-like,13275
NC_035786.1,53678864,53698655,53678864,53694650,111105366,XM_022439608.1,protein FAM228B-like,15786
NC_035786.1,53678864,53698655,53678864,53698655,111105366,XM_022439610.1,protein FAM228B-like,19791
NC_035781.1,21186077,21197418,21186077,21197418,111122134,XM_022463719.1,protein FAM32A-like,11341
NC_035784.1,83166501,83181658,83166501,83181658,111132080,XM_022479735.1,protein FAM43A-like,15157
NC_035784.1,93014504,93020157,93014504,93020157,111132909,XM_022480838.1,protein FAM45A-like,5653
NC_035786.1,48939654,48943791,48939654,48943791,111103865,XM_022437424.1,protein FAM46C-like,4137
NC_035782.1,57141036,57148592,57141036,57148592,111122979,XM_022465031.1,protein FAM47A-like,7556
NC_035782.1,56628949,56637847,56628949,56637847,111122559,XM_022464351.1,protein FAM47A-like,8898
NC_035781.1,39348193,39368340,39348193,39360788,111119187,XM_022459089.1,protein FAM49B-like,12595
NC_035781.1,39507763,39528061,39514132,39528061,111119231,XM_022459210.1,protein FAM49B-like,13929
NC_035781.1,39507763,39528061,39512050,39528061,111119231,XM_022459203.1,protein FAM49B-like,16011
NC_035781.1,39348193,39368340,39348193,39368323,111119187,XM_022459082.1,protein FAM49B-like,20130
NC_035781.1,39348193,39368340,39348193,39368334,111119187,XM_022459088.1,protein FAM49B-like,20141
NC_035781.1,39348193,39368340,39348193,39368335,111119187,XM_022459081.1,protein FAM49B-like,20142
NC_035781.1,39348193,39368340,39348193,39368340,111119187,XM_022459087.1,protein FAM49B-like,20147
NC_035781.1,39507763,39528061,39507770,39528061,111119231,XM_022459209.1,protein FAM49B-like,20291
NC_035781.1,39507763,39528061,39507769,39528061,111119231,XM_022459202.1,protein FAM49B-like,20292
NC_035781.1,39507763,39528061,39507764,39528061,111119231,XM_022459208.1,protein FAM49B-like,20297
NC_035781.1,39507763,39528061,39507763,39528061,111119231,XM_022459205.1,protein FAM49B-like,20298
NC_035783.1,34543593,34547660,34543593,34547660,111129945,XM_022476498.1,protein FAM50A-like,4067
NC_035785.1,31870553,31885515,31870553,31882606,111100852,XM_022432964.1,protein FAM53A-like,12053
NC_035785.1,31870553,31885515,31870553,31885515,111100852,XM_022432963.1,protein FAM53A-like,14962
NC_035785.1,31870553,31885515,31870553,31879411,111100852,XM_022432967.1,protein FAM53A-like,8858
NC_035785.1,31870553,31885515,31870553,31879722,111100852,XM_022432965.1,protein FAM53A-like,9169
NC_035785.1,31870553,31885515,31870553,31879986,111100852,XM_022432966.1,protein FAM53A-like,9433
NC_035784.1,48649152,48656983,48649152,48656983,111135453,XM_022485545.1,protein FAM57B-like,7831
NC_035786.1,51982285,51993323,51982688,51993323,111103502,XM_022436822.1,protein FAM60A-like,10635
NC_035786.1,51982285,51993323,51982285,51993323,111103502,XM_022436821.1,protein FAM60A-like,11038
NC_035782.1,31151394,31157211,31151394,31157187,111126355,XM_022470918.1,protein FAM69B-like,5793
NC_035782.1,31151394,31157211,31151394,31157211,111126355,XM_022470917.1,protein FAM69B-like,5817
NC_035784.1,26267223,26271875,26267223,26269522,111136899,XM_022488061.1,protein FAM69C-like,2299
NC_035784.1,26267223,26271875,26267231,26271875,111136899,XM_022488060.1,protein FAM69C-like,4644
NC_035784.1,26256747,26261791,26256747,26261791,111136906,XM_022488074.1,protein FAM69C-like,5044
NC_035787.1,59195366,59198896,59195366,59198896,111109601,XM_022445793.1,protein FAM72A-like,3530
NC_035787.1,55369887,55373493,55369887,55373493,111110085,XM_022446428.1,protein FAM72A-like,3606
NC_035789.1,1218749,1230868,1223727,1230868,111117764,XM_022457007.1,protein FAM76B-like,7141
NC_035780.1,18880608,18889102,18880608,18889102,111099102,XM_022430470.1,protein FAM76B-like,8494
NC_035789.1,1218749,1230868,1218749,1228209,111117764,XM_022457008.1,protein FAM76B-like,9460
NC_035782.1,61108197,61110434,61108197,61110434,111124743,XM_022467892.1,protein FAM78A-like,2237
NC_035788.1,51956271,51971305,51956271,51971304,111112731,XM_022450465.1,protein FAM81A-like,15033
NC_035788.1,51956671,51963328,51956671,51963328,111112732,XM_022450468.1,protein FAM81A-like,6657
NC_035788.1,51956271,51971305,51963985,51971305,111112731,XM_022450466.1,protein FAM81A-like,7320
NC_035783.1,11083478,11086919,11083478,11086919,111131596,XM_022479203.1,protein FAM89A-like,3441
NC_035780.1,44465706,44469017,44465706,44469017,111118020,XM_022457288.1,protein FAM8A1-like,3311
NC_035780.1,45482230,45485908,45482230,45485908,111115619,XM_022454433.1,protein FAM8A1-like,3678
NC_035781.1,33080217,33089948,33080217,33089948,111119205,XM_022459136.1,protein FAM91A1-like,9731
NC_035784.1,5866760,5874056,5866762,5874055,111133209,XM_022481361.1,protein FAM92B-like,7293
NC_035784.1,5866760,5874056,5866760,5874055,111133209,XM_022481360.1,protein FAM92B-like,7295
NC_035784.1,5866760,5874056,5866760,5874056,111133209,XM_022481359.1,protein FAM92B-like,7296
NC_035784.1,6815478,6824007,6815489,6824007,111138025,XM_022489781.1,protein FAM92B-like,8518
NC_035784.1,6815478,6824007,6815484,6824007,111138025,XM_022489778.1,protein FAM92B-like,8523
NC_035784.1,6815478,6824007,6815478,6824007,111138025,XM_022489780.1,protein FAM92B-like,8529
NC_035783.1,39955051,39960023,39955051,39960023,111128303,XM_022473861.1,protein FAM98A-like,4972
NC_035783.1,41773692,41779317,41773692,41779317,111131139,XM_022478521.1,protein FAM98A-like,5625
NC_035789.1,4454462,4456821,4454462,4456821,111116754,XM_022455750.1,protein FAM98B-like,2359
NC_035784.1,2993442,3005954,2993442,3005954,111134341,XM_022483283.1,protein FAN-like,12512
NC_035781.1,5524402,5533341,5524402,5533341,111121622,XM_022462976.1,neuropeptide FF receptor 2-like,8939
NC_035780.1,27859465,27867253,27859465,27867253,111116966,XM_022456025.1,MKI67 FHA domain-interacting nucleolar phosphoprotein-like,7788
NC_035780.1,8080367,8081692,8080367,8081692,111111357,XM_022448294.1,protein FMC1 homolog,1325
NC_035782.1,62990183,63013323,62990183,63013323,111125498,XM_022469400.1,cytoplasmic FMR1-interacting protein 1-like,23140
NC_035785.1,37651736,37671374,37651737,37671374,111100190,XM_022431842.1,protein FORGETTER 1-like,19637
NC_035785.1,31240575,31249001,31240575,31249001,111100609,XM_022432665.1,protein FRA10AC1 homolog,8426
NC_035782.1,63410737,63418685,63410737,63418685,111123045,XM_022465133.1,protein FRG1-like,7948
NC_035780.1,2622064,2630407,2622064,2630407,111100985,XM_022433185.1,protocadherin Fat 4-like,8343
NC_035781.1,11758140,11764609,11758140,11764609,111121293,XM_022462497.1,cytosolic Fe-S cluster assembly factor NUBP2 homolog,6469
NC_035788.1,71446341,71448292,71446341,71448292,111111083,XM_022447849.1,protein Fer3-like,1951
NC_035782.1,14274861,14278141,14274861,14278141,111123007,XM_022465083.1,protein Flattop homolog,3280
NC_035780.1,40129872,40146132,40129872,40146132,111126799,XM_022471675.1,adhesion G protein-coupled receptor E1-like,16260
NC_035782.1,61157870,61160886,61157870,61160886,111126118,XM_022470528.1,endonuclease G,3016
NC_035780.1,366837,370670,366837,370670,111119377,XM_022459483.1,probable G-protein coupled receptor 83,3833
NC_035782.1,29249605,29289121,29249605,29289121,111127644,XM_022472909.1,prostaglandin G/H synthase 2-like,39516
NC_035786.1,28131346,28139027,28131346,28139027,111103761,XM_022437223.1,protein GDAP2 homolog,7681
NC_035787.1,28872432,28879187,28872432,28879187,111106577,XM_022441303.1,rab GDP dissociation inhibitor beta-like,6755
NC_035781.1,30943535,30951762,30943535,30951762,111119153,XM_022459024.1,rho GDP-dissociation inhibitor 1-like,8227
NC_035784.1,37180979,37190636,37180979,37190636,111136845,XM_022487974.1,rab5 GDP/GTP exchange factor-like,9657
NC_035783.1,16625359,16626287,16625359,16626287,111128262,XM_022473797.1,probable GH family 25 lysozyme 3,928
NC_035784.1,2264428,2271674,2264428,2271674,111138201,XM_022490059.1,nucleoporin GLE1-like,7246
NC_035782.1,22429432,22439857,22429432,22439857,111123646,XM_022466109.1,ganglioside GM2 activator-like,10425
NC_035785.1,3671903,3674155,3671903,3674155,111101158,XM_022433504.1,cyclic GMP-AMP synthase-like,2252
NC_035780.1,64478556,64481643,64478556,64481643,111108555,XM_022444541.1,putative GPI-anchored protein pfl2,3087
NC_035784.1,3819591,3826233,3819591,3826233,111136392,XM_022487210.1,snaclec GPIB-binding protein subunit beta-like,6642
NC_035782.1,26131012,26149525,26131012,26143883,111123129,XM_022465260.1,protein GPR108-like,12871
NC_035782.1,28426946,28446997,28426946,28441219,111124579,XM_022467550.1,protein GPR108-like,14273
NC_035782.1,26131012,26149525,26131012,26149525,111123129,XM_022465261.1,protein GPR108-like,18513
NC_035782.1,28426946,28446997,28426946,28446997,111124579,XM_022467551.1,protein GPR108-like,20051
NC_035780.1,8929145,8941284,8929145,8941283,111138441,XM_022490409.1,putative GTP-binding protein 6,12138
NC_035783.1,26175964,26178066,26175964,26178066,111131370,XM_022478852.1,GPN-loop GTPase 2-like,2102
NC_035781.1,24084916,24118650,24084916,24118650,111118303,XM_022457687.1,rap1 GTPase-GDP dissociation stimulator 1-B-like,33734
NC_035780.1,23733774,23761883,23733774,23761883,111101313,XM_022433764.1,rho GTPase-activating protein 18-like,28109
NC_035788.1,51910310,51956228,51910310,51956228,111112730,XM_022450464.1,ras GTPase-activating-like protein IQGAP1,45918
NC_035784.1,10023552,10038972,10023552,10038972,111133563,XM_022482043.1,rab GTPase-binding effector protein 1-like,15420
NC_035784.1,27310398,27315646,27310398,27315646,111137989,XM_022489731.1,protein GUCD1-like,5248
NC_035784.1,57597578,57614974,57597578,57614974,111135127,XM_022484885.1,GRB10-interacting GYF protein 2-like,17396
NC_035781.1,53255362,53273740,53263216,53273740,111118216,XM_022457555.1,protein Gawky-like,10524
NC_035781.1,53255362,53273740,53255362,53272182,111118216,XM_022457554.1,protein Gawky-like,16820
NC_035781.1,53255362,53273740,53263216,53272182,111118216,XM_022457556.1,protein Gawky-like,8966
NC_035781.1,20824609,20832895,20824609,20832895,111118477,XM_022457978.1,uncharacterized Golgi apparatus membrane protein-like protein CG5021,8286
NC_035787.1,61368782,61381351,61368782,61381351,111109931,XM_022446199.1,histamine H1 receptor-like,12569
NC_035782.1,16012965,16015812,16012965,16015812,111124054,XM_022466915.1,histone H1,2847
NC_035783.1,32559055,32560124,32559055,32560124,111131637,XM_022479259.1,histone H1-delta-like,1069
NC_035781.1,35175026,35176177,35175026,35176177,111119173,XM_022459050.1,histone H1-delta-like,1151
NC_035782.1,16030845,16032001,16030845,16032001,111125871,XM_022470078.1,histone H1-delta-like,1156
NC_035783.1,39444351,39445597,39444351,39445597,111128950,XM_022474926.1,histone H1-delta-like,1246
NC_035781.1,50561128,50561857,50561128,50561857,111118524,XM_022458042.1,histone H1-delta-like,729
NC_035781.1,50572101,50572862,50572101,50572862,111118526,XM_022458043.1,histone H1-delta-like,761
NC_035781.1,47400740,47401544,47400740,47401544,111122112,XM_022463695.1,histone H1-delta-like,804
NC_035783.1,52188199,52189162,52188199,52189162,111131719,XM_022479377.1,histone H1-delta-like,963
NC_035781.1,31374266,31375438,31374266,31375438,111121652,XM_022463009.1,histone H1-like,1172
NC_035781.1,47502913,47514845,47502913,47514845,111120003,XM_022460608.1,ribonuclease H1-like,11932
NC_035784.1,38412271,38412771,38412271,38412771,111132347,XM_022480151.1,ribonuclease H1-like,500
NC_035781.1,50468887,50474047,50468887,50474047,111120733,XM_022461666.1,ribonuclease H1-like,5160
NC_035781.1,47502913,47514845,47508198,47514845,111120003,XM_022460609.1,ribonuclease H1-like,6647
NC_035782.1,16021622,16024940,16021622,16024940,111124711,XM_022467836.1,histone H1.0-like,3318
NC_035781.1,44772715,44774071,44772715,44774071,111122426,XM_022464217.1,histone H1.1-like,1356
NC_035781.1,44136000,44137372,44136000,44137372,111119550,XM_022459798.1,histone H1.1-like,1372
NC_035786.1,26858856,26859916,26858856,26859916,111104207,XM_022438041.1,sperm-specific H1/protamine-like protein type 1,1060
NC_035780.1,34516514,34530958,34516514,34530958,111105717,XM_022440082.1,histamine H2 receptor-like,14444
NC_035782.1,16019881,16020931,16019881,16020931,111124706,XM_022467832.1,histone H2A,1050
NC_035782.1,16029007,16030127,16029007,16030127,111124705,XM_022467831.1,histone H2A,1120
NC_035781.1,15131632,15132725,15131632,15132725,111121800,XM_022463230.1,histone H2A-like,1093
NC_035781.1,35173595,35174702,35173595,35174702,111120260,XM_022460985.1,histone H2A-like,1107
NC_035781.1,35185294,35186448,35185294,35186448,111121835,XM_022463273.1,histone H2A-like,1154
NC_035781.1,47398360,47399638,47398360,47399638,111122113,XM_022463697.1,histone H2A-like,1278
NC_035781.1,15122470,15123761,15122470,15123761,111120990,XM_022462071.1,histone H2A-like,1291
NC_035781.1,47408036,47409530,47408036,47409530,111122115,XM_022463699.1,histone H2A-like,1494
NC_035781.1,50529458,50531058,50529458,50531058,111118527,XM_022458044.1,histone H2A-like,1600
NC_035781.1,50551515,50553132,50551515,50553132,111118535,XM_022458048.1,histone H2A-like,1617
NC_035781.1,50540415,50542051,50540415,50542051,111118536,XM_022458050.1,histone H2A-like,1636
NC_035782.1,57671799,57673829,57671799,57673829,111126163,XM_022470603.1,histone H2A-like,2030
NC_035781.1,15187565,15189713,15187565,15189713,111121684,XM_022463051.1,histone H2A-like,2148
NC_035781.1,15168880,15171119,15168880,15171119,111121681,XM_022463049.1,histone H2A-like,2239
NC_035781.1,15150180,15152420,15150180,15152420,111121798,XM_022463227.1,histone H2A-like,2240
NC_035783.1,39441750,39444128,39441750,39444128,111129656,XM_022476117.1,histone H2A-like,2378
NC_035784.1,80398375,80398818,80398375,80398818,111135215,XM_022485076.1,histone H2A-like,443
NC_035781.1,15140911,15141432,15140911,15141432,111121801,XM_022463231.1,histone H2A-like,521
NC_035782.1,16011468,16012008,16011468,16012008,111124053,XM_022466914.1,histone H2A-like,540
NC_035781.1,12712218,12712793,12712218,12712793,111119051,XM_022458861.1,histone H2A-like,575
NC_035781.1,12739543,12740122,12739543,12740122,111118762,XM_022458375.1,histone H2A-like,579
NC_035781.1,15205486,15206068,15205486,15206068,111121683,XM_022463050.1,histone H2A-like,582
NC_035781.1,12721104,12721697,12721104,12721697,111118761,XM_022458374.1,histone H2A-like,593
NC_035781.1,50574603,50575278,50574603,50575278,111118496,XM_022458001.1,histone H2A-like,675
NC_035784.1,81261721,81262629,81261721,81262629,111135205,XM_022485052.1,histone H2A-like,908
NC_035783.1,39450680,39451676,39450680,39451676,111128951,XM_022474927.1,histone H2A-like,996
NC_035781.1,33811443,33813290,33811443,33813290,111119449,XM_022459637.1,histone H2A.V,1847
NC_035781.1,34426498,34428360,34426498,34428360,111118182,XM_022457515.1,histone H2A.V,1862
NC_035781.1,12729178,12730234,12729178,12730234,111118763,XM_022458376.1,histone H2B,1056
NC_035781.1,12738391,12739450,12738391,12739450,111118764,XM_022458377.1,histone H2B,1059
NC_035781.1,47406446,47407843,47406446,47407843,111122114,XM_022463698.1,histone H2B,1397
NC_035781.1,15149635,15150062,15149635,15150062,111121804,XM_022463234.1,histone H2B,427
NC_035781.1,15131085,15131513,15131085,15131513,111120989,XM_022462069.1,histone H2B,428
NC_035781.1,15204948,15205395,15204948,15205395,111121686,XM_022463055.1,histone H2B,447
NC_035781.1,50553325,50558849,50553325,50558849,111118530,XM_022458046.1,histone H2B,5524
NC_035781.1,50542244,50547775,50542244,50547775,111118529,XM_022458045.1,histone H2B,5531
NC_035781.1,50531155,50536693,50531155,50536693,111118531,XM_022458047.1,histone H2B,5538
NC_035781.1,12720133,12721022,12720133,12721022,111118765,XM_022458378.1,histone H2B,889
NC_035782.1,16028065,16029008,16028065,16029008,111124707,XM_022467833.1,histone H2B,943
NC_035781.1,15187052,15196708,15187052,15196697,111121685,XM_022463053.1,histone H2B,9645
NC_035781.1,39878512,39879681,39878512,39879681,111121364,XM_022462620.1,histone H2B-like,1169
NC_035781.1,38969163,38969549,38969163,38969549,111120283,XM_022461008.1,histone H2B-like,386
NC_035781.1,35184721,35185259,35184721,35185259,111121837,XM_022463274.1,histone H2B-like,538
NC_035782.1,39987212,39987981,39987212,39987981,111124801,XM_022467992.1,histone H2B-like,769
NC_035781.1,38968376,38969151,38968376,38969151,111118321,XM_022457727.1,histone H2B-like,775
NC_035781.1,39879805,39880591,39879805,39880591,111121425,XM_022462711.1,histone H2B-like,786
NC_035781.1,39875232,39876020,39875232,39876020,111118309,XM_022457701.1,histone H2B-like,788
NC_035781.1,38963799,38964600,38963799,38964600,111118715,XM_022458303.1,histone H2B-like,801
NC_035782.1,40284543,40285387,40284543,40285387,111124798,XM_022467989.1,histone H2B-like,844
NC_035782.1,69837470,69840929,69837470,69840929,111127528,XM_022472741.1,histamine H3 receptor-like,3459
NC_035781.1,15154844,15156276,15154844,15156276,111121797,XM_022463226.1,histone H3,1432
NC_035783.1,39445657,39447474,39445657,39447474,111128952,XM_022474928.1,histone H3,1817
NC_035781.1,12713716,12717664,12713716,12717664,111118770,XM_022458382.1,histone H3-like centromeric protein hH3v,3948
NC_035781.1,47403346,47406136,47403346,47406136,111122116,XM_022463700.1,histone H3-like,2790
NC_035781.1,50532760,50535555,50532760,50535555,111118537,XM_022458051.1,histone H3-like,2795
NC_035786.1,1551630,1552163,1551630,1552163,111102749,XM_022435614.1,histone H3-like,533
NC_035781.1,35176254,35183618,35176254,35183618,111119174,XM_022459051.1,histone H3-like,7364
NC_035782.1,22750511,22751962,22750566,22751962,111124901,XM_022468171.1,histone H3.3,1396
NC_035782.1,22750511,22751962,22750511,22751962,111124901,XM_022468170.1,histone H3.3,1451
NC_035781.1,52642705,52644355,52642705,52644355,111119123,XM_022458980.1,histone H3.3,1650
NC_035783.1,8522670,8525367,8522670,8525367,111127934,XM_022473264.1,histone H3.3-like,2697
NC_035781.1,27593479,27601354,27593479,27601354,111122345,XM_022464077.1,COMPASS-like H3K4 histone methylase component WDR5A,7875
NC_035782.1,19365245,19367573,19365245,19367573,111126953,XM_022471907.1,histone H4 transcription factor-like,2328
NC_035782.1,16017685,16018277,16017685,16018277,111124710,XM_022467835.1,histone H4,592
NC_035781.1,15129068,15129774,15129068,15129774,111120991,XM_022462072.1,histone H4,706
NC_035781.1,15194255,15194968,15194255,15194968,111121691,XM_022463060.1,histone H4,713
NC_035783.1,39448709,39449426,39448709,39449426,111128955,XM_022474929.1,histone H4,717
NC_035781.1,12718933,12719686,12718933,12719686,111118769,XM_022458381.1,histone H4,753
NC_035781.1,15203590,15204347,15203590,15204347,111121690,XM_022463059.1,histone H4,757
NC_035782.1,16026800,16027628,16026800,16027628,111124709,XM_022467834.1,histone H4,828
NC_035780.1,8508004,8508997,8508004,8508997,111105859,XM_022440316.1,protein HEXIM-like,993
NC_035787.1,4749184,4751362,4749184,4751362,111109733,XM_022445957.1,protein HEXIM1-like,2178
NC_035787.1,1111194,1111970,1111194,1111970,111107446,XM_022442655.1,protein HEXIM1-like,776
NC_035784.1,30443337,30448712,30443337,30448712,111134899,XM_022484436.1,protein HGH1 homolog,5375
NC_035781.1,37438984,37455180,37438984,37455180,111120273,XM_022460996.1,protein HID1-like,16196
NC_035784.1,14976233,14993552,14976233,14993552,111136239,XM_022486947.1,protein HIRA-like,17319
NC_035785.1,29155711,29159253,29155711,29159253,111101472,XM_022433977.1,uncharacterized HIT-like protein Synpcc7942_1390,3542
NC_035780.1,43133285,43135649,43133285,43135649,111105378,XM_022439656.1,lipoma HMGIC fusion partner-like,2364
NC_035780.1,63822387,63837383,63822387,63836044,111136265,XM_022487023.1,GTPase HRas,13657
NC_035780.1,63822387,63837383,63822391,63837383,111136265,XM_022487014.1,GTPase HRas,14992
NC_035780.1,63822387,63837383,63822387,63837383,111136265,XM_022487006.1,GTPase HRas,14996
NC_035780.1,46242990,46246445,46242990,46246445,111118341,XM_022457758.1,oxidoreductase HTATIP2-like,3455
NC_035780.1,43755692,43759226,43755692,43759226,111100779,XM_022432873.1,oxidoreductase HTATIP2-like,3534
NC_035780.1,39970223,39976206,39970223,39976206,111119795,XM_022460296.1,oxidoreductase HTATIP2-like,5983
NC_035780.1,27617138,27620907,27617138,27620907,111138258,XM_022490135.1,protein Hikeshi-like,3769
NC_035782.1,46102302,46103718,46102302,46103718,111126589,XM_022471333.1,von Hippel-Lindau disease tumor suppressor-like,1416
NC_035781.1,36197538,36215206,36197538,36215206,111121551,XM_022462874.1,protein Hook homolog 3-like,17668
NC_035783.1,19834328,19837895,19834328,19837895,111130179,XM_022476944.1,complex I intermediate-associated protein 30,3567
NC_035780.1,26147352,26158397,26147353,26158397,111100940,XM_022433128.1,arylsulfatase I-like,11044
NC_035780.1,26147352,26158397,26147352,26158397,111100940,XM_022433136.1,arylsulfatase I-like,11045
NC_035781.1,3099569,3104092,3099569,3104092,111119408,XM_022459548.1,baculoviral IAP repeat-containing protein 5-like,4523
NC_035780.1,2063986,2067024,2063986,2067024,111109736,XM_022445962.1,myosin ID heavy chain-like,3038
NC_035784.1,51345915,51367801,51345915,51358318,111135085,XM_022484812.1,protein IFH1-like,12403
NC_035784.1,51345915,51367801,51345915,51358480,111135085,XM_022484816.1,protein IFH1-like,12565
NC_035784.1,51345915,51367801,51345915,51360168,111135085,XM_022484813.1,protein IFH1-like,14253
NC_035784.1,51345915,51367801,51345915,51360815,111135085,XM_022484815.1,protein IFH1-like,14900
NC_035784.1,51345915,51367801,51345915,51364256,111135085,XM_022484810.1,protein IFH1-like,18341
NC_035784.1,51345915,51367801,51345915,51364257,111135085,XM_022484808.1,protein IFH1-like,18342
NC_035784.1,51345915,51367801,51345915,51367801,111135085,XM_022484814.1,protein IFH1-like,21886
NC_035784.1,51345915,51367801,51345915,51352454,111135085,XM_022484811.1,protein IFH1-like,6539
NC_035782.1,43234889,43261901,43234889,43261901,111126171,XM_022470616.1,type II inositol 3,27012
NC_035782.1,65210072,65215465,65210072,65215465,111126211,XM_022470686.1,complex III assembly factor LYRM7-like,5393
NC_035781.1,11666027,11668561,11666027,11668561,111120812,XM_022461791.1,endonuclease III-like protein 1,2534
NC_035781.1,42704802,42709107,42704802,42709107,111120314,XM_022461041.1,GTPase IMAP family member 8-like,4305
NC_035781.1,32939145,32941676,32939145,32941676,111120705,XM_022461630.1,golgin IMH1-like,2531
NC_035782.1,27344568,27351016,27344568,27351016,111124156,XM_022467018.1,protein IMPACT homolog,6448
NC_035784.1,7544353,7554380,7544353,7554380,111138147,XM_022489987.1,protein IMPACT-like,10027
NC_035788.1,68435064,68436344,68435064,68436344,111114097,XM_022452385.1,protein IMPACT-like,1280
NC_035789.1,2638513,2639188,2638513,2639188,111117173,XM_022456253.1,protein IMPACT-like,675
NC_035785.1,36926734,36927565,36926734,36927565,111099453,XM_022430733.1,protein IMPACT-like,831
NC_035786.1,9658798,9659631,9658798,9659631,111103717,XM_022437160.1,protein IMPACT-like,833
NC_035787.1,23357982,23358878,23357982,23358878,111108891,XM_022444975.1,protein IMPACT-like,896
NC_035782.1,5378574,5379523,5378574,5379523,111122633,XM_022464458.1,protein IMPACT-like,949
NC_035781.1,47615855,47621417,47615855,47621417,111117799,XM_022457032.1,putative IQ motif and ankyrin repeat domain-containing protein,5562
NC_035781.1,261366,263173,261366,263173,111118795,XM_022458424.1,protein IWS1 homolog,1807
NC_035781.1,53041845,53046585,53041845,53046585,111117954,XM_022457203.1,protoheme IX farnesyltransferase,4740
NC_035784.1,35288857,35291533,35288857,35291533,111138283,XM_022490161.1,turripeptide Ici9.1-like,2676
NC_035783.1,16732149,16770978,16732149,16770978,111130384,XM_022477412.1,zwei Ig domain protein zig-8-like,38829
NC_035785.1,27312609,27317294,27312609,27317294,111101100,XM_022433400.1,con-Ins Im2-like,4685
NC_035785.1,27279147,27284839,27279147,27284839,111101835,XM_022434456.1,con-Ins Im2-like,5692
NC_035780.1,50033650,50039279,50033650,50038679,111123348,XM_022465647.1,arylsulfatase J-like,5029
NC_035780.1,50033650,50039279,50033651,50038884,111123348,XM_022465633.1,arylsulfatase J-like,5233
NC_035780.1,50033650,50039279,50033651,50039279,111123348,XM_022465640.1,arylsulfatase J-like,5628
NC_035780.1,48302653,48309118,48302653,48308534,111105811,XM_022440236.1,arylsulfatase J-like,5881
NC_035780.1,48302653,48309118,48302653,48309015,111105811,XM_022440221.1,arylsulfatase J-like,6362
NC_035780.1,48302653,48309118,48302653,48309095,111105811,XM_022440227.1,arylsulfatase J-like,6442
NC_035780.1,48302653,48309118,48302653,48309118,111105811,XM_022440214.1,arylsulfatase J-like,6465
NC_035782.1,53956960,53965053,53956960,53965053,111124527,XM_022467455.1,crystallin J1A-like,8093
NC_035781.1,36129735,36171774,36129735,36171774,111121544,XM_022462864.1,protein JBTS17-like,42039
NC_035781.1,36322207,36372921,36322207,36372921,111121543,XM_022462863.1,protein JBTS17-like,50714
NC_035783.1,16217005,16220473,16217005,16220473,111130554,XM_022477703.1,protein JTB-like,3468
NC_035784.1,38241267,38243214,38241267,38243214,111136434,XM_022487282.1,vitamin K epoxide reductase complex subunit 1-like protein 1,1947
NC_035781.1,43346014,43358792,43346014,43358792,111122173,XM_022463789.1,vitamin K-dependent gamma-carboxylase-like,12778
NC_035787.1,19003458,19008560,19003458,19008560,111108297,XM_022444078.1,selenoprotein K-like,5102
NC_035787.1,17396922,17402114,17396922,17402114,111108210,XM_022443892.1,selenoprotein K-like,5192
NC_035784.1,50256107,50296917,50256107,50296917,111137834,XM_022489525.1,protein KIAA0100-like,40810
NC_035781.1,42648292,42681788,42648292,42681788,111120311,XM_022461039.1,protein KIAA0556 homolog,33496
NC_035782.1,65533766,65554806,65533766,65554806,111127227,XM_022472313.1,protein KIBRA-like,21040
NC_035781.1,42795082,42796986,42795082,42796986,111119930,XM_022460510.1,protein KRI1 homolog,1904
NC_035787.1,65489468,65493305,65489468,65493305,111109807,XM_022446047.1,protein KTI12 homolog,3837
NC_035783.1,7380230,7383777,7380230,7383777,111130557,XM_022477706.1,probable L-asparaginase 2,3547
NC_035784.1,12065341,12074573,12065341,12074573,111136573,XM_022487518.1,putative L-aspartate dehydrogenase,9232
NC_035780.1,841204,844397,841204,844397,111131052,XM_022478387.1,probable L-cysteine desulfhydrase,3193
NC_035784.1,42645405,42655273,42645406,42654298,111138065,XM_022489860.1,cathepsin L-like,8892
NC_035784.1,42645405,42655273,42645406,42654313,111138065,XM_022489859.1,cathepsin L-like,8907
NC_035784.1,42645405,42655273,42645405,42654334,111138065,XM_022489856.1,cathepsin L-like,8929
NC_035784.1,42645405,42655273,42645406,42655251,111138065,XM_022489858.1,cathepsin L-like,9845
NC_035784.1,42645405,42655273,42645406,42655273,111138065,XM_022489857.1,cathepsin L-like,9867
NC_035782.1,66743252,66763706,66743252,66763706,111127322,XM_022472449.1,voltage-dependent L-type calcium channel subunit beta-1-like,20454
NC_035781.1,8738714,8750035,8738714,8750035,111120482,XM_022461214.1,ribosomal L1 domain-containing protein 1-like,11321
NC_035788.1,101133665,101136808,101133665,101136807,111113025,XM_022450955.1,cathepsin L1-like,3142
NC_035788.1,101133665,101136808,101133665,101136808,111113025,XM_022450954.1,cathepsin L1-like,3143
NC_035788.1,101128008,101131716,101128008,101131716,111113028,XM_022450958.1,cathepsin L1-like,3708
NC_035782.1,69113701,69117889,69113703,69117889,111126710,XM_022471535.1,cathepsin L1-like,4186
NC_035782.1,69113701,69117889,69113701,69117889,111126710,XM_022471536.1,cathepsin L1-like,4188
NC_035782.1,69565536,69571049,69565536,69569970,111123637,XM_022466099.1,cathepsin L1-like,4434
NC_035788.1,101120991,101125725,101120991,101125709,111113026,XM_022450957.1,cathepsin L1-like,4718
NC_035788.1,101120991,101125725,101120991,101125725,111113026,XM_022450956.1,cathepsin L1-like,4734
NC_035782.1,69553763,69560178,69553763,69558531,111125656,XM_022469675.1,cathepsin L1-like,4768
NC_035782.1,69577333,69582273,69577333,69582273,111125197,XM_022468737.1,cathepsin L1-like,4940
NC_035782.1,69090032,69095084,69090032,69095084,111122564,XM_022464355.1,cathepsin L1-like,5052
NC_035782.1,69565536,69571049,69565536,69571049,111123637,XM_022466098.1,cathepsin L1-like,5513
NC_035782.1,69099618,69105419,69099618,69105419,111122563,XM_022464354.1,cathepsin L1-like,5801
NC_035782.1,69553763,69560178,69553763,69560178,111125656,XM_022469674.1,cathepsin L1-like,6415
NC_035788.1,101138769,101145759,101138769,101145759,111113029,XM_022450959.1,cathepsin L1-like,6990
NC_035784.1,47077396,47079286,47077396,47079286,111137790,XM_022489442.1,apolipoprotein L3-like,1890
NC_035784.1,46950610,46955173,46950610,46953460,111137282,XM_022488682.1,apolipoprotein L3-like,2850
NC_035784.1,46962105,46965692,46962105,46965692,111132402,XM_022480205.1,apolipoprotein L3-like,3587
NC_035784.1,46950610,46955173,46950610,46955173,111137282,XM_022488683.1,apolipoprotein L3-like,4563
NC_035780.1,40037019,40044395,40037019,40044395,111100676,XM_022432792.1,endoribonuclease LACTB2-like,7376
NC_035784.1,29383275,29389371,29383275,29389371,111133701,XM_022482314.1,protein LCHN-like,6096
NC_035784.1,25302362,25310141,25302362,25310141,111099108,XM_022430478.1,protein LIAT1-like,7779
NC_035780.1,15735635,15746916,15735635,15746916,111136703,XM_022487776.1,muscle LIM protein Mlp84B-like,11281
NC_035780.1,58273760,58278759,58273760,58278759,111104651,XM_022438720.1,protein LKAAEAR1-like,4999
NC_035780.1,57946828,57958062,57946828,57958062,111135574,XM_022485767.1,protein LMBR1L-like,11234
NC_035780.1,17038826,17040196,17038826,17040196,111099030,XM_022430679.1,uncharacterized LOC111099030,1370
NC_035784.1,2415607,2420144,2415607,2420144,111099031,XM_022430340.1,uncharacterized LOC111099031,4537
NC_035784.1,27144536,27148489,27144536,27148489,111099034,XM_022430344.1,uncharacterized LOC111099034,3953
NC_035784.1,43296894,43301351,43296894,43301351,111099039,XM_022430351.1,uncharacterized LOC111099039,4457
NC_035780.1,49197151,49209030,49197415,49209030,111099046,XM_022430578.1,uncharacterized LOC111099046,11615
NC_035780.1,49197151,49209030,49197151,49209030,111099046,XM_022430424.1,uncharacterized LOC111099046,11879
NC_035784.1,85541824,85543369,85541824,85543369,111099054,XM_022430396.1,uncharacterized LOC111099054,1545
NC_035784.1,10587556,10600961,10587556,10600961,111099057,XM_022430401.1,uncharacterized LOC111099057,13405
NC_035784.1,70482178,70498085,70482178,70498017,111099060,XM_022430408.1,uncharacterized LOC111099060,15839
NC_035784.1,70482178,70498085,70482178,70498085,111099060,XM_022430407.1,uncharacterized LOC111099060,15907
NC_035784.1,28197474,28200798,28197474,28200798,111099061,XM_022430409.1,uncharacterized LOC111099061,3324
NC_035784.1,86786928,86799198,86786928,86799198,111099076,XM_022430430.1,uncharacterized LOC111099076,12270
NC_035784.1,43627908,43629447,43627908,43629447,111099077,XM_022430431.1,uncharacterized LOC111099077,1539
NC_035784.1,580180,601283,582423,592858,111099078,XM_022430436.1,uncharacterized LOC111099078,10435
NC_035784.1,580180,601283,580180,592853,111099078,XM_022430432.1,uncharacterized LOC111099078,12673
NC_035784.1,580180,601283,580180,601249,111099078,XM_022430434.1,uncharacterized LOC111099078,21069
NC_035784.1,580180,601283,580180,601283,111099078,XM_022430433.1,uncharacterized LOC111099078,21103
NC_035784.1,580180,601283,580180,589154,111099078,XM_022430435.1,uncharacterized LOC111099078,8974
NC_035784.1,9308552,9342969,9318636,9342969,111099084,XM_022430443.1,uncharacterized LOC111099084,24333
NC_035784.1,39796608,39800798,39796608,39800798,111099090,XM_022430449.1,uncharacterized LOC111099090,4190
NC_035784.1,39791205,39796428,39791205,39796428,111099091,XM_022430451.1,uncharacterized LOC111099091,5223
NC_035784.1,87333387,87343228,87333387,87343228,111099095,XM_022430455.1,uncharacterized LOC111099095,9841
NC_035784.1,9988511,10002304,9988511,10002304,111099098,XM_022430461.1,uncharacterized LOC111099098,13793
NC_035784.1,25289740,25293934,25289740,25293934,111099107,XM_022430477.1,uncharacterized LOC111099107,4194
NC_035784.1,44007572,44015153,44007572,44015153,111099117,XM_022430485.1,uncharacterized LOC111099117,7581
NC_035784.1,73307858,73309331,73307858,73309331,111099119,XM_022430487.1,uncharacterized LOC111099119,1473
NC_035784.1,88502885,88504359,88502885,88504359,111099124,XM_022430494.1,uncharacterized LOC111099124,1474
NC_035784.1,69759317,69767117,69759636,69767117,111099125,XM_022430498.1,uncharacterized LOC111099125,7481
NC_035784.1,69759317,69767117,69759591,69767117,111099125,XM_022430499.1,uncharacterized LOC111099125,7526
NC_035784.1,69759317,69767117,69759496,69767117,111099125,XM_022430495.1,uncharacterized LOC111099125,7621
NC_035784.1,69759317,69767117,69759495,69767117,111099125,XM_022430496.1,uncharacterized LOC111099125,7622
NC_035784.1,69759317,69767117,69759317,69767117,111099125,XM_022430497.1,uncharacterized LOC111099125,7800
NC_035784.1,52039076,52044948,52039076,52044948,111099126,XM_022430500.1,uncharacterized LOC111099126,5872
NC_035784.1,40926746,40931601,40926746,40931601,111099128,XM_022430506.1,uncharacterized LOC111099128,4855
NC_035784.1,95490655,95622025,95490655,95622025,111099135,XM_022430517.1,uncharacterized LOC111099135,131370
NC_035784.1,95490655,95622025,95490655,95496872,111099135,XM_022430519.1,uncharacterized LOC111099135,6217
NC_035784.1,95490655,95622025,95490655,95496875,111099135,XM_022430516.1,uncharacterized LOC111099135,6220
NC_035784.1,73450285,73457305,73450285,73457305,111099137,XM_022430521.1,uncharacterized LOC111099137,7020
NC_035784.1,33672822,33675211,33672822,33675211,111099141,XM_022430526.1,uncharacterized LOC111099141,2389
NC_035784.1,91089433,91096118,91089433,91096118,111099145,XM_022430527.1,uncharacterized LOC111099145,6685
NC_035784.1,91087150,91088660,91087150,91088298,111099146,XM_022430530.1,uncharacterized LOC111099146,1148
NC_035784.1,91087150,91088660,91087150,91088660,111099146,XM_022430528.1,uncharacterized LOC111099146,1510
NC_035784.1,16462283,16465147,16462283,16465147,111099148,XM_022430533.1,uncharacterized LOC111099148,2864
NC_035784.1,10393563,10400928,10393563,10400928,111099153,XM_022430541.1,uncharacterized LOC111099153,7365
NC_035780.1,56761404,56765384,56761404,56765384,111099158,XM_022430565.1,uncharacterized LOC111099158,3980
NC_035784.1,29390331,29393808,29390331,29393808,111099163,XM_022430569.1,uncharacterized LOC111099163,3477
NC_035784.1,33321255,33321815,33321255,33321815,111099164,XM_022430570.1,uncharacterized LOC111099164,560
NC_035784.1,39617342,39630942,39617342,39630942,111099169,XM_022430574.1,uncharacterized LOC111099169,13600
NC_035784.1,2070182,2072210,2070182,2072210,111099178,XM_022430587.1,uncharacterized LOC111099178,2028
NC_035784.1,91030128,91032350,91030195,91032350,111099190,XM_022430600.1,uncharacterized LOC111099190,2155
NC_035784.1,91030128,91032350,91030128,91032350,111099190,XM_022430599.1,uncharacterized LOC111099190,2222
NC_035780.1,14448986,14456291,14448986,14456291,111099191,XM_022430603.1,uncharacterized LOC111099191,7305
NC_035784.1,50463880,50465840,50463880,50465840,111099193,XM_022430602.1,uncharacterized LOC111099193,1960
NC_035784.1,18212165,18226658,18212718,18226658,111099194,XM_022430608.1,uncharacterized LOC111099194,13940
NC_035784.1,18212165,18226658,18212707,18226658,111099194,XM_022430605.1,uncharacterized LOC111099194,13951
NC_035784.1,18212165,18226658,18212219,18226658,111099194,XM_022430606.1,uncharacterized LOC111099194,14439
NC_035784.1,18212165,18226658,18212169,18226658,111099194,XM_022430620.1,uncharacterized LOC111099194,14489
NC_035784.1,18212165,18226658,18212168,18226658,111099194,XM_022430612.1,uncharacterized LOC111099194,14490
NC_035784.1,18212165,18226658,18212167,18226658,111099194,XM_022430604.1,uncharacterized LOC111099194,14491
NC_035784.1,18212165,18226658,18212165,18226658,111099194,XM_022430607.1,uncharacterized LOC111099194,14493
NC_035784.1,1715507,1729509,1715510,1727832,111099199,XM_022430629.1,uncharacterized LOC111099199,12322
NC_035784.1,1715507,1729509,1715507,1729509,111099199,XM_022430628.1,uncharacterized LOC111099199,14002
NC_035784.1,47828668,47835633,47828668,47835633,111099202,XM_022430633.1,uncharacterized LOC111099202,6965
NC_035784.1,64512787,64514254,64512787,64514254,111099205,XM_022430636.1,uncharacterized LOC111099205,1467
NC_035784.1,50725515,50735030,50725515,50735030,111099210,XM_022430643.1,uncharacterized LOC111099210,9515
NC_035784.1,88428042,88430916,88428042,88430916,111099225,XM_022430665.1,uncharacterized LOC111099225,2874
NC_035784.1,75244178,75256070,75244178,75256070,111099227,XM_022430669.1,uncharacterized LOC111099227,11892
NC_035784.1,75244178,75256070,75251279,75256070,111099227,XM_022430668.1,uncharacterized LOC111099227,4791
NC_035784.1,75244178,75256070,75251240,75256070,111099227,XM_022430667.1,uncharacterized LOC111099227,4830
NC_035784.1,560482,569017,560482,569017,111099228,XM_022430670.1,uncharacterized LOC111099228,8535
NC_035784.1,43285842,43288792,43285842,43288792,111099229,XM_022430672.1,uncharacterized LOC111099229,2950
NC_035784.1,2909403,2934001,2909403,2934001,111099230,XM_022430673.1,uncharacterized LOC111099230,24598
NC_035784.1,2909403,2934001,2927826,2934001,111099230,XM_022430674.1,uncharacterized LOC111099230,6175
NC_035780.1,31235434,31247727,31235434,31247727,111099246,XM_022430676.1,uncharacterized LOC111099246,12293
NC_035780.1,55793674,55795781,55793835,55795781,111099375,XM_022430685.1,uncharacterized LOC111099375,1946
NC_035780.1,55793674,55795781,55793710,55795781,111099375,XM_022430686.1,uncharacterized LOC111099375,2071
NC_035780.1,55793674,55795781,55793674,55795781,111099375,XM_022430687.1,uncharacterized LOC111099375,2107
NC_035785.1,24358373,24382773,24358439,24382773,111099409,XM_022430689.1,uncharacterized LOC111099409,24334
NC_035785.1,24358373,24382773,24358373,24382773,111099409,XM_022430688.1,uncharacterized LOC111099409,24400
NC_035785.1,45274670,45276300,45274670,45276300,111099413,XM_022430690.1,uncharacterized LOC111099413,1630
NC_035785.1,20316008,20320339,20316008,20320339,111099415,XM_022430694.1,uncharacterized LOC111099415,4331
NC_035785.1,43449515,43467473,43449515,43467473,111099417,XM_022430695.1,uncharacterized LOC111099417,17958
NC_035785.1,3629794,3638372,3629794,3638372,111099418,XM_022430696.1,uncharacterized LOC111099418,8578
NC_035785.1,1583476,1585485,1583476,1585485,111099421,XM_022430698.1,uncharacterized LOC111099421,2009
NC_035785.1,18923299,18924935,18923299,18924935,111099423,XM_022430699.1,uncharacterized LOC111099423,1636
NC_035785.1,48842497,48851229,48842925,48851229,111099425,XM_022430703.1,uncharacterized LOC111099425,8304
NC_035785.1,48842497,48851229,48842505,48851229,111099425,XM_022430702.1,uncharacterized LOC111099425,8724
NC_035785.1,48842497,48851229,48842497,48851229,111099425,XM_022430704.1,uncharacterized LOC111099425,8732
NC_035785.1,1736804,1739358,1736804,1739358,111099428,XM_022430711.1,uncharacterized LOC111099428,2554
NC_035785.1,1739512,1741592,1739512,1741592,111099429,XM_022430712.1,uncharacterized LOC111099429,2080
NC_035785.1,3084363,3086853,3084363,3086853,111099432,XM_022430715.1,uncharacterized LOC111099432,2490
NC_035785.1,24987185,24989204,24987185,24989204,111099436,XM_022430718.1,uncharacterized LOC111099436,2019
NC_035785.1,24692910,24735694,24713472,24735694,111099438,XM_022430722.1,uncharacterized LOC111099438,22222
NC_035785.1,24692910,24735694,24695715,24735694,111099438,XM_022430721.1,uncharacterized LOC111099438,39979
NC_035785.1,24692910,24735694,24692910,24735694,111099438,XM_022430720.1,uncharacterized LOC111099438,42784
NC_035785.1,3400636,3402426,3400636,3402426,111099447,XM_022430728.1,uncharacterized LOC111099447,1790
NC_035780.1,16411255,16414817,16411255,16414817,111099448,XM_022430761.1,uncharacterized LOC111099448,3562
NC_035780.1,58779413,58780191,58779413,58780191,111099451,XM_022430735.1,uncharacterized LOC111099451,778
NC_035785.1,24475114,24476411,24475114,24476411,111099456,XM_022430737.1,uncharacterized LOC111099456,1297
NC_035785.1,28093217,28152871,28093278,28148731,111099463,XM_022430750.1,uncharacterized LOC111099463,55453
NC_035785.1,28093217,28152871,28093292,28152871,111099463,XM_022430748.1,uncharacterized LOC111099463,59579
NC_035785.1,28093217,28152871,28093281,28152871,111099463,XM_022430747.1,uncharacterized LOC111099463,59590
NC_035785.1,28093217,28152871,28093217,28152871,111099463,XM_022430749.1,uncharacterized LOC111099463,59654
NC_035785.1,46101128,46116412,46101128,46112826,111099465,XM_022430754.1,uncharacterized LOC111099465,11698
NC_035785.1,6271552,6297659,6271552,6297659,111099466,XM_022430755.1,uncharacterized LOC111099466,26107
NC_035785.1,35410323,35412125,35410323,35412125,111099473,XM_022430759.1,uncharacterized LOC111099473,1802
NC_035785.1,25302215,25306773,25302215,25306773,111099474,XM_022430760.1,uncharacterized LOC111099474,4558
NC_035785.1,41412916,41414698,41412916,41414698,111099475,XM_022430763.1,uncharacterized LOC111099475,1782
NC_035785.1,41355332,41364128,41355983,41364128,111099476,XM_022430765.1,uncharacterized LOC111099476,8145
NC_035785.1,41355332,41364128,41355332,41364127,111099476,XM_022430764.1,uncharacterized LOC111099476,8795
NC_035785.1,35973248,36006661,35973248,36006661,111099477,XM_022430766.1,uncharacterized LOC111099477,33413
NC_035785.1,12130772,12142274,12130772,12142274,111099482,XM_022430771.1,uncharacterized LOC111099482,11502
NC_035785.1,22919851,22952236,22922994,22948222,111099486,XM_022430783.1,uncharacterized LOC111099486,25228
NC_035785.1,22919851,22952236,22922994,22951646,111099486,XM_022430780.1,uncharacterized LOC111099486,28652
NC_035785.1,22919851,22952236,22922994,22952141,111099486,XM_022430785.1,uncharacterized LOC111099486,29147
NC_035785.1,22919851,22952236,22922994,22952236,111099486,XM_022430782.1,uncharacterized LOC111099486,29242
NC_035785.1,22919851,22952236,22919851,22952236,111099486,XM_022430786.1,uncharacterized LOC111099486,32385
NC_035785.1,868438,872065,868438,872065,111099489,XM_022430787.1,uncharacterized LOC111099489,3627
NC_035785.1,2198565,2202650,2198565,2202650,111099494,XM_022430794.1,uncharacterized LOC111099494,4085
NC_035785.1,10578615,10596373,10578615,10596373,111099495,XM_022430795.1,uncharacterized LOC111099495,17758
NC_035785.1,9818552,9820190,9818552,9820190,111099497,XM_022430799.1,uncharacterized LOC111099497,1638
NC_035785.1,44599824,44601532,44599824,44601532,111099499,XM_022430802.1,uncharacterized LOC111099499,1708
NC_035785.1,37133206,37143029,37133206,37143029,111099500,XM_022430803.1,uncharacterized LOC111099500,9823
NC_035785.1,28365897,28393216,28372600,28393216,111099501,XM_022430804.1,uncharacterized LOC111099501,20616
NC_035785.1,28365897,28393216,28372598,28393216,111099501,XM_022430807.1,uncharacterized LOC111099501,20618
NC_035785.1,28365897,28393216,28365898,28393216,111099501,XM_022430805.1,uncharacterized LOC111099501,27318
NC_035785.1,28365897,28393216,28365897,28393216,111099501,XM_022430806.1,uncharacterized LOC111099501,27319
NC_035785.1,9031242,9033099,9031242,9033099,111099507,XM_022430816.1,uncharacterized LOC111099507,1857
NC_035785.1,38780562,38795027,38780562,38795027,111099508,XM_022430818.1,uncharacterized LOC111099508,14465
NC_035785.1,38780562,38795027,38787296,38795027,111099508,XM_022430817.1,uncharacterized LOC111099508,7731
NC_035780.1,36067743,36075974,36067743,36075974,111099509,XM_022430822.1,uncharacterized LOC111099509,8231
NC_035785.1,25415218,25470006,25415218,25470006,111099510,XM_022430819.1,uncharacterized LOC111099510,54788
NC_035785.1,27559778,27567381,27559778,27567381,111099513,XM_022430823.1,uncharacterized LOC111099513,7603
NC_035785.1,33805925,33812010,33805925,33811936,111099515,XM_022430827.1,uncharacterized LOC111099515,6011
NC_035785.1,33805925,33812010,33805925,33812010,111099515,XM_022430825.1,uncharacterized LOC111099515,6085
NC_035785.1,33032575,33042498,33032575,33042497,111099517,XM_022430829.1,uncharacterized LOC111099517,9922
NC_035785.1,33032575,33042498,33032575,33042498,111099517,XM_022430830.1,uncharacterized LOC111099517,9923
NC_035785.1,914358,924123,914358,924123,111099521,XM_022430833.1,uncharacterized LOC111099521,9765
NC_035785.1,35606968,35608839,35606968,35608839,111099522,XM_022430835.1,uncharacterized LOC111099522,1871
NC_035785.1,30429614,30439536,30429614,30439536,111099526,XM_022430838.1,uncharacterized LOC111099526,9922
NC_035785.1,30435361,30436375,30435361,30436375,111099528,XM_022430840.1,uncharacterized LOC111099528,1014
NC_035780.1,34415845,34418150,34415845,34418150,111099529,XM_022430875.1,uncharacterized LOC111099529,2305
NC_035785.1,10841523,10848502,10842812,10848502,111099532,XM_022430843.1,uncharacterized LOC111099532,5690
NC_035785.1,10841523,10848502,10841523,10848502,111099532,XM_022430844.1,uncharacterized LOC111099532,6979
NC_035785.1,25071660,25074146,25071660,25074146,111099535,XM_022430847.1,uncharacterized LOC111099535,2486
NC_035785.1,25084396,25087171,25084396,25087171,111099536,XM_022430849.1,uncharacterized LOC111099536,2775
NC_035785.1,25059627,25061098,25059627,25061098,111099537,XM_022430850.1,uncharacterized LOC111099537,1471
NC_035785.1,45031881,45033050,45031881,45033050,111099540,XM_022430853.1,uncharacterized LOC111099540,1169
NC_035785.1,25044639,25046342,25044639,25046342,111099542,XM_022430855.1,uncharacterized LOC111099542,1703
NC_035785.1,37412642,37426045,37412642,37426045,111099545,XM_022430859.1,uncharacterized LOC111099545,13403
NC_035785.1,29983887,30012480,29983887,30012480,111099546,XM_022430860.1,uncharacterized LOC111099546,28593
NC_035785.1,32123930,32128125,32123930,32128125,111099547,XM_022430861.1,uncharacterized LOC111099547,4195
NC_035785.1,8059501,8105902,8059501,8094770,111099549,XM_022430863.1,uncharacterized LOC111099549,35269
NC_035785.1,8059501,8105902,8059501,8105902,111099549,XM_022430864.1,uncharacterized LOC111099549,46401
NC_035785.1,9023918,9026798,9023976,9026798,111099551,XM_022430867.1,uncharacterized LOC111099551,2822
NC_035785.1,9023918,9026798,9023918,9026798,111099551,XM_022430866.1,uncharacterized LOC111099551,2880
NC_035785.1,38609366,38613289,38609366,38613289,111099554,XM_022430870.1,uncharacterized LOC111099554,3923
NC_035785.1,30533645,30536359,30533645,30536359,111099555,XM_022430871.1,uncharacterized LOC111099555,2714
NC_035785.1,23626299,23628741,23626299,23628741,111099556,XM_022430872.1,uncharacterized LOC111099556,2442
NC_035785.1,23505650,23507949,23505650,23507949,111099558,XM_022430873.1,uncharacterized LOC111099558,2299
NC_035785.1,33364235,33377759,33364235,33376304,111099567,XM_022430884.1,uncharacterized LOC111099567,12069
NC_035785.1,33364235,33377759,33364235,33377759,111099567,XM_022430885.1,uncharacterized LOC111099567,13524
NC_035785.1,25908500,25911795,25908500,25911793,111099572,XM_022430890.1,uncharacterized LOC111099572,3293
NC_035785.1,25908500,25911795,25908500,25911795,111099572,XM_022430891.1,uncharacterized LOC111099572,3295
NC_035785.1,25896780,25914453,25896780,25914453,111099574,XM_022430892.1,uncharacterized LOC111099574,17673
NC_035785.1,5290055,5309679,5290055,5309679,111099577,XM_022430895.1,uncharacterized LOC111099577,19624
NC_035785.1,5290055,5309679,5290056,5292714,111099577,XM_022430894.1,uncharacterized LOC111099577,2658
NC_035785.1,22695268,22703745,22696419,22703745,111099579,XM_022430899.1,uncharacterized LOC111099579,7326
NC_035785.1,22695268,22703745,22696407,22703745,111099579,XM_022430897.1,uncharacterized LOC111099579,7338
NC_035785.1,22695268,22703745,22695268,22703745,111099579,XM_022430898.1,uncharacterized LOC111099579,8477
NC_035785.1,28036609,28040622,28036609,28040622,111099581,XM_022430900.1,uncharacterized LOC111099581,4013
NC_035785.1,40799254,40810262,40799254,40810262,111099582,XM_022430901.1,uncharacterized LOC111099582,11008
NC_035785.1,33706194,33717791,33706194,33717642,111099583,XM_022430905.1,uncharacterized LOC111099583,11448
NC_035785.1,33706194,33717791,33706194,33717791,111099583,XM_022430903.1,uncharacterized LOC111099583,11597
NC_035785.1,33706194,33717791,33706194,33710807,111099583,XM_022430904.1,uncharacterized LOC111099583,4613
NC_035785.1,4122776,4133082,4122776,4133082,111099586,XM_022430908.1,uncharacterized LOC111099586,10306
NC_035785.1,13005865,13032664,13007721,13032044,111099587,XM_022430915.1,uncharacterized LOC111099587,24323
NC_035785.1,13005865,13032664,13005865,13032045,111099587,XM_022430913.1,uncharacterized LOC111099587,26180
NC_035785.1,13005865,13032664,13005865,13032046,111099587,XM_022430914.1,uncharacterized LOC111099587,26181
NC_035785.1,13005865,13032664,13005865,13032664,111099587,XM_022430912.1,uncharacterized LOC111099587,26799
NC_035785.1,32887167,32888456,32887167,32888456,111099589,XM_022430917.1,uncharacterized LOC111099589,1289
NC_035785.1,6669975,6677396,6669975,6677396,111099590,XM_022430918.1,uncharacterized LOC111099590,7421
NC_035785.1,6677407,6684516,6678413,6684516,111099591,XM_022430919.1,uncharacterized LOC111099591,6103
NC_035785.1,6677407,6684516,6677407,6684516,111099591,XM_022430921.1,uncharacterized LOC111099591,7109
NC_035785.1,28936751,29043689,28936751,29043689,111099595,XM_022430928.1,uncharacterized LOC111099595,106938
NC_035785.1,40487636,40510968,40487636,40500715,111099596,XM_022430931.1,uncharacterized LOC111099596,13079
NC_035785.1,40487636,40510968,40487636,40505544,111099596,XM_022430930.1,uncharacterized LOC111099596,17908
NC_035785.1,40487636,40510968,40487636,40510968,111099596,XM_022430933.1,uncharacterized LOC111099596,23332
NC_035785.1,5020706,5027972,5021798,5027972,111099601,XM_022430939.1,uncharacterized LOC111099601,6174
NC_035785.1,5020706,5027972,5020706,5027972,111099601,XM_022430941.1,uncharacterized LOC111099601,7266
NC_035785.1,22103193,22109128,22103193,22109128,111099602,XM_022430943.1,uncharacterized LOC111099602,5935
NC_035780.1,63633496,63645720,63633496,63645720,111099604,XM_022430955.1,uncharacterized LOC111099604,12224
NC_035780.1,34445720,34448270,34445720,34448270,111099605,XM_022430994.1,uncharacterized LOC111099605,2550
NC_035785.1,29509160,29512048,29509160,29512048,111099606,XM_022430958.1,uncharacterized LOC111099606,2888
NC_035785.1,29605134,29625503,29605134,29625503,111099609,XM_022430960.1,uncharacterized LOC111099609,20369
NC_035785.1,33051194,33065199,33051194,33061301,111099612,XM_022430967.1,uncharacterized LOC111099612,10107
NC_035785.1,33051194,33065199,33058731,33065199,111099612,XM_022430969.1,uncharacterized LOC111099612,6468
NC_035785.1,33051194,33065199,33051677,33061301,111099612,XM_022430968.1,uncharacterized LOC111099612,9624
NC_035785.1,5214925,5218922,5217123,5218922,111099615,XM_022430977.1,uncharacterized LOC111099615,1799
NC_035785.1,5214925,5218922,5216629,5218922,111099615,XM_022430975.1,uncharacterized LOC111099615,2293
NC_035785.1,5214925,5218922,5214925,5218905,111099615,XM_022430978.1,uncharacterized LOC111099615,3980
NC_035785.1,5214925,5218922,5214925,5218920,111099615,XM_022430974.1,uncharacterized LOC111099615,3995
NC_035785.1,5214925,5218922,5214925,5218921,111099615,XM_022430972.1,uncharacterized LOC111099615,3996
NC_035785.1,22284365,22286585,22284365,22286585,111099618,XM_022430980.1,uncharacterized LOC111099618,2220
NC_035785.1,966210,989697,966210,989697,111099627,XM_022430990.1,uncharacterized LOC111099627,23487
NC_035780.1,31331892,31335666,31331892,31335666,111099628,XM_022430995.1,uncharacterized LOC111099628,3774
NC_035785.1,967112,974184,967112,974184,111099629,XM_022430991.1,uncharacterized LOC111099629,7072
NC_035785.1,959660,970128,959660,970128,111099631,XM_022430996.1,uncharacterized LOC111099631,10468
NC_035785.1,959660,970128,959661,961570,111099631,XM_022430993.1,uncharacterized LOC111099631,1909
NC_035785.1,25748014,25774086,25748014,25772613,111099632,XM_022430997.1,uncharacterized LOC111099632,24599
NC_035785.1,25748014,25774086,25748014,25774086,111099632,XM_022430998.1,uncharacterized LOC111099632,26072
NC_035785.1,51228487,51233018,51228487,51233018,111099634,XM_022431000.1,uncharacterized LOC111099634,4531
NC_035785.1,28197550,28201835,28197550,28201835,111099640,XM_022431005.1,uncharacterized LOC111099640,4285
NC_035785.1,34730572,34732833,34730572,34732833,111099641,XM_022431006.1,uncharacterized LOC111099641,2261
NC_035785.1,3414393,3417535,3414398,3417535,111099642,XM_022431007.1,uncharacterized LOC111099642,3137
NC_035785.1,3414393,3417535,3414393,3417535,111099642,XM_022431008.1,uncharacterized LOC111099642,3142
NC_035785.1,7970267,7981150,7970267,7981150,111099644,XM_022431009.1,uncharacterized LOC111099644,10883
NC_035785.1,49706203,49741851,49706206,49741851,111099646,XM_022431010.1,uncharacterized LOC111099646,35645
NC_035785.1,49706203,49741851,49706203,49741851,111099646,XM_022431012.1,uncharacterized LOC111099646,35648
NC_035785.1,620456,623219,620456,623219,111099654,XM_022431019.1,uncharacterized LOC111099654,2763
NC_035785.1,641144,645517,641144,645517,111099656,XM_022431024.1,uncharacterized LOC111099656,4373
NC_035785.1,25973515,26000190,25973515,25994942,111099663,XM_022431033.1,uncharacterized LOC111099663,21427
NC_035785.1,25973515,26000190,25973515,25997084,111099663,XM_022431032.1,uncharacterized LOC111099663,23569
NC_035785.1,25973515,26000190,25973515,25997230,111099663,XM_022431034.1,uncharacterized LOC111099663,23715
NC_035785.1,25973515,26000190,25973515,25998495,111099663,XM_022431037.1,uncharacterized LOC111099663,24980
NC_035785.1,25973515,26000190,25973515,26000153,111099663,XM_022431030.1,uncharacterized LOC111099663,26638
NC_035785.1,25973515,26000190,25973515,26000187,111099663,XM_022431031.1,uncharacterized LOC111099663,26672
NC_035785.1,25973515,26000190,25973515,26000190,111099663,XM_022431038.1,uncharacterized LOC111099663,26675
NC_035785.1,39761853,39778355,39762416,39778355,111099667,XM_022431054.1,uncharacterized LOC111099667,15939
NC_035785.1,39761853,39778355,39761853,39778355,111099667,XM_022431053.1,uncharacterized LOC111099667,16502
NC_035785.1,32147621,32150808,32147621,32150808,111099671,XM_022431058.1,uncharacterized LOC111099671,3187
NC_035785.1,20837227,20847353,20837227,20847344,111099673,XM_022431063.1,uncharacterized LOC111099673,10117
NC_035785.1,20837227,20847353,20837227,20847346,111099673,XM_022431059.1,uncharacterized LOC111099673,10119
NC_035785.1,20837227,20847353,20837227,20847347,111099673,XM_022431062.1,uncharacterized LOC111099673,10120
NC_035785.1,695745,700221,695745,700221,111099679,XM_022431068.1,uncharacterized LOC111099679,4476
NC_035785.1,744459,748829,744459,748829,111099680,XM_022431069.1,uncharacterized LOC111099680,4370
NC_035785.1,760604,767681,760604,767681,111099681,XM_022431070.1,uncharacterized LOC111099681,7077
NC_035785.1,33830238,33834697,33830238,33834671,111099683,XM_022431074.1,uncharacterized LOC111099683,4433
NC_035785.1,33830238,33834697,33830238,33834697,111099683,XM_022431073.1,uncharacterized LOC111099683,4459
NC_035785.1,11416225,11418802,11416225,11418802,111099685,XM_022431077.1,uncharacterized LOC111099685,2577
NC_035785.1,8436815,8442896,8436815,8442872,111099686,XM_022431081.1,uncharacterized LOC111099686,6057
NC_035785.1,28755230,28790974,28757360,28790974,111099689,XM_022431085.1,uncharacterized LOC111099689,33614
NC_035785.1,28755230,28790974,28755230,28790974,111099689,XM_022431086.1,uncharacterized LOC111099689,35744
NC_035785.1,9016148,9018078,9016148,9018078,111099691,XM_022431090.1,uncharacterized LOC111099691,1930
NC_035785.1,2171238,2174823,2171238,2174823,111099694,XM_022431102.1,uncharacterized LOC111099694,3585
NC_035785.1,20902372,20907197,20902372,20907197,111099704,XM_022431116.1,uncharacterized LOC111099704,4825
NC_035785.1,26457893,26521088,26457893,26521088,111099705,XM_022431117.1,uncharacterized LOC111099705,63195
NC_035785.1,47344280,47349886,47344305,47349882,111099711,XM_022431121.1,uncharacterized LOC111099711,5577
NC_035785.1,47344280,47349886,47344297,47349883,111099711,XM_022431123.1,uncharacterized LOC111099711,5586
NC_035785.1,47344280,47349886,47344282,47349882,111099711,XM_022431122.1,uncharacterized LOC111099711,5600
NC_035785.1,47344280,47349886,47344280,47349882,111099711,XM_022431124.1,uncharacterized LOC111099711,5602
NC_035785.1,10677367,10691602,10678702,10691602,111099721,XM_022431133.1,uncharacterized LOC111099721,12900
NC_035785.1,10677367,10691602,10677401,10691602,111099721,XM_022431135.1,uncharacterized LOC111099721,14201
NC_035785.1,10677367,10691602,10677400,10691602,111099721,XM_022431136.1,uncharacterized LOC111099721,14202
NC_035785.1,10677367,10691602,10677397,10691602,111099721,XM_022431134.1,uncharacterized LOC111099721,14205
NC_035785.1,10677367,10691602,10677367,10691602,111099721,XM_022431138.1,uncharacterized LOC111099721,14235
NC_035785.1,27760608,27800904,27760610,27800904,111099726,XM_022431145.1,uncharacterized LOC111099726,40294
NC_035785.1,27760608,27800904,27760608,27800904,111099726,XM_022431143.1,uncharacterized LOC111099726,40296
NC_035785.1,40088980,40101434,40088980,40101434,111099727,XM_022431147.1,uncharacterized LOC111099727,12454
NC_035785.1,40086236,40088869,40086236,40088869,111099728,XM_022431148.1,uncharacterized LOC111099728,2633
NC_035785.1,43763402,43775324,43763402,43775324,111099729,XM_022431149.1,uncharacterized LOC111099729,11922
NC_035785.1,1115937,1125464,1115938,1125464,111099730,XM_022431150.1,uncharacterized LOC111099730,9526
NC_035785.1,1115937,1125464,1115937,1125464,111099730,XM_022431151.1,uncharacterized LOC111099730,9527
NC_035780.1,29441775,29447523,29441775,29447523,111099732,XM_022431156.1,uncharacterized LOC111099732,5748
NC_035785.1,348555,372022,350064,371741,111099733,XM_022431154.1,uncharacterized LOC111099733,21677
NC_035785.1,12586731,12611836,12597811,12611836,111099734,XM_022431158.1,uncharacterized LOC111099734,14025
NC_035785.1,12586731,12611836,12586731,12611836,111099734,XM_022431157.1,uncharacterized LOC111099734,25105
NC_035780.1,31828748,31830323,31828748,31830323,111099738,XM_022431170.1,uncharacterized LOC111099738,1575
NC_035785.1,26096041,26107762,26096041,26107762,111099739,XM_022431168.1,uncharacterized LOC111099739,11721
NC_035785.1,3699664,3703445,3699664,3703445,111099749,XM_022431182.1,uncharacterized LOC111099749,3781
NC_035785.1,41662979,41694520,41663336,41694520,111099750,XM_022431183.1,uncharacterized LOC111099750,31184
NC_035785.1,41662979,41694520,41662979,41694520,111099750,XM_022431184.1,uncharacterized LOC111099750,31541
NC_035785.1,41662979,41694520,41687754,41694520,111099750,XM_022431185.1,uncharacterized LOC111099750,6766
NC_035780.1,30172276,30173892,30172276,30173892,111099751,XM_022431224.1,uncharacterized LOC111099751,1616
NC_035785.1,11114585,11121379,11114585,11121379,111099753,XM_022431187.1,uncharacterized LOC111099753,6794
NC_035785.1,30524344,30527677,30524344,30527677,111099756,XM_022431192.1,uncharacterized LOC111099756,3333
NC_035785.1,46794405,46822298,46794405,46822298,111099761,XM_022431193.1,uncharacterized LOC111099761,27893
NC_035785.1,52211,55037,52211,55037,111099764,XM_022431195.1,uncharacterized LOC111099764,2826
NC_035785.1,38143694,38150857,38143694,38150489,111099765,XM_022431198.1,uncharacterized LOC111099765,6795
NC_035785.1,38143694,38150857,38143694,38150806,111099765,XM_022431197.1,uncharacterized LOC111099765,7112
NC_035785.1,38143694,38150857,38143694,38150852,111099765,XM_022431199.1,uncharacterized LOC111099765,7158
NC_035785.1,38143694,38150857,38143694,38150857,111099765,XM_022431196.1,uncharacterized LOC111099765,7163
NC_035785.1,41268980,41273151,41268980,41273151,111099766,XM_022431202.1,uncharacterized LOC111099766,4171
NC_035785.1,26841445,26862698,26851626,26862696,111099767,XM_022431203.1,uncharacterized LOC111099767,11070
NC_035785.1,26841445,26862698,26851557,26862695,111099767,XM_022431205.1,uncharacterized LOC111099767,11138
NC_035785.1,26841445,26862698,26848951,26862696,111099767,XM_022431204.1,uncharacterized LOC111099767,13745
NC_035785.1,26841445,26862698,26848860,26862697,111099767,XM_022431206.1,uncharacterized LOC111099767,13837
NC_035785.1,26841445,26862698,26841445,26862698,111099767,XM_022431207.1,uncharacterized LOC111099767,21253
NC_035785.1,42055435,42063622,42055435,42063622,111099783,XM_022431242.1,uncharacterized LOC111099783,8187
NC_035785.1,42040218,42042932,42040218,42042932,111099784,XM_022431243.1,uncharacterized LOC111099784,2714
NC_035785.1,42016327,42019750,42016327,42019750,111099786,XM_022431245.1,uncharacterized LOC111099786,3423
NC_035785.1,42021083,42022511,42021083,42022511,111099787,XM_022431246.1,uncharacterized LOC111099787,1428
NC_035785.1,42019847,42020775,42019847,42020775,111099788,XM_022431247.1,uncharacterized LOC111099788,928
NC_035785.1,41940814,41946294,41940814,41946287,111099789,XM_022431249.1,uncharacterized LOC111099789,5473
NC_035785.1,41940814,41946294,41940814,41946293,111099789,XM_022431250.1,uncharacterized LOC111099789,5479
NC_035785.1,41940814,41946294,41940814,41946294,111099789,XM_022431248.1,uncharacterized LOC111099789,5480
NC_035785.1,1370162,1383121,1370162,1383121,111099793,XM_022431251.1,uncharacterized LOC111099793,12959
NC_035785.1,37906289,37909228,37906602,37909228,111099795,XM_022431260.1,uncharacterized LOC111099795,2626
NC_035785.1,37906289,37909228,37906289,37909227,111099795,XM_022431259.1,uncharacterized LOC111099795,2938
NC_035780.1,48026822,48031049,48026822,48031049,111099798,XM_022431266.1,uncharacterized LOC111099798,4227
NC_035785.1,40525303,40529341,40525303,40529341,111099799,XM_022431263.1,uncharacterized LOC111099799,4038
NC_035785.1,43483558,43496532,43485053,43496532,111099802,XM_022431267.1,uncharacterized LOC111099802,11479
NC_035785.1,43483558,43496532,43483558,43496532,111099802,XM_022431265.1,uncharacterized LOC111099802,12974
NC_035785.1,38269539,38277158,38269559,38277158,111099804,XM_022431270.1,uncharacterized LOC111099804,7599
NC_035785.1,38269539,38277158,38269539,38277158,111099804,XM_022431269.1,uncharacterized LOC111099804,7619
NC_035785.1,477817,485211,477817,485211,111099806,XM_022431271.1,uncharacterized LOC111099806,7394
NC_035785.1,485335,495615,485335,495615,111099807,XM_022431272.1,uncharacterized LOC111099807,10280
NC_035785.1,3341631,3356622,3341631,3356622,111099810,XM_022431273.1,uncharacterized LOC111099810,14991
NC_035785.1,21899396,21906852,21899396,21906852,111099813,XM_022431278.1,uncharacterized LOC111099813,7456
NC_035785.1,21994171,21995224,21994171,21995224,111099814,XM_022431279.1,uncharacterized LOC111099814,1053
NC_035785.1,4989505,4995185,4989505,4995185,111099816,XM_022431281.1,uncharacterized LOC111099816,5680
NC_035785.1,48023691,48028010,48023691,48028010,111099820,XM_022431284.1,uncharacterized LOC111099820,4319
NC_035785.1,37284887,37287281,37284887,37287281,111099821,XM_022431285.1,uncharacterized LOC111099821,2394
NC_035785.1,18330738,18344023,18330738,18344023,111099823,XM_022431288.1,uncharacterized LOC111099823,13285
NC_035785.1,49992275,50003892,49992275,50003892,111099825,XM_022431289.1,uncharacterized LOC111099825,11617
NC_035785.1,3097124,3099716,3097124,3099716,111099827,XM_022431290.1,uncharacterized LOC111099827,2592
NC_035785.1,17647051,17649518,17647051,17649518,111099828,XM_022431291.1,uncharacterized LOC111099828,2467
NC_035785.1,8386399,8407357,8393278,8407334,111099830,XM_022431295.1,uncharacterized LOC111099830,14056
NC_035785.1,8386399,8407357,8386399,8407357,111099830,XM_022431296.1,uncharacterized LOC111099830,20958
NC_035785.1,8386399,8407357,8386399,8392183,111099830,XM_022431294.1,uncharacterized LOC111099830,5784
NC_035785.1,8321313,8326399,8321313,8326399,111099832,XM_022431298.1,uncharacterized LOC111099832,5086
NC_035785.1,8353715,8357649,8353715,8357649,111099833,XM_022431299.1,uncharacterized LOC111099833,3934
NC_035785.1,8371080,8376321,8371080,8376321,111099834,XM_022431300.1,uncharacterized LOC111099834,5241
NC_035785.1,37743060,37744514,37743060,37744514,111099842,XM_022431307.1,uncharacterized LOC111099842,1454
NC_035785.1,37764247,37780720,37764247,37780720,111099843,XM_022431308.1,uncharacterized LOC111099843,16473
NC_035780.1,32990757,33000484,32990757,33000484,111099844,XM_022431313.1,uncharacterized LOC111099844,9727
NC_035785.1,37790433,37797178,37790433,37797178,111099847,XM_022431312.1,uncharacterized LOC111099847,6745
NC_035785.1,42231522,42239287,42231522,42238367,111099849,XM_022431316.1,uncharacterized LOC111099849,6845
NC_035785.1,42231522,42239287,42231522,42238431,111099849,XM_022431315.1,uncharacterized LOC111099849,6909
NC_035785.1,42231522,42239287,42231522,42239287,111099849,XM_022431320.1,uncharacterized LOC111099849,7765
NC_035785.1,40329863,40351616,40329863,40351616,111099850,XM_022431321.1,uncharacterized LOC111099850,21753
NC_035785.1,1530822,1542165,1531585,1542165,111099852,XM_022431323.1,uncharacterized LOC111099852,10580
NC_035785.1,1530822,1542165,1530822,1542165,111099852,XM_022431322.1,uncharacterized LOC111099852,11343
NC_035785.1,33844328,33849843,33846710,33849843,111099854,XM_022431326.1,uncharacterized LOC111099854,3133
NC_035785.1,33844328,33849843,33844328,33849843,111099854,XM_022431324.1,uncharacterized LOC111099854,5515
NC_035785.1,45688501,45693048,45688501,45693048,111099855,XM_022431327.1,uncharacterized LOC111099855,4547
NC_035785.1,32142096,32144085,32142096,32144085,111099856,XM_022431328.1,uncharacterized LOC111099856,1989
NC_035785.1,27592678,27601106,27592678,27601106,111099858,XM_022431330.1,uncharacterized LOC111099858,8428
NC_035785.1,43211988,43213745,43211988,43213745,111099859,XM_022431331.1,uncharacterized LOC111099859,1757
NC_035785.1,23028831,23041486,23028831,23041486,111099860,XM_022431332.1,uncharacterized LOC111099860,12655
NC_035780.1,33008306,33013880,33008306,33013880,111099861,XM_022431337.1,uncharacterized LOC111099861,5574
NC_035785.1,35335106,35337648,35335106,35337648,111099862,XM_022431334.1,uncharacterized LOC111099862,2542
NC_035785.1,884812,889121,884812,888193,111099864,XM_022431338.1,uncharacterized LOC111099864,3381
NC_035785.1,884812,889121,884812,889121,111099864,XM_022431336.1,uncharacterized LOC111099864,4309
NC_035785.1,6553297,6566433,6553297,6566433,111099867,XM_022431340.1,uncharacterized LOC111099867,13136
NC_035785.1,22203049,22235174,22203049,22235174,111099868,XM_022431341.1,uncharacterized LOC111099868,32125
NC_035785.1,34829969,34835933,34829969,34835933,111099869,XM_022431342.1,uncharacterized LOC111099869,5964
NC_035785.1,48045891,48047588,48045891,48047588,111099874,XM_022431358.1,uncharacterized LOC111099874,1697
NC_035785.1,277918,342453,277918,342453,111099876,XM_022431360.1,uncharacterized LOC111099876,64535
NC_035785.1,12535339,12540743,12537126,12540743,111099878,XM_022431362.1,uncharacterized LOC111099878,3617
NC_035785.1,12535339,12540743,12535339,12540743,111099878,XM_022431361.1,uncharacterized LOC111099878,5404
NC_035785.1,5991546,5994866,5991546,5993997,111099879,XM_022431364.1,uncharacterized LOC111099879,2451
NC_035785.1,5991546,5994866,5991546,5994866,111099879,XM_022431363.1,uncharacterized LOC111099879,3320
NC_035785.1,33977239,33979284,33977239,33979167,111099880,XM_022431366.1,uncharacterized LOC111099880,1928
NC_035785.1,33977239,33979284,33977239,33979198,111099880,XM_022431365.1,uncharacterized LOC111099880,1959
NC_035785.1,33977239,33979284,33977239,33979284,111099880,XM_022431367.1,uncharacterized LOC111099880,2045
NC_035780.1,56311389,56316833,56311571,56316809,111099888,XM_022431380.1,uncharacterized LOC111099888,5238
NC_035780.1,56311389,56316833,56311412,56316819,111099888,XM_022431400.1,uncharacterized LOC111099888,5407
NC_035780.1,56311389,56316833,56311407,56316833,111099888,XM_022431390.1,uncharacterized LOC111099888,5426
NC_035785.1,3331168,3336206,3331168,3336206,111099889,XM_022431379.1,uncharacterized LOC111099889,5038
NC_035785.1,49109671,49117752,49109671,49113625,111099892,XM_022431381.1,uncharacterized LOC111099892,3954
NC_035785.1,49109671,49117752,49110580,49117752,111099892,XM_022431382.1,uncharacterized LOC111099892,7172
NC_035785.1,49109671,49117752,49110579,49117752,111099892,XM_022431386.1,uncharacterized LOC111099892,7173
NC_035785.1,49073565,49100289,49073565,49100289,111099894,XM_022431392.1,uncharacterized LOC111099894,26724
NC_035785.1,49073565,49100289,49092888,49100289,111099894,XM_022431391.1,uncharacterized LOC111099894,7401
NC_035785.1,49073565,49100289,49092874,49100289,111099894,XM_022431389.1,uncharacterized LOC111099894,7415
NC_035785.1,13034595,13039552,13034595,13039552,111099902,XM_022431408.1,uncharacterized LOC111099902,4957
NC_035785.1,50159012,50204502,50188258,50204502,111099905,XM_022431414.1,uncharacterized LOC111099905,16244
NC_035785.1,50159012,50204502,50188204,50204502,111099905,XM_022431415.1,uncharacterized LOC111099905,16298
NC_035785.1,50159012,50204502,50159012,50204502,111099905,XM_022431413.1,uncharacterized LOC111099905,45490
NC_035780.1,58385953,58388391,58385953,58388391,111099906,XM_022431455.1,uncharacterized LOC111099906,2438
NC_035785.1,34720720,34722529,34720720,34722529,111099907,XM_022431417.1,uncharacterized LOC111099907,1809
NC_035785.1,8189955,8195251,8189965,8195251,111099910,XM_022431419.1,uncharacterized LOC111099910,5286
NC_035785.1,8189955,8195251,8189955,8195251,111099910,XM_022431420.1,uncharacterized LOC111099910,5296
NC_035785.1,50611564,50639118,50611564,50639118,111099912,XM_022431421.1,uncharacterized LOC111099912,27554
NC_035785.1,23790707,23792991,23790707,23792991,111099914,XM_022431422.1,uncharacterized LOC111099914,2284
NC_035785.1,17628902,17634788,17628902,17631268,111099916,XM_022431425.1,uncharacterized LOC111099916,2366
NC_035785.1,17628902,17634788,17628902,17633988,111099916,XM_022431424.1,uncharacterized LOC111099916,5086
NC_035785.1,17628902,17634788,17628902,17634788,111099916,XM_022431426.1,uncharacterized LOC111099916,5886
NC_035785.1,2273438,2276210,2273438,2276210,111099917,XM_022431427.1,uncharacterized LOC111099917,2772
NC_035785.1,8412619,8423105,8412619,8423105,111099919,XM_022431429.1,uncharacterized LOC111099919,10486
NC_035785.1,8412619,8423105,8412619,8419666,111099919,XM_022431430.1,uncharacterized LOC111099919,7047
NC_035785.1,4447254,4458336,4447254,4457794,111099920,XM_022431434.1,uncharacterized LOC111099920,10540
NC_035785.1,4447254,4458336,4447254,4458029,111099920,XM_022431433.1,uncharacterized LOC111099920,10775
NC_035785.1,4447254,4458336,4447254,4458336,111099920,XM_022431431.1,uncharacterized LOC111099920,11082
NC_035785.1,4447254,4458336,4447254,4450680,111099920,XM_022431435.1,uncharacterized LOC111099920,3426
NC_035780.1,23266377,23270575,23266377,23270575,111099921,XM_022431437.1,uncharacterized LOC111099921,4198
NC_035785.1,11493602,11495932,11493602,11495932,111099923,XM_022431438.1,uncharacterized LOC111099923,2330
NC_035785.1,33584939,33586045,33584939,33586045,111099924,XM_022431439.1,uncharacterized LOC111099924,1106
NC_035785.1,1798389,1802977,1798389,1802977,111099926,XM_022431443.1,uncharacterized LOC111099926,4588
NC_035780.1,27417715,27420310,27417715,27420310,111099928,XM_022431449.1,uncharacterized LOC111099928,2595
NC_035785.1,44760098,44802124,44760098,44785112,111099929,XM_022431453.1,uncharacterized LOC111099929,25014
NC_035785.1,44760098,44802124,44774674,44802124,111099929,XM_022431454.1,uncharacterized LOC111099929,27450
NC_035785.1,44760098,44802124,44774603,44802124,111099929,XM_022431456.1,uncharacterized LOC111099929,27521
NC_035785.1,44760098,44802124,44774129,44802124,111099929,XM_022431452.1,uncharacterized LOC111099929,27995
NC_035785.1,44760098,44802124,44760098,44802124,111099929,XM_022431447.1,uncharacterized LOC111099929,42026
NC_035785.1,28238560,28335370,28238560,28325878,111099930,XM_022431458.1,uncharacterized LOC111099930,87318
NC_035785.1,28238560,28335370,28238560,28335370,111099930,XM_022431457.1,uncharacterized LOC111099930,96810
NC_035785.1,28499261,28561290,28499261,28561290,111099931,XM_022431459.1,uncharacterized LOC111099931,62029
NC_035785.1,17449800,17480571,17449800,17480571,111099934,XM_022431461.1,uncharacterized LOC111099934,30771
NC_035785.1,16675599,16678053,16675599,16678053,111099935,XM_022431462.1,uncharacterized LOC111099935,2454
NC_035785.1,49920023,49925681,49920023,49925681,111099937,XM_022431465.1,uncharacterized LOC111099937,5658
NC_035785.1,5775029,5791292,5775029,5791292,111099940,XM_022431467.1,uncharacterized LOC111099940,16263
NC_035785.1,6057987,6069275,6057987,6069275,111099942,XM_022431468.1,uncharacterized LOC111099942,11288
NC_035785.1,38761276,38771492,38761276,38771492,111099944,XM_022431469.1,uncharacterized LOC111099944,10216
NC_035785.1,38761276,38771492,38761276,38770662,111099944,XM_022431471.1,uncharacterized LOC111099944,9386
NC_035785.1,51207554,51210854,51207554,51209222,111099947,XM_022431477.1,uncharacterized LOC111099947,1668
NC_035785.1,51207554,51210854,51208451,51210854,111099947,XM_022431476.1,uncharacterized LOC111099947,2403
NC_035785.1,25306895,25307632,25306895,25307632,111099948,XM_022431478.1,uncharacterized LOC111099948,737
NC_035785.1,46635833,46637346,46635833,46637346,111099951,XM_022431479.1,uncharacterized LOC111099951,1513
NC_035785.1,2811757,2815888,2811757,2815888,111099957,XM_022431489.1,uncharacterized LOC111099957,4131
NC_035785.1,50786187,50797578,50786187,50797578,111099960,XM_022431492.1,uncharacterized LOC111099960,11391
NC_035785.1,17786088,17791815,17786088,17791813,111099963,XM_022431496.1,uncharacterized LOC111099963,5725
NC_035785.1,17786088,17791815,17786088,17791815,111099963,XM_022431497.1,uncharacterized LOC111099963,5727
NC_035780.1,45490328,45492595,45490328,45492595,111099966,XM_022431505.1,uncharacterized LOC111099966,2267
NC_035785.1,11477321,11481398,11477321,11481332,111099967,XM_022431504.1,uncharacterized LOC111099967,4011
NC_035785.1,11482022,11484299,11482022,11484299,111099969,XM_022431507.1,uncharacterized LOC111099969,2277
NC_035785.1,11476109,11476944,11476109,11476944,111099970,XM_022431508.1,uncharacterized LOC111099970,835
NC_035785.1,11447890,11448858,11447890,11448858,111099971,XM_022431509.1,uncharacterized LOC111099971,968
NC_035785.1,5535482,5546235,5535482,5546235,111099986,XM_022431539.1,uncharacterized LOC111099986,10753
NC_035785.1,34716119,34717730,34716119,34717730,111099988,XM_022431540.1,uncharacterized LOC111099988,1611
NC_035785.1,5705035,5706154,5705035,5706154,111099990,XM_022431541.1,uncharacterized LOC111099990,1119
NC_035785.1,22292077,22299035,22292077,22298779,111099993,XM_022431545.1,uncharacterized LOC111099993,6702
NC_035785.1,22292077,22299035,22292077,22299035,111099993,XM_022431544.1,uncharacterized LOC111099993,6958
NC_035785.1,41542141,41555176,41542141,41555176,111099994,XM_022431546.1,uncharacterized LOC111099994,13035
NC_035785.1,12656981,12659529,12656981,12659241,111099997,XM_022431558.1,uncharacterized LOC111099997,2260
NC_035785.1,12656981,12659529,12656981,12659529,111099997,XM_022431557.1,uncharacterized LOC111099997,2548
NC_035785.1,21497218,21524479,21497218,21524479,111099998,XM_022431559.1,uncharacterized LOC111099998,27261
NC_035785.1,21497218,21524479,21518267,21524479,111099998,XM_022431561.1,uncharacterized LOC111099998,6212
NC_035785.1,4830086,4833523,4830086,4833523,111100001,XM_022431562.1,uncharacterized LOC111100001,3437
NC_035785.1,1234869,1241732,1234869,1241732,111100004,XM_022431563.1,uncharacterized LOC111100004,6863
NC_035785.1,38156991,38162747,38159588,38162747,111100010,XM_022431573.1,uncharacterized LOC111100010,3159
NC_035785.1,38156991,38162747,38157013,38162747,111100010,XM_022431569.1,uncharacterized LOC111100010,5734
NC_035785.1,38156991,38162747,38156991,38162747,111100010,XM_022431570.1,uncharacterized LOC111100010,5756
NC_035780.1,8292814,8306980,8292814,8306980,111100011,XM_022431589.1,uncharacterized LOC111100011,14166
NC_035780.1,8292814,8306980,8299337,8306980,111100011,XM_022431577.1,uncharacterized LOC111100011,7643
NC_035785.1,12808867,12983447,12808867,12983447,111100017,XM_022431579.1,uncharacterized LOC111100017,174580
NC_035785.1,12780806,12808290,12780806,12808290,111100018,XM_022431582.1,uncharacterized LOC111100018,27484
NC_035785.1,12780806,12808290,12780806,12788760,111100018,XM_022431580.1,uncharacterized LOC111100018,7954
NC_035785.1,12780806,12808290,12780806,12788782,111100018,XM_022431581.1,uncharacterized LOC111100018,7976
NC_035785.1,12788627,12800924,12788627,12800886,111100019,XM_022431585.1,uncharacterized LOC111100019,12259
NC_035785.1,12788627,12800924,12788627,12800924,111100019,XM_022431584.1,uncharacterized LOC111100019,12297
NC_035785.1,19204482,19230104,19204486,19230104,111100024,XM_022431590.1,uncharacterized LOC111100024,25618
NC_035785.1,19204482,19230104,19204482,19230104,111100024,XM_022431591.1,uncharacterized LOC111100024,25622
NC_035780.1,8306842,8308416,8306842,8308416,111100027,XM_022431604.1,uncharacterized LOC111100027,1574
NC_035785.1,16652820,16658824,16652820,16654598,111100028,XM_022431611.1,uncharacterized LOC111100028,1778
NC_035785.1,16652820,16658824,16652820,16657846,111100028,XM_022431612.1,uncharacterized LOC111100028,5026
NC_035785.1,16652820,16658824,16652820,16658824,111100028,XM_022431613.1,uncharacterized LOC111100028,6004
NC_035785.1,25743243,25747959,25743243,25747959,111100030,XM_022431614.1,uncharacterized LOC111100030,4716
NC_035785.1,5451411,5473139,5451411,5473139,111100031,XM_022431616.1,uncharacterized LOC111100031,21728
NC_035785.1,29253801,29256799,29253801,29256799,111100036,XM_022431621.1,uncharacterized LOC111100036,2998
NC_035785.1,21212388,21217344,21212388,21217344,111100038,XM_022431625.1,uncharacterized LOC111100038,4956
NC_035785.1,30902950,30905836,30902950,30905836,111100039,XM_022431626.1,uncharacterized LOC111100039,2886
NC_035785.1,30876717,30902794,30876717,30902794,111100040,XM_022431627.1,uncharacterized LOC111100040,26077
NC_035785.1,45666247,45671173,45666247,45671173,111100045,XM_022431633.1,uncharacterized LOC111100045,4926
NC_035785.1,36183113,36194947,36183113,36194947,111100047,XM_022431635.1,uncharacterized LOC111100047,11834
NC_035785.1,11321812,11328609,11321812,11328569,111100050,XM_022431640.1,uncharacterized LOC111100050,6757
NC_035785.1,11321812,11328609,11321812,11328609,111100050,XM_022431639.1,uncharacterized LOC111100050,6797
NC_035785.1,33588766,33590750,33588766,33590750,111100051,XM_022431641.1,uncharacterized LOC111100051,1984
NC_035785.1,5129545,5136460,5129545,5136460,111100052,XM_022431642.1,uncharacterized LOC111100052,6915
NC_035785.1,5151374,5169050,5151374,5169050,111100054,XM_022431646.1,uncharacterized LOC111100054,17676
NC_035785.1,5151374,5169050,5163823,5169050,111100054,XM_022431647.1,uncharacterized LOC111100054,5227
NC_035785.1,24520808,24570130,24520808,24570130,111100059,XM_022431651.1,uncharacterized LOC111100059,49322
NC_035785.1,28792596,28813200,28792596,28813200,111100061,XM_022431653.1,uncharacterized LOC111100061,20604
NC_035785.1,13763895,13812218,13770427,13812218,111100064,XM_022431660.1,uncharacterized LOC111100064,41791
NC_035785.1,13763895,13812218,13770380,13812218,111100064,XM_022431661.1,uncharacterized LOC111100064,41838
NC_035785.1,13763895,13812218,13765575,13812218,111100064,XM_022431659.1,uncharacterized LOC111100064,46643
NC_035785.1,13763895,13812218,13763895,13812218,111100064,XM_022431657.1,uncharacterized LOC111100064,48323
NC_035785.1,10892890,10899063,10892890,10899063,111100067,XM_022431667.1,uncharacterized LOC111100067,6173
NC_035785.1,3394815,3399698,3395577,3399698,111100068,XM_022431669.1,uncharacterized LOC111100068,4121
NC_035785.1,3394815,3399698,3394815,3399698,111100068,XM_022431668.1,uncharacterized LOC111100068,4883
NC_035785.1,8786388,8826039,8786388,8826039,111100073,XM_022431673.1,uncharacterized LOC111100073,39651
NC_035785.1,27870160,27874890,27870160,27874190,111100074,XM_022431675.1,uncharacterized LOC111100074,4030
NC_035785.1,27870160,27874890,27870160,27874890,111100074,XM_022431674.1,uncharacterized LOC111100074,4730
NC_035785.1,29195206,29202766,29195206,29202766,111100076,XM_022431678.1,uncharacterized LOC111100076,7560
NC_035785.1,11613114,11618461,11613114,11616740,111100077,XM_022431680.1,uncharacterized LOC111100077,3626
NC_035785.1,11613114,11618461,11613114,11618461,111100077,XM_022431679.1,uncharacterized LOC111100077,5347
NC_035785.1,33741964,33745422,33741964,33745418,111100078,XM_022431682.1,uncharacterized LOC111100078,3454
NC_035785.1,33741964,33745422,33741964,33745419,111100078,XM_022431681.1,uncharacterized LOC111100078,3455
NC_035785.1,48638959,48643572,48638959,48643572,111100082,XM_022431691.1,uncharacterized LOC111100082,4613
NC_035785.1,48611667,48622149,48611667,48622149,111100083,XM_022431692.1,uncharacterized LOC111100083,10482
NC_035785.1,28168175,28177222,28168175,28177222,111100086,XM_022431694.1,uncharacterized LOC111100086,9047
NC_035785.1,34838328,34841592,34838328,34841592,111100087,XM_022431695.1,uncharacterized LOC111100087,3264
NC_035785.1,36196373,36218975,36196428,36218975,111100089,XM_022431699.1,uncharacterized LOC111100089,22547
NC_035785.1,36196373,36218975,36196373,36218975,111100089,XM_022431698.1,uncharacterized LOC111100089,22602
NC_035785.1,33143028,33145533,33143028,33145203,111100093,XM_022431705.1,uncharacterized LOC111100093,2175
NC_035785.1,33143028,33145533,33143028,33145533,111100093,XM_022431704.1,uncharacterized LOC111100093,2505
NC_035785.1,8037481,8045251,8037481,8045251,111100094,XM_022431708.1,uncharacterized LOC111100094,7770
NC_035785.1,12768059,12774396,12768059,12774396,111100096,XM_022431711.1,uncharacterized LOC111100096,6337
NC_035780.1,6131116,6133530,6131116,6133530,111100099,XM_022431750.1,uncharacterized LOC111100099,2414
NC_035780.1,15967722,15996583,15967897,15996583,111100100,XM_022431727.1,uncharacterized LOC111100100,28686
NC_035780.1,15967722,15996583,15967722,15996583,111100100,XM_022431717.1,uncharacterized LOC111100100,28861
NC_035785.1,2016047,2020586,2016047,2020586,111100103,XM_022431718.1,uncharacterized LOC111100103,4539
NC_035785.1,4807302,4821696,4807302,4821696,111100107,XM_022431720.1,uncharacterized LOC111100107,14394
NC_035785.1,16808182,16810710,16808182,16810710,111100109,XM_022431721.1,uncharacterized LOC111100109,2528
NC_035785.1,38229659,38243624,38229659,38243624,111100112,XM_022431723.1,uncharacterized LOC111100112,13965
NC_035785.1,9919658,9927461,9919658,9927461,111100113,XM_022431724.1,uncharacterized LOC111100113,7803
NC_035785.1,45999236,46002190,45999236,46002190,111100115,XM_022431725.1,uncharacterized LOC111100115,2954
NC_035785.1,28719909,28734232,28719909,28734232,111100116,XM_022431726.1,uncharacterized LOC111100116,14323
NC_035785.1,42200596,42208708,42200596,42207696,111100117,XM_022431730.1,uncharacterized LOC111100117,7100
NC_035785.1,42200596,42208708,42200596,42207805,111100117,XM_022431729.1,uncharacterized LOC111100117,7209
NC_035785.1,42200596,42208708,42200596,42208708,111100117,XM_022431732.1,uncharacterized LOC111100117,8112
NC_035785.1,42185015,42229743,42185113,42198822,111100118,XM_022431738.1,uncharacterized LOC111100118,13709
NC_035785.1,42185015,42229743,42185112,42198822,111100118,XM_022431739.1,uncharacterized LOC111100118,13710
NC_035785.1,42185015,42229743,42185111,42198822,111100118,XM_022431736.1,uncharacterized LOC111100118,13711
NC_035785.1,42185015,42229743,42185097,42229743,111100118,XM_022431734.1,uncharacterized LOC111100118,44646
NC_035785.1,42185015,42229743,42185016,42229743,111100118,XM_022431733.1,uncharacterized LOC111100118,44727
NC_035785.1,42185015,42229743,42185015,42229743,111100118,XM_022431735.1,uncharacterized LOC111100118,44728
NC_035785.1,42216391,42222873,42216391,42222873,111100119,XM_022431740.1,uncharacterized LOC111100119,6482
NC_035785.1,19008819,19011942,19008819,19011942,111100124,XM_022431748.1,uncharacterized LOC111100124,3123
NC_035785.1,1247572,1258307,1247572,1258307,111100125,XM_022431751.1,uncharacterized LOC111100125,10735
NC_035785.1,32135090,32136148,32135090,32136148,111100127,XM_022431752.1,uncharacterized LOC111100127,1058
NC_035785.1,7878012,7914552,7878012,7914552,111100131,XM_022431756.1,uncharacterized LOC111100131,36540
NC_035785.1,11178222,11180820,11178222,11180820,111100132,XM_022431757.1,uncharacterized LOC111100132,2598
NC_035780.1,16190929,16208990,16190929,16207194,111100135,XM_022431763.1,uncharacterized LOC111100135,16265
NC_035785.1,49346883,49352307,49349547,49352307,111100136,XM_022431761.1,uncharacterized LOC111100136,2760
NC_035785.1,49346883,49352307,49346883,49352307,111100136,XM_022431760.1,uncharacterized LOC111100136,5424
NC_035785.1,24936007,24941639,24936007,24941639,111100137,XM_022431762.1,uncharacterized LOC111100137,5632
NC_035785.1,33225115,33232656,33230065,33232656,111100138,XM_022431765.1,uncharacterized LOC111100138,2591
NC_035785.1,33225115,33232656,33225115,33232656,111100138,XM_022431764.1,uncharacterized LOC111100138,7541
NC_035785.1,33216262,33223518,33221399,33223518,111100142,XM_022431769.1,uncharacterized LOC111100142,2119
NC_035785.1,33216262,33223518,33216262,33223518,111100142,XM_022431768.1,uncharacterized LOC111100142,7256
NC_035780.1,15888089,15916772,15901160,15916771,111100144,XM_022431788.1,uncharacterized LOC111100144,15611
NC_035780.1,15888089,15916772,15888089,15916771,111100144,XM_022431778.1,uncharacterized LOC111100144,28682
NC_035780.1,15888089,15916772,15888089,15916772,111100144,XM_022431799.1,uncharacterized LOC111100144,28683
NC_035785.1,4056579,4060379,4056579,4060379,111100146,XM_022431779.1,uncharacterized LOC111100146,3800
NC_035785.1,4174905,4183322,4174905,4178585,111100147,XM_022431780.1,uncharacterized LOC111100147,3680
NC_035785.1,4174905,4183322,4174905,4183224,111100147,XM_022431781.1,uncharacterized LOC111100147,8319
NC_035785.1,33137951,33141243,33137951,33141243,111100149,XM_022431790.1,uncharacterized LOC111100149,3292
NC_035785.1,50219737,50236819,50225350,50236819,111100152,XM_022431792.1,uncharacterized LOC111100152,11469
NC_035785.1,50219737,50236819,50219737,50236819,111100152,XM_022431791.1,uncharacterized LOC111100152,17082
NC_035780.1,15824210,15827099,15824210,15827099,111100158,XM_022431807.1,uncharacterized LOC111100158,2889
NC_035785.1,48896022,48897934,48896022,48897934,111100160,XM_022431806.1,uncharacterized LOC111100160,1912
NC_035785.1,12026214,12029041,12026214,12029041,111100164,XM_022431808.1,uncharacterized LOC111100164,2827
NC_035785.1,41644629,41659030,41644629,41659030,111100167,XM_022431814.1,uncharacterized LOC111100167,14401
NC_035785.1,48883894,48893684,48883894,48893684,111100171,XM_022431822.1,uncharacterized LOC111100171,9790
NC_035785.1,20576990,20580346,20576990,20580346,111100175,XM_022431823.1,uncharacterized LOC111100175,3356
NC_035785.1,20499251,20518555,20499252,20510262,111100176,XM_022431825.1,uncharacterized LOC111100176,11010
NC_035785.1,20499251,20518555,20499251,20510681,111100176,XM_022431826.1,uncharacterized LOC111100176,11430
NC_035785.1,20499251,20518555,20499251,20518555,111100176,XM_022431824.1,uncharacterized LOC111100176,19304
NC_035785.1,20499251,20518555,20499251,20506498,111100176,XM_022431827.1,uncharacterized LOC111100176,7247
NC_035785.1,20499251,20518555,20499251,20506701,111100176,XM_022431828.1,uncharacterized LOC111100176,7450
NC_035785.1,20499251,20518555,20499251,20509194,111100176,XM_022431829.1,uncharacterized LOC111100176,9943
NC_035785.1,20545163,20548648,20545163,20548648,111100178,XM_022431830.1,uncharacterized LOC111100178,3485
NC_035785.1,20395854,20397590,20395854,20397590,111100181,XM_022431834.1,uncharacterized LOC111100181,1736
NC_035785.1,20623131,20637169,20623131,20637169,111100182,XM_022431835.1,uncharacterized LOC111100182,14038
NC_035785.1,20608139,20612597,20608139,20612597,111100183,XM_022431836.1,uncharacterized LOC111100183,4458
NC_035785.1,20803335,20809247,20803335,20809247,111100184,XM_022431837.1,uncharacterized LOC111100184,5912
NC_035780.1,15924594,16028481,15924594,16028481,111100186,XM_022431850.1,uncharacterized LOC111100186,103887
NC_035780.1,15924594,16028481,15924594,15933280,111100186,XM_022431859.1,uncharacterized LOC111100186,8686
NC_035785.1,33393753,33399575,33393753,33399575,111100188,XM_022431839.1,uncharacterized LOC111100188,5822
NC_035785.1,49262312,49265899,49262312,49265899,111100193,XM_022431854.1,uncharacterized LOC111100193,3587
NC_035785.1,19616582,19630217,19616582,19630217,111100195,XM_022431856.1,uncharacterized LOC111100195,13635
NC_035785.1,19888764,19896122,19888764,19895860,111100196,XM_022431860.1,uncharacterized LOC111100196,7096
NC_035785.1,19888764,19896122,19888764,19896122,111100196,XM_022431858.1,uncharacterized LOC111100196,7358
NC_035785.1,19394653,19401729,19394653,19401729,111100197,XM_022431862.1,uncharacterized LOC111100197,7076
NC_035785.1,19513876,19520131,19513876,19520131,111100198,XM_022431863.1,uncharacterized LOC111100198,6255
NC_035785.1,19717810,19723658,19717810,19723658,111100199,XM_022431865.1,uncharacterized LOC111100199,5848
NC_035785.1,19537626,19540318,19537626,19540318,111100200,XM_022431866.1,uncharacterized LOC111100200,2692
NC_035785.1,19854019,19866110,19854663,19866110,111100206,XM_022431872.1,uncharacterized LOC111100206,11447
NC_035785.1,19854019,19866110,19854019,19866110,111100206,XM_022431873.1,uncharacterized LOC111100206,12091
NC_035785.1,19404844,19409311,19404968,19409311,111100207,XM_022431875.1,uncharacterized LOC111100207,4343
NC_035785.1,19404844,19409311,19404874,19409311,111100207,XM_022431874.1,uncharacterized LOC111100207,4437
NC_035785.1,19404844,19409311,19404844,19409311,111100207,XM_022431876.1,uncharacterized LOC111100207,4467
NC_035780.1,16014788,16021990,16014788,16021990,111100208,XM_022431877.1,uncharacterized LOC111100208,7202
NC_035785.1,17652123,17655857,17652123,17655857,111100218,XM_022431878.1,uncharacterized LOC111100218,3734
NC_035780.1,16084387,16097558,16084388,16097558,111100219,XM_022431883.1,uncharacterized LOC111100219,13170
NC_035780.1,16084387,16097558,16084387,16097558,111100219,XM_022431899.1,uncharacterized LOC111100219,13171
NC_035780.1,16084387,16097558,16084387,16090846,111100219,XM_022431907.1,uncharacterized LOC111100219,6459
NC_035785.1,17675463,17687098,17675463,17687098,111100222,XM_022431882.1,uncharacterized LOC111100222,11635
NC_035780.1,40064651,40084186,40064863,40084186,111100229,XM_022432097.1,uncharacterized LOC111100229,19323
NC_035780.1,40064651,40084186,40064651,40084186,111100229,XM_022432017.1,uncharacterized LOC111100229,19535
NC_035785.1,44404513,44492088,44404513,44440474,111100231,XM_022431897.1,uncharacterized LOC111100231,35961
NC_035785.1,44404513,44492088,44404513,44484427,111100231,XM_022431898.1,uncharacterized LOC111100231,79914
NC_035785.1,21017368,21022726,21017370,21021952,111100236,XM_022431906.1,uncharacterized LOC111100236,4582
NC_035785.1,21017368,21022726,21017368,21022726,111100236,XM_022431905.1,uncharacterized LOC111100236,5358
NC_035785.1,21015714,21028713,21015714,21028713,111100237,XM_022431909.1,uncharacterized LOC111100237,12999
NC_035785.1,17357174,17384084,17370165,17384011,111100239,XM_022431918.1,uncharacterized LOC111100239,13846
NC_035785.1,17357174,17384084,17357180,17383375,111100239,XM_022431922.1,uncharacterized LOC111100239,26195
NC_035785.1,17357174,17384084,17357186,17384011,111100239,XM_022431921.1,uncharacterized LOC111100239,26825
NC_035785.1,17357174,17384084,17357182,17384011,111100239,XM_022431915.1,uncharacterized LOC111100239,26829
NC_035785.1,17357174,17384084,17357174,17384011,111100239,XM_022431917.1,uncharacterized LOC111100239,26837
NC_035785.1,17357174,17384084,17357182,17384084,111100239,XM_022431914.1,uncharacterized LOC111100239,26902
NC_035785.1,17357174,17384084,17379048,17384011,111100239,XM_022431920.1,uncharacterized LOC111100239,4963
NC_035785.1,17357174,17384084,17375862,17384011,111100239,XM_022431919.1,uncharacterized LOC111100239,8149
NC_035780.1,16217205,16223478,16217205,16223477,111100240,XM_022431923.1,uncharacterized LOC111100240,6272
NC_035780.1,16217205,16223478,16217205,16223478,111100240,XM_022431936.1,uncharacterized LOC111100240,6273
NC_035785.1,17173581,17198072,17173581,17188499,111100241,XM_022431924.1,uncharacterized LOC111100241,14918
NC_035785.1,17289094,17296162,17289094,17296162,111100242,XM_022431927.1,uncharacterized LOC111100242,7068
NC_035785.1,17269257,17270601,17269257,17270601,111100245,XM_022431930.1,uncharacterized LOC111100245,1344
NC_035785.1,17117933,17139222,17117933,17139222,111100246,XM_022431932.1,uncharacterized LOC111100246,21289
NC_035785.1,17117933,17139222,17117933,17126209,111100246,XM_022431931.1,uncharacterized LOC111100246,8276
NC_035785.1,17274641,17276212,17274641,17276212,111100247,XM_022431933.1,uncharacterized LOC111100247,1571
NC_035785.1,23182208,23187208,23182208,23187208,111100252,XM_022431937.1,uncharacterized LOC111100252,5000
NC_035785.1,23253170,23256594,23253170,23256594,111100253,XM_022431938.1,uncharacterized LOC111100253,3424
NC_035785.1,23173484,23178199,23173484,23177762,111100254,XM_022431941.1,uncharacterized LOC111100254,4278
NC_035785.1,23173484,23178199,23173484,23178199,111100254,XM_022431940.1,uncharacterized LOC111100254,4715
NC_035785.1,23223315,23226081,23223315,23226081,111100255,XM_022431942.1,uncharacterized LOC111100255,2766
NC_035785.1,23273817,23276491,23273817,23276491,111100256,XM_022431943.1,uncharacterized LOC111100256,2674
NC_035785.1,23157585,23201473,23157585,23160353,111100257,XM_022431946.1,uncharacterized LOC111100257,2768
NC_035785.1,23157585,23201473,23157585,23201470,111100257,XM_022431947.1,uncharacterized LOC111100257,43885
NC_035785.1,23157585,23201473,23196217,23201418,111100257,XM_022431945.1,uncharacterized LOC111100257,5201
NC_035785.1,23157585,23201473,23196218,23201473,111100257,XM_022431944.1,uncharacterized LOC111100257,5255
NC_035780.1,15917049,15922979,15917049,15922979,111100258,XM_022431949.1,uncharacterized LOC111100258,5930
NC_035785.1,23069207,23074312,23069207,23074312,111100259,XM_022431948.1,uncharacterized LOC111100259,5105
NC_035780.1,16207207,16211823,16207207,16211823,111100267,XM_022431959.1,uncharacterized LOC111100267,4616
NC_035785.1,23105148,23139133,23105148,23139133,111100269,XM_022431958.1,uncharacterized LOC111100269,33985
NC_035780.1,16154787,16168428,16154790,16168428,111100278,XM_022432007.1,uncharacterized LOC111100278,13638
NC_035780.1,16154787,16168428,16154788,16168428,111100278,XM_022432018.1,uncharacterized LOC111100278,13640
NC_035780.1,16154787,16168428,16154787,16168428,111100278,XM_022431997.1,uncharacterized LOC111100278,13641
NC_035780.1,16154787,16168428,16154787,16163003,111100278,XM_022432024.1,uncharacterized LOC111100278,8216
NC_035780.1,16154787,16168428,16154787,16163006,111100278,XM_022432032.1,uncharacterized LOC111100278,8219
NC_035780.1,16154787,16168428,16154787,16163030,111100278,XM_022431988.1,uncharacterized LOC111100278,8243
NC_035785.1,3248069,3255622,3248069,3255622,111100282,XM_022431977.1,uncharacterized LOC111100282,7553
NC_035785.1,3215112,3225077,3215112,3225077,111100283,XM_022431978.1,uncharacterized LOC111100283,9965
NC_035785.1,3227736,3232654,3227738,3232654,111100286,XM_022431982.1,uncharacterized LOC111100286,4916
NC_035785.1,3227736,3232654,3227736,3232654,111100286,XM_022431983.1,uncharacterized LOC111100286,4918
NC_035785.1,10423445,10484274,10425995,10437105,111100289,XM_022431995.1,uncharacterized LOC111100289,11110
NC_035785.1,10423445,10484274,10423500,10437105,111100289,XM_022431993.1,uncharacterized LOC111100289,13605
NC_035785.1,10423445,10484274,10423482,10437105,111100289,XM_022431994.1,uncharacterized LOC111100289,13623
NC_035785.1,10423445,10484274,10423453,10437105,111100289,XM_022431991.1,uncharacterized LOC111100289,13652
NC_035785.1,10423445,10484274,10423445,10484274,111100289,XM_022431992.1,uncharacterized LOC111100289,60829
NC_035785.1,10250936,10259222,10250936,10259222,111100291,XM_022431998.1,uncharacterized LOC111100291,8286
NC_035785.1,10260892,10263198,10260892,10263198,111100295,XM_022432015.1,uncharacterized LOC111100295,2306
NC_035785.1,10238734,10247295,10238734,10247295,111100297,XM_022432021.1,uncharacterized LOC111100297,8561
NC_035785.1,10221018,10230284,10221018,10230284,111100298,XM_022432022.1,uncharacterized LOC111100298,9266
NC_035785.1,10265214,10272018,10265729,10270009,111100299,XM_022432023.1,uncharacterized LOC111100299,4280
NC_035785.1,13396956,13416203,13396956,13416203,111100306,XM_022432035.1,uncharacterized LOC111100306,19247
NC_035785.1,13449219,13456118,13449219,13455566,111100307,XM_022432036.1,uncharacterized LOC111100307,6347
NC_035785.1,13449219,13456118,13449219,13456078,111100307,XM_022432038.1,uncharacterized LOC111100307,6859
NC_035785.1,13449219,13456118,13449219,13456079,111100307,XM_022432037.1,uncharacterized LOC111100307,6860
NC_035785.1,13449219,13456118,13449219,13456118,111100307,XM_022432039.1,uncharacterized LOC111100307,6899
NC_035785.1,13310337,13346143,13310337,13346143,111100308,XM_022432040.1,uncharacterized LOC111100308,35806
NC_035785.1,45440413,45446887,45440416,45444797,111100319,XM_022432054.1,uncharacterized LOC111100319,4381
NC_035785.1,45440413,45446887,45440413,45446887,111100319,XM_022432053.1,uncharacterized LOC111100319,6474
NC_035785.1,45438758,45450281,45438758,45450281,111100320,XM_022432055.1,uncharacterized LOC111100320,11523
NC_035785.1,12664276,12689662,12664276,12689662,111100323,XM_022432058.1,uncharacterized LOC111100323,25386
NC_035785.1,30754532,30798285,30756272,30798285,111100329,XM_022432078.1,uncharacterized LOC111100329,42013
NC_035785.1,30754532,30798285,30756001,30798285,111100329,XM_022432077.1,uncharacterized LOC111100329,42284
NC_035785.1,30754532,30798285,30754532,30798285,111100329,XM_022432074.1,uncharacterized LOC111100329,43753
NC_035785.1,18530824,18536900,18530824,18536900,111100335,XM_022432090.1,uncharacterized LOC111100335,6076
NC_035785.1,32844666,32847494,32844666,32847494,111100341,XM_022432102.1,uncharacterized LOC111100341,2828
NC_035785.1,36788788,36792930,36788788,36792930,111100354,XM_022432121.1,uncharacterized LOC111100354,4142
NC_035785.1,37242804,37246872,37242804,37246872,111100360,XM_022432129.1,uncharacterized LOC111100360,4068
NC_035785.1,41430750,41443732,41430750,41443732,111100362,XM_022432130.1,uncharacterized LOC111100362,12982
NC_035785.1,41427283,41428821,41427283,41428821,111100368,XM_022432144.1,uncharacterized LOC111100368,1538
NC_035785.1,41468808,41479514,41468808,41479514,111100369,XM_022432145.1,uncharacterized LOC111100369,10706
NC_035785.1,44039091,44045642,44039091,44045642,111100374,XM_022432149.1,uncharacterized LOC111100374,6551
NC_035780.1,16293550,16309095,16293550,16309092,111100385,XM_022432225.1,uncharacterized LOC111100385,15542
NC_035780.1,16293550,16309095,16293550,16309095,111100385,XM_022432314.1,uncharacterized LOC111100385,15545
NC_035785.1,42910535,42917702,42910535,42915404,111100387,XM_022432183.1,uncharacterized LOC111100387,4869
NC_035785.1,14107650,14111619,14108083,14111619,111100389,XM_022432186.1,uncharacterized LOC111100389,3536
NC_035785.1,14107650,14111619,14108079,14111619,111100389,XM_022432191.1,uncharacterized LOC111100389,3540
NC_035785.1,14107650,14111619,14107662,14111619,111100389,XM_022432187.1,uncharacterized LOC111100389,3957
NC_035785.1,14107650,14111619,14107650,14111619,111100389,XM_022432189.1,uncharacterized LOC111100389,3969
NC_035785.1,14118794,14123151,14119808,14123151,111100390,XM_022432196.1,uncharacterized LOC111100390,3343
NC_035785.1,14118794,14123151,14118994,14123151,111100390,XM_022432195.1,uncharacterized LOC111100390,4157
NC_035785.1,14118794,14123151,14118794,14123151,111100390,XM_022432193.1,uncharacterized LOC111100390,4357
NC_035785.1,14113689,14118788,14113699,14118785,111100391,XM_022432197.1,uncharacterized LOC111100391,5086
NC_035785.1,14113689,14118788,14113689,14118788,111100391,XM_022432198.1,uncharacterized LOC111100391,5099
NC_035785.1,29368358,29437844,29372070,29437844,111100394,XM_022432207.1,uncharacterized LOC111100394,65774
NC_035785.1,29368358,29437844,29368530,29434434,111100394,XM_022432208.1,uncharacterized LOC111100394,65904
NC_035785.1,29368358,29437844,29368530,29437844,111100394,XM_022432205.1,uncharacterized LOC111100394,69314
NC_035785.1,29368358,29437844,29368358,29437844,111100394,XM_022432209.1,uncharacterized LOC111100394,69486
NC_035785.1,29409517,29413361,29409517,29413361,111100395,XM_022432210.1,uncharacterized LOC111100395,3844
NC_035785.1,15987030,16002362,15987030,15997865,111100400,XM_022432222.1,uncharacterized LOC111100400,10835
NC_035785.1,15987030,16002362,15987030,16002362,111100400,XM_022432221.1,uncharacterized LOC111100400,15332
NC_035785.1,15247530,15271892,15247530,15265228,111100402,XM_022432226.1,uncharacterized LOC111100402,17698
NC_035785.1,15247530,15271892,15247530,15269452,111100402,XM_022432224.1,uncharacterized LOC111100402,21922
NC_035785.1,15247530,15271892,15247530,15271892,111100402,XM_022432227.1,uncharacterized LOC111100402,24362
NC_035785.1,14396222,14899936,14469686,14899903,111100403,XM_022432228.1,uncharacterized LOC111100403,430217
NC_035785.1,14396222,14899936,14401024,14899936,111100403,XM_022432237.1,uncharacterized LOC111100403,498912
NC_035785.1,14396222,14899936,14398547,14899934,111100403,XM_022432236.1,uncharacterized LOC111100403,501387
NC_035785.1,14396222,14899936,14397908,14899905,111100403,XM_022432234.1,uncharacterized LOC111100403,501997
NC_035785.1,14396222,14899936,14396222,14899904,111100403,XM_022432235.1,uncharacterized LOC111100403,503682
NC_035785.1,14396222,14899936,14396222,14899929,111100403,XM_022432232.1,uncharacterized LOC111100403,503707
NC_035785.1,14396222,14899936,14396222,14899930,111100403,XM_022432233.1,uncharacterized LOC111100403,503708
NC_035785.1,15670905,15676975,15670905,15676740,111100404,XM_022432241.1,uncharacterized LOC111100404,5835
NC_035785.1,15670905,15676975,15670905,15676975,111100404,XM_022432240.1,uncharacterized LOC111100404,6070
NC_035785.1,15237814,15243211,15237814,15243211,111100405,XM_022432242.1,uncharacterized LOC111100405,5397
NC_035785.1,14557179,14699936,14688973,14699936,111100406,XM_022432245.1,uncharacterized LOC111100406,10963
NC_035785.1,14557179,14699936,14688778,14699936,111100406,XM_022432243.1,uncharacterized LOC111100406,11158
NC_035785.1,14557179,14699936,14688695,14699936,111100406,XM_022432244.1,uncharacterized LOC111100406,11241
NC_035785.1,14557179,14699936,14557224,14699936,111100406,XM_022432247.1,uncharacterized LOC111100406,142712
NC_035785.1,14557179,14699936,14557219,14699936,111100406,XM_022432253.1,uncharacterized LOC111100406,142717
NC_035785.1,14557179,14699936,14557179,14699936,111100406,XM_022432248.1,uncharacterized LOC111100406,142757
NC_035785.1,14557179,14699936,14688776,14696312,111100406,XM_022432256.1,uncharacterized LOC111100406,7536
NC_035785.1,14557179,14699936,14688778,14698184,111100406,XM_022432254.1,uncharacterized LOC111100406,9406
NC_035785.1,15267437,15327008,15296425,15327008,111100407,XM_022432258.1,uncharacterized LOC111100407,30583
NC_035785.1,15267437,15327008,15288329,15327008,111100407,XM_022432259.1,uncharacterized LOC111100407,38679
NC_035785.1,15267437,15327008,15288213,15327008,111100407,XM_022432263.1,uncharacterized LOC111100407,38795
NC_035785.1,15267437,15327008,15288190,15327008,111100407,XM_022432257.1,uncharacterized LOC111100407,38818
NC_035785.1,15267437,15327008,15268419,15327008,111100407,XM_022432261.1,uncharacterized LOC111100407,58589
NC_035785.1,15267437,15327008,15267437,15327008,111100407,XM_022432262.1,uncharacterized LOC111100407,59571
NC_035785.1,15337474,15356340,15337474,15356340,111100409,XM_022432271.1,uncharacterized LOC111100409,18866
NC_035785.1,16003428,16010151,16003678,16010151,111100411,XM_022432276.1,uncharacterized LOC111100411,6473
NC_035785.1,16003428,16010151,16003428,16010151,111100411,XM_022432275.1,uncharacterized LOC111100411,6723
NC_035785.1,15895986,15923212,15895986,15922922,111100412,XM_022432279.1,uncharacterized LOC111100412,26936
NC_035785.1,15895986,15923212,15895986,15923212,111100412,XM_022432278.1,uncharacterized LOC111100412,27226
NC_035785.1,14833943,15198098,14833943,15198098,111100413,XM_022432281.1,uncharacterized LOC111100413,364155
NC_035785.1,15764193,15773183,15765230,15773183,111100414,XM_022432283.1,uncharacterized LOC111100414,7953
NC_035785.1,15764193,15773183,15764193,15773183,111100414,XM_022432282.1,uncharacterized LOC111100414,8990
NC_035785.1,15941501,15962198,15941501,15962198,111100415,XM_022432284.1,uncharacterized LOC111100415,20697
NC_035785.1,15729659,15749937,15729714,15749936,111100418,XM_022432293.1,uncharacterized LOC111100418,20222
NC_035785.1,15729659,15749937,15729662,15749937,111100418,XM_022432290.1,uncharacterized LOC111100418,20275
NC_035785.1,15729659,15749937,15729659,15749937,111100418,XM_022432292.1,uncharacterized LOC111100418,20278
NC_035785.1,15390008,15565011,15390008,15565011,111100419,XM_022432294.1,uncharacterized LOC111100419,175003
NC_035785.1,15390008,15565011,15542954,15565011,111100419,XM_022432298.1,uncharacterized LOC111100419,22057
NC_035785.1,14704926,14762282,14704926,14761828,111100420,XM_022432299.1,uncharacterized LOC111100420,56902
NC_035785.1,15835859,15844062,15840903,15844062,111100425,XM_022432308.1,uncharacterized LOC111100425,3159
NC_035785.1,15835859,15844062,15836121,15844062,111100425,XM_022432309.1,uncharacterized LOC111100425,7941
NC_035785.1,16088153,16090149,16088153,16090149,111100429,XM_022432320.1,uncharacterized LOC111100429,1996
NC_035785.1,15020583,15022112,15020583,15022112,111100431,XM_022432322.1,uncharacterized LOC111100431,1529
NC_035785.1,14817503,14819567,14817503,14819567,111100433,XM_022432325.1,uncharacterized LOC111100433,2064
NC_035785.1,15206852,15211528,15206852,15211528,111100434,XM_022432326.1,uncharacterized LOC111100434,4676
NC_035785.1,14662939,14681745,14669152,14681745,111100436,XM_022432330.1,uncharacterized LOC111100436,12593
NC_035785.1,14662939,14681745,14666514,14681744,111100436,XM_022432329.1,uncharacterized LOC111100436,15230
NC_035785.1,14662939,14681745,14665378,14681744,111100436,XM_022432327.1,uncharacterized LOC111100436,16366
NC_035785.1,14662939,14681745,14662939,14681744,111100436,XM_022432328.1,uncharacterized LOC111100436,18805
NC_035785.1,14662939,14681745,14679658,14681744,111100436,XM_022432331.1,uncharacterized LOC111100436,2086
NC_035785.1,14662939,14681745,14675607,14681744,111100436,XM_022432332.1,uncharacterized LOC111100436,6137
NC_035785.1,15644243,15648995,15644243,15648995,111100437,XM_022432333.1,uncharacterized LOC111100437,4752
NC_035785.1,15274697,15281277,15274697,15281277,111100438,XM_022432334.1,uncharacterized LOC111100438,6580
NC_035780.1,64256626,64268639,64256626,64268639,111100439,XM_022432339.1,uncharacterized LOC111100439,12013
NC_035785.1,14568598,14598217,14587681,14598217,111100441,XM_022432343.1,uncharacterized LOC111100441,10536
NC_035785.1,14568598,14598217,14586734,14598217,111100441,XM_022432342.1,uncharacterized LOC111100441,11483
NC_035785.1,14568598,14598217,14568598,14598217,111100441,XM_022432338.1,uncharacterized LOC111100441,29619
NC_035785.1,15720208,15726931,15720208,15726931,111100442,XM_022432347.1,uncharacterized LOC111100442,6723
NC_035785.1,15420489,15422671,15420489,15422671,111100446,XM_022432351.1,uncharacterized LOC111100446,2182
NC_035785.1,15044016,15046108,15044016,15046108,111100447,XM_022432352.1,uncharacterized LOC111100447,2092
NC_035785.1,15062477,15065334,15062477,15065334,111100448,XM_022432354.1,uncharacterized LOC111100448,2857
NC_035785.1,15437167,15440011,15437167,15440011,111100449,XM_022432355.1,uncharacterized LOC111100449,2844
NC_035785.1,14411275,14414711,14411275,14414711,111100450,XM_022432356.1,uncharacterized LOC111100450,3436
NC_035785.1,14600005,14602778,14600005,14602778,111100454,XM_022432361.1,uncharacterized LOC111100454,2773
NC_035785.1,33747003,33780466,33767353,33780466,111100476,XM_022432403.1,uncharacterized LOC111100476,13113
NC_035785.1,33747003,33780466,33747006,33763198,111100476,XM_022432404.1,uncharacterized LOC111100476,16192
NC_035785.1,33747003,33780466,33747003,33780466,111100476,XM_022432405.1,uncharacterized LOC111100476,33463
NC_035785.1,29682430,29687078,29682618,29687078,111100483,XM_022432423.1,uncharacterized LOC111100483,4460
NC_035785.1,29682430,29687078,29682430,29687078,111100483,XM_022432422.1,uncharacterized LOC111100483,4648
NC_035785.1,16873078,16880964,16874391,16880964,111100485,XM_022432427.1,uncharacterized LOC111100485,6573
NC_035785.1,16873078,16880964,16874022,16880964,111100485,XM_022432428.1,uncharacterized LOC111100485,6942
NC_035785.1,16873078,16880964,16873078,16880964,111100485,XM_022432424.1,uncharacterized LOC111100485,7886
NC_035785.1,16942230,17003991,16998734,17003991,111100486,XM_022432429.1,uncharacterized LOC111100486,5257
NC_035785.1,16942230,17003991,16942249,17003991,111100486,XM_022432430.1,uncharacterized LOC111100486,61742
NC_035785.1,16942230,17003991,16942234,16950842,111100486,XM_022432434.1,uncharacterized LOC111100486,8608
NC_035785.1,16942230,17003991,16942230,16950843,111100486,XM_022432432.1,uncharacterized LOC111100486,8613
NC_035785.1,17046923,17063295,17052617,17063295,111100487,XM_022432436.1,uncharacterized LOC111100487,10678
NC_035785.1,17046923,17063295,17046923,17063295,111100487,XM_022432435.1,uncharacterized LOC111100487,16372
NC_035780.1,44459397,44461747,44459397,44461747,111100488,XM_022432440.1,uncharacterized LOC111100488,2350
NC_035785.1,16886602,16889520,16886602,16889520,111100489,XM_022432437.1,uncharacterized LOC111100489,2918
NC_035785.1,16889519,16892291,16889519,16892107,111100491,XM_022432441.1,uncharacterized LOC111100491,2588
NC_035785.1,16889519,16892291,16889519,16892291,111100491,XM_022432439.1,uncharacterized LOC111100491,2772
NC_035785.1,17035553,17043146,17035553,17043146,111100492,XM_022432442.1,uncharacterized LOC111100492,7593
NC_035785.1,17021261,17023181,17021261,17023181,111100493,XM_022432443.1,uncharacterized LOC111100493,1920
NC_035785.1,35393715,35398446,35393715,35398446,111100501,XM_022432450.1,uncharacterized LOC111100501,4731
NC_035785.1,9940364,9946666,9940364,9946666,111100506,XM_022432456.1,uncharacterized LOC111100506,6302
NC_035785.1,9953840,9961258,9954175,9961258,111100508,XM_022432461.1,uncharacterized LOC111100508,7083
NC_035785.1,9953840,9961258,9954142,9961258,111100508,XM_022432458.1,uncharacterized LOC111100508,7116
NC_035785.1,9953840,9961258,9953840,9961258,111100508,XM_022432460.1,uncharacterized LOC111100508,7418
NC_035785.1,10028945,10033203,10028945,10033203,111100510,XM_022432465.1,uncharacterized LOC111100510,4258
NC_035785.1,9975028,9979144,9975028,9979144,111100512,XM_022432466.1,uncharacterized LOC111100512,4116
NC_035785.1,9983591,9995371,9983597,9995371,111100513,XM_022432469.1,uncharacterized LOC111100513,11774
NC_035785.1,9983591,9995371,9983591,9987678,111100513,XM_022432467.1,uncharacterized LOC111100513,4087
NC_035785.1,9983591,9995371,9991276,9995367,111100513,XM_022432468.1,uncharacterized LOC111100513,4091
NC_035785.1,9996946,9999079,9996946,9999057,111100514,XM_022432472.1,uncharacterized LOC111100514,2111
NC_035785.1,9996946,9999079,9996948,9999079,111100514,XM_022432471.1,uncharacterized LOC111100514,2131
NC_035785.1,9965858,9967788,9965858,9967788,111100515,XM_022432473.1,uncharacterized LOC111100515,1930
NC_035780.1,58519848,58522560,58519848,58522560,111100520,XM_022432481.1,uncharacterized LOC111100520,2712
NC_035785.1,4607381,4610106,4607381,4610106,111100525,XM_022432497.1,uncharacterized LOC111100525,2725
NC_035785.1,4474089,4476973,4474089,4476973,111100526,XM_022432498.1,uncharacterized LOC111100526,2884
NC_035785.1,4580127,4583032,4580127,4583032,111100527,XM_022432499.1,uncharacterized LOC111100527,2905
NC_035785.1,4520815,4531774,4520815,4531292,111100529,XM_022432503.1,uncharacterized LOC111100529,10477
NC_035785.1,4520815,4531774,4520815,4531520,111100529,XM_022432501.1,uncharacterized LOC111100529,10705
NC_035785.1,4520815,4531774,4520815,4531774,111100529,XM_022432500.1,uncharacterized LOC111100529,10959
NC_035785.1,4520815,4531774,4520815,4523746,111100529,XM_022432502.1,uncharacterized LOC111100529,2931
NC_035785.1,4542794,4545375,4542794,4545375,111100530,XM_022432504.1,uncharacterized LOC111100530,2581
NC_035785.1,4495626,4499322,4495626,4499322,111100532,XM_022432506.1,uncharacterized LOC111100532,3696
NC_035785.1,4595641,4598166,4595641,4598166,111100533,XM_022432507.1,uncharacterized LOC111100533,2525
NC_035785.1,4592842,4595358,4592842,4595358,111100535,XM_022432508.1,uncharacterized LOC111100535,2516
NC_035780.1,58392180,58392839,58392180,58392839,111100538,XM_022432554.1,uncharacterized LOC111100538,659
NC_035785.1,35321087,35334061,35321087,35334061,111100541,XM_022432515.1,uncharacterized LOC111100541,12974
NC_035785.1,10539971,10574718,10539971,10570716,111100543,XM_022432519.1,uncharacterized LOC111100543,30745
NC_035785.1,10539971,10574718,10540492,10574718,111100543,XM_022432518.1,uncharacterized LOC111100543,34226
NC_035785.1,10539971,10574718,10539971,10574718,111100543,XM_022432517.1,uncharacterized LOC111100543,34747
NC_035785.1,18114615,18136657,18124378,18136335,111100548,XM_022432527.1,uncharacterized LOC111100548,11957
NC_035785.1,18114615,18136657,18124378,18136510,111100548,XM_022432529.1,uncharacterized LOC111100548,12132
NC_035785.1,18114615,18136657,18124378,18136608,111100548,XM_022432528.1,uncharacterized LOC111100548,12230
NC_035785.1,18114615,18136657,18124378,18136657,111100548,XM_022432538.1,uncharacterized LOC111100548,12279
NC_035785.1,18114615,18136657,18118684,18136657,111100548,XM_022432535.1,uncharacterized LOC111100548,17973
NC_035785.1,18114615,18136657,18114618,18136657,111100548,XM_022432536.1,uncharacterized LOC111100548,22039
NC_035785.1,18114615,18136657,18114615,18136657,111100548,XM_022432537.1,uncharacterized LOC111100548,22042
NC_035785.1,18114615,18136657,18131403,18136657,111100548,XM_022432534.1,uncharacterized LOC111100548,5254
NC_035785.1,18160215,18161706,18160215,18161687,111100551,XM_022432545.1,uncharacterized LOC111100551,1472
NC_035785.1,18160215,18161706,18160215,18161706,111100551,XM_022432544.1,uncharacterized LOC111100551,1491
NC_035785.1,18065767,18071302,18065767,18071302,111100552,XM_022432547.1,uncharacterized LOC111100552,5535
NC_035780.1,46078762,46080412,46078762,46080412,111100558,XM_022432941.1,uncharacterized LOC111100558,1650
NC_035780.1,47086322,47092299,47086322,47092299,111100559,XM_022432559.1,uncharacterized LOC111100559,5977
NC_035785.1,39345182,39349155,39345182,39349155,111100565,XM_022432567.1,uncharacterized LOC111100565,3973
NC_035785.1,39279253,39291333,39279253,39291333,111100567,XM_022432568.1,uncharacterized LOC111100567,12080
NC_035785.1,19024127,19038292,19024127,19038292,111100569,XM_022432579.1,uncharacterized LOC111100569,14165
NC_035785.1,23945211,24001450,23945211,24001450,111100574,XM_022432594.1,uncharacterized LOC111100574,56239
NC_035785.1,927896,950830,935500,950830,111100577,XM_022432609.1,uncharacterized LOC111100577,15330
NC_035785.1,927896,950830,935495,950830,111100577,XM_022432608.1,uncharacterized LOC111100577,15335
NC_035785.1,927896,950830,931423,950830,111100577,XM_022432610.1,uncharacterized LOC111100577,19407
NC_035785.1,927896,950830,930646,950830,111100577,XM_022432611.1,uncharacterized LOC111100577,20184
NC_035785.1,927896,950830,927897,950830,111100577,XM_022432600.1,uncharacterized LOC111100577,22933
NC_035785.1,927896,950830,927896,950830,111100577,XM_022432597.1,uncharacterized LOC111100577,22934
NC_035780.1,7599219,7611397,7599219,7611397,111100578,XM_022432605.1,uncharacterized LOC111100578,12178
NC_035785.1,31517727,31543210,31518006,31543210,111100584,XM_022432628.1,uncharacterized LOC111100584,25204
NC_035785.1,31517727,31543210,31517727,31543210,111100584,XM_022432627.1,uncharacterized LOC111100584,25483
NC_035780.1,30754627,30763434,30754627,30763434,111100585,XM_022432634.1,uncharacterized LOC111100585,8807
NC_035785.1,31447223,31473544,31463533,31473544,111100586,XM_022432631.1,uncharacterized LOC111100586,10011
NC_035785.1,31447223,31473544,31462506,31473544,111100586,XM_022432636.1,uncharacterized LOC111100586,11038
NC_035785.1,31447223,31473544,31461528,31473544,111100586,XM_022432633.1,uncharacterized LOC111100586,12016
NC_035785.1,31447223,31473544,31453828,31473544,111100586,XM_022432630.1,uncharacterized LOC111100586,19716
NC_035785.1,31447223,31473544,31447300,31473544,111100586,XM_022432637.1,uncharacterized LOC111100586,26244
NC_035785.1,31447223,31473544,31447223,31473544,111100586,XM_022432635.1,uncharacterized LOC111100586,26321
NC_035780.1,24967486,24970295,24967486,24970295,111100593,XM_022432686.1,uncharacterized LOC111100593,2809
NC_035780.1,6151251,6154867,6151251,6154867,111100597,XM_022432655.1,uncharacterized LOC111100597,3616
NC_035780.1,6183506,6187835,6183506,6187835,111100606,XM_022432666.1,uncharacterized LOC111100606,4329
NC_035785.1,31401589,31402851,31401589,31402851,111100607,XM_022432663.1,uncharacterized LOC111100607,1262
NC_035785.1,31353922,31356992,31353922,31356992,111100614,XM_022432674.1,uncharacterized LOC111100614,3070
NC_035780.1,6195282,6199711,6195282,6199711,111100615,XM_022432678.1,uncharacterized LOC111100615,4429
NC_035785.1,31404071,31408611,31404071,31408349,111100619,XM_022432680.1,uncharacterized LOC111100619,4278
NC_035785.1,31404071,31408611,31404071,31408611,111100619,XM_022432679.1,uncharacterized LOC111100619,4540
NC_035785.1,31595711,31604383,31595720,31604383,111100620,XM_022432682.1,uncharacterized LOC111100620,8663
NC_035785.1,31595711,31604383,31595711,31604383,111100620,XM_022432681.1,uncharacterized LOC111100620,8672
NC_035785.1,31284450,31296437,31284450,31296428,111100621,XM_022432684.1,uncharacterized LOC111100621,11978
NC_035785.1,31284450,31296437,31284450,31296437,111100621,XM_022432683.1,uncharacterized LOC111100621,11987
NC_035785.1,11185547,11264622,11185578,11225361,111100623,XM_022432687.1,uncharacterized LOC111100623,39783
NC_035785.1,11185547,11264622,11185547,11225361,111100623,XM_022432688.1,uncharacterized LOC111100623,39814
NC_035785.1,11185547,11264622,11185578,11228578,111100623,XM_022432691.1,uncharacterized LOC111100623,43000
NC_035785.1,11185547,11264622,11185578,11232008,111100623,XM_022432696.1,uncharacterized LOC111100623,46430
NC_035785.1,11185547,11264622,11185578,11232017,111100623,XM_022432699.1,uncharacterized LOC111100623,46439
NC_035785.1,11185547,11264622,11185578,11232031,111100623,XM_022432698.1,uncharacterized LOC111100623,46453
NC_035785.1,11185547,11264622,11185578,11264622,111100623,XM_022432689.1,uncharacterized LOC111100623,79044
NC_035785.1,32993700,33014178,32993705,33014175,111100628,XM_022432703.1,uncharacterized LOC111100628,20470
NC_035785.1,32993700,33014178,32993702,33014177,111100628,XM_022432702.1,uncharacterized LOC111100628,20475
NC_035785.1,32993700,33014178,32993700,33014178,111100628,XM_022432701.1,uncharacterized LOC111100628,20478
NC_035785.1,48196909,48257086,48196909,48255761,111100631,XM_022432707.1,uncharacterized LOC111100631,58852
NC_035785.1,48196909,48257086,48196912,48257086,111100631,XM_022432706.1,uncharacterized LOC111100631,60174
NC_035785.1,38166281,38191156,38166281,38191134,111100634,XM_022432716.1,uncharacterized LOC111100634,24853
NC_035785.1,38166281,38191156,38166281,38191156,111100634,XM_022432718.1,uncharacterized LOC111100634,24875
NC_035785.1,36520156,36528747,36520156,36528747,111100639,XM_022432721.1,uncharacterized LOC111100639,8591
NC_035785.1,10723541,10727023,10723541,10725859,111100642,XM_022432726.1,uncharacterized LOC111100642,2318
NC_035785.1,10723541,10727023,10723541,10727022,111100642,XM_022432727.1,uncharacterized LOC111100642,3481
NC_035785.1,10723541,10727023,10723541,10727023,111100642,XM_022432728.1,uncharacterized LOC111100642,3482
NC_035785.1,37443834,37456689,37443834,37455015,111100644,XM_022432730.1,uncharacterized LOC111100644,11181
NC_035785.1,37443834,37456689,37443842,37456689,111100644,XM_022432729.1,uncharacterized LOC111100644,12847
NC_035785.1,3029532,3035898,3029532,3035898,111100647,XM_022432734.1,uncharacterized LOC111100647,6366
NC_035785.1,47810902,47818578,47810902,47818578,111100651,XM_022432738.1,uncharacterized LOC111100651,7676
NC_035785.1,47824292,47834322,47824292,47834322,111100653,XM_022432739.1,uncharacterized LOC111100653,10030
NC_035785.1,530031,534240,530031,534240,111100654,XM_022432740.1,uncharacterized LOC111100654,4209
NC_035785.1,705718,708942,705718,708942,111100656,XM_022432743.1,uncharacterized LOC111100656,3224
NC_035785.1,1557510,1568310,1557510,1568310,111100657,XM_022432744.1,uncharacterized LOC111100657,10800
NC_035785.1,1868088,1869842,1868088,1869842,111100659,XM_022432746.1,uncharacterized LOC111100659,1754
NC_035785.1,1869876,1871285,1869876,1871285,111100660,XM_022432747.1,uncharacterized LOC111100660,1409
NC_035785.1,1871355,1874347,1871355,1874347,111100661,XM_022432748.1,uncharacterized LOC111100661,2992
NC_035780.1,2863719,2875976,2863719,2875976,111100662,XM_022432752.1,uncharacterized LOC111100662,12257
NC_035785.1,1875436,1877903,1875436,1877903,111100663,XM_022432749.1,uncharacterized LOC111100663,2467
NC_035785.1,2019460,2022285,2019460,2022285,111100665,XM_022432751.1,uncharacterized LOC111100665,2825
NC_035785.1,2029707,2037737,2029707,2037737,111100667,XM_022432754.1,uncharacterized LOC111100667,8030
NC_035785.1,47877499,47896856,47877499,47896856,111100670,XM_022432757.1,uncharacterized LOC111100670,19357
NC_035785.1,47792451,47845731,47842382,47845731,111100671,XM_022432758.1,uncharacterized LOC111100671,3349
NC_035785.1,47792451,47845731,47792451,47845716,111100671,XM_022432759.1,uncharacterized LOC111100671,53265
NC_035785.1,47742458,47745217,47742458,47745217,111100673,XM_022432760.1,uncharacterized LOC111100673,2759
NC_035785.1,47801463,47804138,47801463,47804138,111100674,XM_022432761.1,uncharacterized LOC111100674,2675
NC_035785.1,2399131,2399961,2399131,2399961,111100687,XM_022432771.1,uncharacterized LOC111100687,830
NC_035785.1,2634371,2635738,2634371,2635738,111100689,XM_022432774.1,uncharacterized LOC111100689,1367
NC_035785.1,2669246,2670577,2669246,2670577,111100690,XM_022432775.1,uncharacterized LOC111100690,1331
NC_035785.1,4254290,4260750,4254290,4260750,111100694,XM_022432780.1,uncharacterized LOC111100694,6460
NC_035785.1,4261338,4262927,4261338,4262927,111100695,XM_022432781.1,uncharacterized LOC111100695,1589
NC_035785.1,3061615,3068653,3061615,3068653,111100697,XM_022432782.1,uncharacterized LOC111100697,7038
NC_035785.1,3232958,3243595,3232958,3243595,111100700,XM_022432783.1,uncharacterized LOC111100700,10637
NC_035785.1,3321321,3322496,3321321,3322496,111100701,XM_022432784.1,uncharacterized LOC111100701,1175
NC_035785.1,32665920,32671895,32665920,32671895,111100705,XM_022432789.1,uncharacterized LOC111100705,5975
NC_035785.1,3667059,3670777,3667059,3670777,111100709,XM_022432793.1,uncharacterized LOC111100709,3718
NC_035785.1,4346857,4349123,4346857,4349123,111100716,XM_022432799.1,uncharacterized LOC111100716,2266
NC_035785.1,4360457,4362312,4360457,4362312,111100717,XM_022432800.1,uncharacterized LOC111100717,1855
NC_035785.1,4380831,4384220,4380831,4384220,111100719,XM_022432801.1,uncharacterized LOC111100719,3389
NC_035785.1,38931532,38936228,38931532,38936228,111100726,XM_022432809.1,uncharacterized LOC111100726,4696
NC_035785.1,38945321,38947846,38945321,38947846,111100727,XM_022432810.1,uncharacterized LOC111100727,2525
NC_035785.1,38908693,38911096,38908693,38911096,111100728,XM_022432811.1,uncharacterized LOC111100728,2403
NC_035785.1,38896630,38899851,38896630,38899851,111100730,XM_022432812.1,uncharacterized LOC111100730,3221
NC_035785.1,38921653,38924204,38921653,38924204,111100731,XM_022432813.1,uncharacterized LOC111100731,2551
NC_035785.1,38955796,38958890,38955796,38958890,111100732,XM_022432814.1,uncharacterized LOC111100732,3094
NC_035780.1,25669506,25674040,25669506,25674040,111100735,XM_022432830.1,uncharacterized LOC111100735,4534
NC_035785.1,38940862,38942397,38940862,38942397,111100736,XM_022432828.1,uncharacterized LOC111100736,1535
NC_035785.1,38961365,38984908,38961365,38984908,111100737,XM_022432829.1,uncharacterized LOC111100737,23543
NC_035785.1,8290632,8294889,8290632,8294889,111100740,XM_022432832.1,uncharacterized LOC111100740,4257
NC_035785.1,4870143,4874456,4870143,4874456,111100741,XM_022432833.1,uncharacterized LOC111100741,4313
NC_035785.1,5140596,5142083,5140596,5142083,111100742,XM_022432834.1,uncharacterized LOC111100742,1487
NC_035785.1,5444607,5448947,5444607,5448947,111100744,XM_022432836.1,uncharacterized LOC111100744,4340
NC_035785.1,5653317,5654906,5653317,5654906,111100746,XM_022432837.1,uncharacterized LOC111100746,1589
NC_035785.1,5660984,5667855,5660984,5667855,111100747,XM_022432838.1,uncharacterized LOC111100747,6871
NC_035785.1,5703938,5704933,5703938,5704933,111100748,XM_022432839.1,uncharacterized LOC111100748,995
NC_035785.1,6055858,6082039,6055858,6082039,111100750,XM_022432842.1,uncharacterized LOC111100750,26181
NC_035785.1,6089801,6095225,6089801,6095225,111100751,XM_022432843.1,uncharacterized LOC111100751,5424
NC_035785.1,6852042,6853708,6852042,6853708,111100758,XM_022432851.1,uncharacterized LOC111100758,1666
NC_035785.1,6933292,6934311,6933292,6934311,111100761,XM_022432853.1,uncharacterized LOC111100761,1019
NC_035785.1,6998542,6999105,6998542,6999105,111100762,XM_022432854.1,uncharacterized LOC111100762,563
NC_035785.1,7061242,7062679,7061242,7062679,111100766,XM_022432862.1,uncharacterized LOC111100766,1437
NC_035785.1,7182678,7185583,7182678,7185583,111100770,XM_022432863.1,uncharacterized LOC111100770,2905
NC_035785.1,7933527,7944371,7933527,7944371,111100774,XM_022432866.1,uncharacterized LOC111100774,10844
NC_035785.1,8311344,8312534,8311344,8312534,111100775,XM_022432867.1,uncharacterized LOC111100775,1190
NC_035785.1,1172296,1234692,1172296,1234692,111100778,XM_022432869.1,uncharacterized LOC111100778,62396
NC_035785.1,1193313,1204811,1193313,1204811,111100780,XM_022432870.1,uncharacterized LOC111100780,11498
NC_035785.1,1168306,1172200,1168306,1172200,111100781,XM_022432871.1,uncharacterized LOC111100781,3894
NC_035785.1,1218946,1222102,1218946,1222102,111100782,XM_022432872.1,uncharacterized LOC111100782,3156
NC_035785.1,8640022,8729972,8640022,8729972,111100784,XM_022432874.1,uncharacterized LOC111100784,89950
NC_035785.1,8771537,8773412,8771537,8773412,111100785,XM_022432875.1,uncharacterized LOC111100785,1875
NC_035780.1,2605983,2613799,2605983,2613799,111100789,XM_022432885.1,uncharacterized LOC111100789,7816
NC_035785.1,34974015,34984282,34974044,34984162,111100790,XM_022432888.1,uncharacterized LOC111100790,10118
NC_035785.1,34974015,34984282,34974015,34984162,111100790,XM_022432887.1,uncharacterized LOC111100790,10147
NC_035785.1,34974015,34984282,34974044,34984282,111100790,XM_022432886.1,uncharacterized LOC111100790,10238
NC_035785.1,34870271,34891472,34870437,34891472,111100791,XM_022432890.1,uncharacterized LOC111100791,21035
NC_035785.1,34870271,34891472,34870271,34891472,111100791,XM_022432892.1,uncharacterized LOC111100791,21201
NC_035785.1,34906961,34915001,34906961,34915001,111100799,XM_022432913.1,uncharacterized LOC111100799,8040
NC_035785.1,35172598,35176025,35172598,35176025,111100803,XM_022432921.1,uncharacterized LOC111100803,3427
NC_035785.1,35266139,35271606,35266139,35271606,111100805,XM_022432922.1,uncharacterized LOC111100805,5467
NC_035785.1,34899610,34902421,34899610,34902421,111100806,XM_022432923.1,uncharacterized LOC111100806,2811
NC_035785.1,34895137,34896602,34895137,34896602,111100807,XM_022432924.1,uncharacterized LOC111100807,1465
NC_035785.1,3734871,3766247,3734871,3745393,111100815,XM_022432935.1,uncharacterized LOC111100815,10522
NC_035785.1,3734871,3766247,3734871,3759441,111100815,XM_022432931.1,uncharacterized LOC111100815,24570
NC_035785.1,3734871,3766247,3734871,3762165,111100815,XM_022432934.1,uncharacterized LOC111100815,27294
NC_035785.1,3734871,3766247,3734871,3766247,111100815,XM_022432932.1,uncharacterized LOC111100815,31376
NC_035785.1,3734871,3766247,3734871,3738429,111100815,XM_022432933.1,uncharacterized LOC111100815,3558
NC_035785.1,3813442,3821796,3813442,3821796,111100817,XM_022432939.1,uncharacterized LOC111100817,8354
NC_035785.1,3903539,3906667,3903539,3906667,111100818,XM_022432940.1,uncharacterized LOC111100818,3128
NC_035785.1,3790522,3794739,3791626,3794739,111100819,XM_022432942.1,uncharacterized LOC111100819,3113
NC_035785.1,3790522,3794739,3790522,3794739,111100819,XM_022432943.1,uncharacterized LOC111100819,4217
NC_035785.1,3706010,3710000,3706010,3709021,111100820,XM_022432944.1,uncharacterized LOC111100820,3011
NC_035785.1,3706010,3710000,3706010,3709067,111100820,XM_022432946.1,uncharacterized LOC111100820,3057
NC_035785.1,3706010,3710000,3706010,3710000,111100820,XM_022432945.1,uncharacterized LOC111100820,3990
NC_035785.1,3875226,3877648,3875226,3877620,111100821,XM_022432949.1,uncharacterized LOC111100821,2394
NC_035785.1,3875226,3877648,3875226,3877648,111100821,XM_022432948.1,uncharacterized LOC111100821,2422
NC_035785.1,44263038,44316377,44263038,44316377,111100837,XM_022432952.1,uncharacterized LOC111100837,53339
NC_035785.1,44257992,44262999,44259339,44262999,111100838,XM_022432953.1,uncharacterized LOC111100838,3660
NC_035785.1,29064232,29067655,29064232,29067655,111100842,XM_022432954.1,uncharacterized LOC111100842,3423
NC_035785.1,29057524,29089452,29067564,29089432,111100843,XM_022432956.1,uncharacterized LOC111100843,21868
NC_035785.1,29057524,29089452,29057524,29089452,111100843,XM_022432955.1,uncharacterized LOC111100843,31928
NC_035780.1,55261000,55268669,55261000,55268669,111100845,XM_022432960.1,uncharacterized LOC111100845,7669
NC_035785.1,30098442,30110956,30098442,30110956,111100853,XM_022432968.1,uncharacterized LOC111100853,12514
NC_035785.1,30168067,30172490,30168067,30172490,111100855,XM_022432969.1,uncharacterized LOC111100855,4423
NC_035785.1,30176469,30178412,30176469,30178412,111100856,XM_022432970.1,uncharacterized LOC111100856,1943
NC_035785.1,13103148,13165790,13120354,13149127,111100858,XM_022432978.1,uncharacterized LOC111100858,28773
NC_035785.1,13103148,13165790,13131304,13165790,111100858,XM_022432979.1,uncharacterized LOC111100858,34486
NC_035785.1,13103148,13165790,13127908,13165790,111100858,XM_022432975.1,uncharacterized LOC111100858,37882
NC_035785.1,13103148,13165790,13120354,13165790,111100858,XM_022432973.1,uncharacterized LOC111100858,45436
NC_035785.1,13103148,13165790,13103181,13165790,111100858,XM_022432976.1,uncharacterized LOC111100858,62609
NC_035785.1,13103148,13165790,13103148,13165790,111100858,XM_022432974.1,uncharacterized LOC111100858,62642
NC_035785.1,22821161,22825050,22821161,22825050,111100862,XM_022432985.1,uncharacterized LOC111100862,3889
NC_035785.1,22827617,22829774,22827617,22829774,111100863,XM_022432986.1,uncharacterized LOC111100863,2157
NC_035785.1,3596701,3617589,3596701,3617589,111100868,XM_022432994.1,uncharacterized LOC111100868,20888
NC_035785.1,37832147,37866741,37832147,37866741,111100871,XM_022433001.1,uncharacterized LOC111100871,34594
NC_035785.1,18726476,18787556,18769008,18787556,111100872,XM_022433008.1,uncharacterized LOC111100872,18548
NC_035785.1,18726476,18787556,18769007,18787556,111100872,XM_022433007.1,uncharacterized LOC111100872,18549
NC_035785.1,18726476,18787556,18735539,18787556,111100872,XM_022433005.1,uncharacterized LOC111100872,52017
NC_035785.1,18726476,18787556,18735457,18787556,111100872,XM_022433006.1,uncharacterized LOC111100872,52099
NC_035785.1,18726476,18787556,18726476,18787556,111100872,XM_022433004.1,uncharacterized LOC111100872,61080
NC_035785.1,41837564,41859557,41840956,41859557,111100878,XM_022433020.1,uncharacterized LOC111100878,18601
NC_035785.1,41837564,41859557,41837564,41859556,111100878,XM_022433021.1,uncharacterized LOC111100878,21992
NC_035785.1,41837564,41859557,41837564,41859557,111100878,XM_022433019.1,uncharacterized LOC111100878,21993
NC_035785.1,35342641,35349211,35344601,35349211,111100879,XM_022433022.1,uncharacterized LOC111100879,4610
NC_035785.1,35342641,35349211,35342641,35349211,111100879,XM_022433023.1,uncharacterized LOC111100879,6570
NC_035785.1,21619049,21622216,21619049,21622216,111100882,XM_022433027.1,uncharacterized LOC111100882,3167
NC_035785.1,21666730,21669401,21666730,21669401,111100883,XM_022433028.1,uncharacterized LOC111100883,2671
NC_035785.1,21591879,21594557,21591879,21594472,111100884,XM_022433030.1,uncharacterized LOC111100884,2593
NC_035785.1,21591879,21594557,21591880,21594557,111100884,XM_022433029.1,uncharacterized LOC111100884,2677
NC_035785.1,21686325,21689048,21686325,21689048,111100885,XM_022433031.1,uncharacterized LOC111100885,2723
NC_035785.1,21638884,21642623,21638884,21642623,111100886,XM_022433032.1,uncharacterized LOC111100886,3739
NC_035785.1,33043312,33049402,33043312,33049401,111100898,XM_022433065.1,uncharacterized LOC111100898,6089
NC_035785.1,33043312,33049402,33043312,33049402,111100898,XM_022433067.1,uncharacterized LOC111100898,6090
NC_035785.1,38384895,38435547,38411727,38435546,111100899,XM_022433070.1,uncharacterized LOC111100899,23819
NC_035785.1,38384895,38435547,38384895,38435547,111100899,XM_022433069.1,uncharacterized LOC111100899,50652
NC_035785.1,33091066,33095312,33091066,33095312,111100901,XM_022433071.1,uncharacterized LOC111100901,4246
NC_035785.1,32100271,32104180,32100271,32104180,111100905,XM_022433078.1,uncharacterized LOC111100905,3909
NC_035785.1,12373149,12374153,12373149,12374153,111100909,XM_022433085.1,uncharacterized LOC111100909,1004
NC_035785.1,6583082,6588380,6583088,6588380,111100913,XM_022433088.1,uncharacterized LOC111100913,5292
NC_035785.1,6583082,6588380,6583082,6588380,111100913,XM_022433090.1,uncharacterized LOC111100913,5298
NC_035780.1,36789756,36796810,36789762,36795571,111100914,XM_022433127.1,uncharacterized LOC111100914,5809
NC_035780.1,36789756,36796810,36789756,36795571,111100914,XM_022433202.1,uncharacterized LOC111100914,5815
NC_035780.1,36789756,36796810,36789762,36796810,111100914,XM_022433284.1,uncharacterized LOC111100914,7048
NC_035785.1,6609497,6656122,6645731,6656122,111100915,XM_022433091.1,uncharacterized LOC111100915,10391
NC_035785.1,6609497,6656122,6609497,6656122,111100915,XM_022433092.1,uncharacterized LOC111100915,46625
NC_035785.1,6602497,6609234,6602497,6609234,111100916,XM_022433093.1,uncharacterized LOC111100916,6737
NC_035785.1,2551145,2563639,2551145,2563639,111100919,XM_022433094.1,uncharacterized LOC111100919,12494
NC_035785.1,2551145,2563639,2551145,2555313,111100919,XM_022433095.1,uncharacterized LOC111100919,4168
NC_035785.1,2878431,2979142,2878431,2979122,111100921,XM_022433100.1,uncharacterized LOC111100921,100691
NC_035785.1,2878431,2979142,2878431,2979142,111100921,XM_022433099.1,uncharacterized LOC111100921,100711
NC_035785.1,2878431,2979142,2878431,2882390,111100921,XM_022433098.1,uncharacterized LOC111100921,3959
NC_035785.1,2725232,2727973,2725232,2727973,111100922,XM_022433101.1,uncharacterized LOC111100922,2741
NC_035785.1,2649894,2652467,2649894,2652467,111100923,XM_022433102.1,uncharacterized LOC111100923,2573
NC_035785.1,2799760,3048083,2799760,3048073,111100924,XM_022433105.1,uncharacterized LOC111100924,248313
NC_035785.1,2799760,3048083,3045432,3048067,111100924,XM_022433107.1,uncharacterized LOC111100924,2635
NC_035785.1,2799760,3048083,3045432,3048083,111100924,XM_022433103.1,uncharacterized LOC111100924,2651
NC_035785.1,2799760,3048083,2799760,2803546,111100924,XM_022433104.1,uncharacterized LOC111100924,3786
NC_035785.1,2799760,3048083,2799760,2843494,111100924,XM_022433106.1,uncharacterized LOC111100924,43734
NC_035785.1,2865810,2868454,2865810,2868454,111100926,XM_022433108.1,uncharacterized LOC111100926,2644
NC_035785.1,2613973,2763555,2613973,2763555,111100927,XM_022433111.1,uncharacterized LOC111100927,149582
NC_035785.1,2613973,2763555,2613973,2616588,111100927,XM_022433112.1,uncharacterized LOC111100927,2615
NC_035785.1,2613973,2763555,2613973,2616605,111100927,XM_022433110.1,uncharacterized LOC111100927,2632
NC_035785.1,2575960,2582954,2575960,2582954,111100928,XM_022433113.1,uncharacterized LOC111100928,6994
NC_035785.1,2739754,2741981,2739754,2741981,111100930,XM_022433114.1,uncharacterized LOC111100930,2227
NC_035785.1,2396500,2399586,2396500,2399586,111100934,XM_022433117.1,uncharacterized LOC111100934,3086
NC_035785.1,2520307,2533261,2520307,2533261,111100935,XM_022433118.1,uncharacterized LOC111100935,12954
NC_035785.1,3014636,3017415,3014636,3017415,111100936,XM_022433119.1,uncharacterized LOC111100936,2779
NC_035785.1,2940638,2943820,2940638,2943820,111100937,XM_022433120.1,uncharacterized LOC111100937,3182
NC_035785.1,2976543,2979146,2976543,2979146,111100939,XM_022433122.1,uncharacterized LOC111100939,2603
NC_035785.1,3000453,3002776,3000453,3002776,111100941,XM_022433123.1,uncharacterized LOC111100941,2323
NC_035785.1,2369369,2370212,2369369,2370171,111100943,XM_022433125.1,uncharacterized LOC111100943,802
NC_035785.1,2369369,2370212,2369369,2370212,111100943,XM_022433126.1,uncharacterized LOC111100943,843
NC_035785.1,2583743,2585166,2583743,2585166,111100944,XM_022433129.1,uncharacterized LOC111100944,1423
NC_035785.1,2839852,2841067,2839852,2841067,111100946,XM_022433133.1,uncharacterized LOC111100946,1215
NC_035785.1,3003751,3005817,3003751,3005817,111100947,XM_022433134.1,uncharacterized LOC111100947,2066
NC_035785.1,33162331,33163696,33162331,33163696,111100966,XM_022433148.1,uncharacterized LOC111100966,1365
NC_035785.1,41177438,41185478,41177438,41185478,111100968,XM_022433149.1,uncharacterized LOC111100968,8040
NC_035785.1,2133776,2141045,2135002,2141045,111100974,XM_022433156.1,uncharacterized LOC111100974,6043
NC_035785.1,2133776,2141045,2133776,2141045,111100974,XM_022433155.1,uncharacterized LOC111100974,7269
NC_035785.1,27375255,27398944,27375255,27377543,111100977,XM_022433163.1,uncharacterized LOC111100977,2288
NC_035785.1,27375255,27398944,27375284,27398944,111100977,XM_022433162.1,uncharacterized LOC111100977,23660
NC_035785.1,27375255,27398944,27396523,27398944,111100977,XM_022433161.1,uncharacterized LOC111100977,2421
NC_035785.1,27476689,27479283,27476689,27479283,111100978,XM_022433166.1,uncharacterized LOC111100978,2594
NC_035785.1,27440713,27443641,27440713,27443641,111100979,XM_022433167.1,uncharacterized LOC111100979,2928
NC_035785.1,27387647,27390239,27387647,27390239,111100980,XM_022433168.1,uncharacterized LOC111100980,2592
NC_035785.1,27409738,27414094,27409738,27414094,111100981,XM_022433169.1,uncharacterized LOC111100981,4356
NC_035785.1,27455231,27457953,27455231,27457953,111100982,XM_022433170.1,uncharacterized LOC111100982,2722
NC_035785.1,27345393,27369337,27345393,27369337,111100986,XM_022433183.1,uncharacterized LOC111100986,23944
NC_035785.1,18931094,18967050,18931094,18944785,111100989,XM_022433186.1,uncharacterized LOC111100989,13691
NC_035785.1,18931094,18967050,18931094,18948342,111100989,XM_022433188.1,uncharacterized LOC111100989,17248
NC_035785.1,18931094,18967050,18960364,18967050,111100989,XM_022433191.1,uncharacterized LOC111100989,6686
NC_035780.1,37236934,37247224,37236934,37247224,111100992,XM_022433197.1,uncharacterized LOC111100992,10290
NC_035785.1,30932222,30966254,30932222,30966249,111100993,XM_022433194.1,uncharacterized LOC111100993,34027
NC_035785.1,30932222,30966254,30932222,30966251,111100993,XM_022433195.1,uncharacterized LOC111100993,34029
NC_035785.1,30932222,30966254,30932222,30966253,111100993,XM_022433196.1,uncharacterized LOC111100993,34031
NC_035785.1,30932222,30966254,30932222,30966254,111100993,XM_022433198.1,uncharacterized LOC111100993,34032
NC_035785.1,30985201,31034196,31023486,31034196,111100994,XM_022433200.1,uncharacterized LOC111100994,10710
NC_035785.1,30985201,31034196,30985201,31034196,111100994,XM_022433199.1,uncharacterized LOC111100994,48995
NC_035785.1,30978828,30985114,30978828,30985114,111100995,XM_022433201.1,uncharacterized LOC111100995,6286
NC_035780.1,32396313,32397762,32396313,32397762,111101000,XM_022433208.1,uncharacterized LOC111101000,1449
NC_035785.1,38461822,38492954,38461822,38489311,111101001,XM_022433206.1,uncharacterized LOC111101001,27489
NC_035785.1,38461822,38492954,38461822,38492954,111101001,XM_022433205.1,uncharacterized LOC111101001,31132
NC_035785.1,43051102,43065423,43051102,43065418,111101006,XM_022433210.1,uncharacterized LOC111101006,14316
NC_035785.1,43051102,43065423,43051102,43065419,111101006,XM_022433211.1,uncharacterized LOC111101006,14317
NC_035785.1,43051102,43065423,43051102,43065420,111101006,XM_022433212.1,uncharacterized LOC111101006,14318
NC_035785.1,43051102,43065423,43051102,43065423,111101006,XM_022433213.1,uncharacterized LOC111101006,14321
NC_035785.1,43045805,43050842,43045805,43050842,111101007,XM_022433214.1,uncharacterized LOC111101007,5037
NC_035785.1,33962640,33976285,33964788,33976285,111101011,XM_022433218.1,uncharacterized LOC111101011,11497
NC_035785.1,33962640,33976285,33962640,33976285,111101011,XM_022433220.1,uncharacterized LOC111101011,13645
NC_035785.1,22362104,22432604,22362104,22432604,111101012,XM_022433221.1,uncharacterized LOC111101012,70500
NC_035785.1,22397521,22399058,22397521,22399058,111101013,XM_022433222.1,uncharacterized LOC111101013,1537
NC_035780.1,23361138,23366318,23361138,23366318,111101017,XM_022433228.1,uncharacterized LOC111101017,5180
NC_035785.1,41405203,41411587,41405203,41411587,111101022,XM_022433232.1,uncharacterized LOC111101022,6384
NC_035785.1,32893243,32902863,32893243,32902863,111101032,XM_022433255.1,uncharacterized LOC111101032,9620
NC_035780.1,37605988,37609471,37605988,37609471,111101037,XM_022433278.1,uncharacterized LOC111101037,3483
NC_035780.1,52483649,52487378,52483649,52487378,111101038,XM_022433294.1,uncharacterized LOC111101038,3729
NC_035785.1,676506,687884,676506,687884,111101040,XM_022433293.1,uncharacterized LOC111101040,11378
NC_035785.1,676506,687884,676506,679198,111101040,XM_022433295.1,uncharacterized LOC111101040,2692
NC_035785.1,9681870,9750002,9711763,9727956,111101042,XM_022433298.1,uncharacterized LOC111101042,16193
NC_035785.1,9681870,9750002,9711763,9750002,111101042,XM_022433299.1,uncharacterized LOC111101042,38239
NC_035785.1,9681870,9750002,9681870,9727956,111101042,XM_022433300.1,uncharacterized LOC111101042,46086
NC_035785.1,3646192,3656608,3646192,3656608,111101047,XM_022433305.1,uncharacterized LOC111101047,10416
NC_035785.1,47364568,47388965,47364568,47379582,111101049,XM_022433308.1,uncharacterized LOC111101049,15014
NC_035785.1,47364568,47388965,47364568,47383559,111101049,XM_022433307.1,uncharacterized LOC111101049,18991
NC_035785.1,47364568,47388965,47364568,47384481,111101049,XM_022433306.1,uncharacterized LOC111101049,19913
NC_035785.1,47364568,47388965,47364568,47367096,111101049,XM_022433309.1,uncharacterized LOC111101049,2528
NC_035785.1,31620325,31624045,31620325,31624045,111101052,XM_022433312.1,uncharacterized LOC111101052,3720
NC_035785.1,14310161,14313973,14310161,14313973,111101056,XM_022433322.1,uncharacterized LOC111101056,3812
NC_035785.1,14320059,14327307,14320059,14327307,111101058,XM_022433324.1,uncharacterized LOC111101058,7248
NC_035785.1,32826339,32834800,32826339,32832105,111101059,XM_022433326.1,uncharacterized LOC111101059,5766
NC_035785.1,32826339,32834800,32826339,32832840,111101059,XM_022433327.1,uncharacterized LOC111101059,6501
NC_035785.1,32826339,32834800,32826340,32834800,111101059,XM_022433325.1,uncharacterized LOC111101059,8460
NC_035785.1,40901697,40904648,40901697,40904648,111101062,XM_022433336.1,uncharacterized LOC111101062,2951
NC_035785.1,40811863,40814589,40811881,40814589,111101063,XM_022433338.1,uncharacterized LOC111101063,2708
NC_035785.1,40811863,40814589,40811863,40814589,111101063,XM_022433337.1,uncharacterized LOC111101063,2726
NC_035785.1,29496867,29498882,29496867,29498882,111101065,XM_022433341.1,uncharacterized LOC111101065,2015
NC_035785.1,5656118,5658142,5656118,5658142,111101066,XM_022433342.1,uncharacterized LOC111101066,2024
NC_035785.1,11839169,11849029,11839169,11844406,111101067,XM_022433345.1,uncharacterized LOC111101067,5237
NC_035785.1,11839169,11849029,11839169,11848870,111101067,XM_022433343.1,uncharacterized LOC111101067,9701
NC_035785.1,11839169,11849029,11839169,11849029,111101067,XM_022433344.1,uncharacterized LOC111101067,9860
NC_035785.1,35543924,35545149,35543924,35545149,111101068,XM_022433347.1,uncharacterized LOC111101068,1225
NC_035785.1,4232053,4234810,4232053,4234810,111101071,XM_022433351.1,uncharacterized LOC111101071,2757
NC_035785.1,4239795,4244178,4239795,4244178,111101072,XM_022433352.1,uncharacterized LOC111101072,4383
NC_035785.1,8735031,8749056,8735031,8749056,111101074,XM_022433354.1,uncharacterized LOC111101074,14025
NC_035785.1,8738682,8744282,8738682,8744282,111101075,XM_022433355.1,uncharacterized LOC111101075,5600
NC_035785.1,6503759,6550704,6503759,6550704,111101078,XM_022433361.1,uncharacterized LOC111101078,46945
NC_035785.1,19046126,19049821,19046126,19049821,111101085,XM_022433374.1,uncharacterized LOC111101085,3695
NC_035785.1,8249860,8261233,8249969,8261233,111101090,XM_022433380.1,uncharacterized LOC111101090,11264
NC_035785.1,8249860,8261233,8249860,8261233,111101090,XM_022433381.1,uncharacterized LOC111101090,11373
NC_035785.1,8249860,8261233,8258229,8261233,111101090,XM_022433382.1,uncharacterized LOC111101090,3004
NC_035785.1,8249860,8261233,8255640,8261233,111101090,XM_022433384.1,uncharacterized LOC111101090,5593
NC_035785.1,11950341,11972984,11950341,11972984,111101098,XM_022433397.1,uncharacterized LOC111101098,22643
NC_035785.1,515401,524498,515401,524498,111101099,XM_022433398.1,uncharacterized LOC111101099,9097
NC_035785.1,22583772,22605027,22590630,22605024,111101102,XM_022433407.1,uncharacterized LOC111101102,14394
NC_035785.1,22583772,22605027,22590624,22605024,111101102,XM_022433405.1,uncharacterized LOC111101102,14400
NC_035785.1,22583772,22605027,22585880,22603501,111101102,XM_022433409.1,uncharacterized LOC111101102,17621
NC_035785.1,22583772,22605027,22585879,22605024,111101102,XM_022433403.1,uncharacterized LOC111101102,19145
NC_035785.1,22583772,22605027,22585879,22605027,111101102,XM_022433411.1,uncharacterized LOC111101102,19148
NC_035785.1,22583772,22605027,22583772,22605024,111101102,XM_022433408.1,uncharacterized LOC111101102,21252
NC_035785.1,22583772,22605027,22597757,22605024,111101102,XM_022433406.1,uncharacterized LOC111101102,7267
NC_035785.1,22605236,22613125,22605236,22613125,111101104,XM_022433412.1,uncharacterized LOC111101104,7889
NC_035785.1,46892771,46904900,46892771,46904900,111101105,XM_022433413.1,uncharacterized LOC111101105,12129
NC_035785.1,46930278,46980155,46930278,46980155,111101106,XM_022433416.1,uncharacterized LOC111101106,49877
NC_035785.1,37527851,37534979,37527851,37534979,111101111,XM_022433421.1,uncharacterized LOC111101111,7128
NC_035785.1,21726860,21729344,21726860,21729344,111101112,XM_022433422.1,uncharacterized LOC111101112,2484
NC_035785.1,2193345,2197539,2193345,2195549,111101115,XM_022433426.1,uncharacterized LOC111101115,2204
NC_035785.1,2193345,2197539,2193346,2197539,111101115,XM_022433425.1,uncharacterized LOC111101115,4193
NC_035785.1,40576567,40620165,40576567,40579211,111101117,XM_022433432.1,uncharacterized LOC111101117,2644
NC_035785.1,40576567,40620165,40576567,40579230,111101117,XM_022433430.1,uncharacterized LOC111101117,2663
NC_035785.1,40576567,40620165,40576567,40620165,111101117,XM_022433431.1,uncharacterized LOC111101117,43598
NC_035785.1,40550076,40552706,40550076,40552706,111101118,XM_022433434.1,uncharacterized LOC111101118,2630
NC_035785.1,40617552,40633200,40617552,40633200,111101120,XM_022433436.1,uncharacterized LOC111101120,15648
NC_035785.1,23285259,23294730,23286868,23294730,111101123,XM_022433439.1,uncharacterized LOC111101123,7862
NC_035785.1,23285259,23294730,23285259,23294730,111101123,XM_022433441.1,uncharacterized LOC111101123,9471
NC_035785.1,39589916,39713151,39589916,39713151,111101125,XM_022433444.1,uncharacterized LOC111101125,123235
NC_035785.1,23849073,23851327,23849111,23851327,111101126,XM_022433446.1,uncharacterized LOC111101126,2216
NC_035785.1,23849073,23851327,23849073,23851327,111101126,XM_022433445.1,uncharacterized LOC111101126,2254
NC_035785.1,23828650,23830884,23828650,23830884,111101127,XM_022433447.1,uncharacterized LOC111101127,2234
NC_035785.1,214573,275676,214573,275676,111101130,XM_022433450.1,uncharacterized LOC111101130,61103
NC_035785.1,215893,219920,215893,219920,111101131,XM_022433451.1,uncharacterized LOC111101131,4027
NC_035785.1,853698,856860,853698,856860,111101132,XM_022433452.1,uncharacterized LOC111101132,3162
NC_035785.1,46723506,46727776,46723506,46727776,111101133,XM_022433453.1,uncharacterized LOC111101133,4270
NC_035785.1,46659463,46734653,46659463,46720504,111101134,XM_022433459.1,uncharacterized LOC111101134,61041
NC_035785.1,46659463,46734653,46659463,46731071,111101134,XM_022433458.1,uncharacterized LOC111101134,71608
NC_035785.1,46659463,46734653,46659463,46734619,111101134,XM_022433455.1,uncharacterized LOC111101134,75156
NC_035785.1,46659463,46734653,46659463,46734653,111101134,XM_022433460.1,uncharacterized LOC111101134,75190
NC_035785.1,46681888,46686817,46681888,46686817,111101135,XM_022433461.1,uncharacterized LOC111101135,4929
NC_035785.1,45782417,45846556,45782425,45799111,111101138,XM_022433473.1,uncharacterized LOC111101138,16686
NC_035785.1,45782417,45846556,45782424,45799111,111101138,XM_022433470.1,uncharacterized LOC111101138,16687
NC_035785.1,45782417,45846556,45782417,45799111,111101138,XM_022433471.1,uncharacterized LOC111101138,16694
NC_035780.1,4111587,4123104,4111587,4122318,111101139,XM_022433485.1,uncharacterized LOC111101139,10731
NC_035780.1,4111587,4123104,4111587,4123104,111101139,XM_022433494.1,uncharacterized LOC111101139,11517
NC_035785.1,45886128,45913279,45901596,45913277,111101141,XM_022433479.1,uncharacterized LOC111101141,11681
NC_035785.1,45886128,45913279,45901595,45913279,111101141,XM_022433476.1,uncharacterized LOC111101141,11684
NC_035785.1,45886128,45913279,45886128,45913275,111101141,XM_022433477.1,uncharacterized LOC111101141,27147
NC_035785.1,45809404,45816828,45809404,45813522,111101143,XM_022433481.1,uncharacterized LOC111101143,4118
NC_035785.1,45809404,45816828,45809404,45816828,111101143,XM_022433482.1,uncharacterized LOC111101143,7424
NC_035785.1,499650,512256,499650,512256,111101146,XM_022433486.1,uncharacterized LOC111101146,12606
NC_035780.1,4126655,4142083,4126655,4142083,111101156,XM_022433507.1,uncharacterized LOC111101156,15428
NC_035785.1,20956366,20967494,20956366,20967494,111101160,XM_022433508.1,uncharacterized LOC111101160,11128
NC_035785.1,20950744,20980647,20950744,20980647,111101161,XM_022433509.1,uncharacterized LOC111101161,29903
NC_035785.1,20948844,20950215,20948844,20950215,111101162,XM_022433510.1,uncharacterized LOC111101162,1371
NC_035785.1,47212265,47234221,47219128,47234221,111101163,XM_022433512.1,uncharacterized LOC111101163,15093
NC_035785.1,47212265,47234221,47219120,47234221,111101163,XM_022433513.1,uncharacterized LOC111101163,15101
NC_035785.1,47212265,47234221,47214366,47232364,111101163,XM_022433516.1,uncharacterized LOC111101163,17998
NC_035785.1,47212265,47234221,47214368,47234221,111101163,XM_022433514.1,uncharacterized LOC111101163,19853
NC_035785.1,47212265,47234221,47214366,47234221,111101163,XM_022433517.1,uncharacterized LOC111101163,19855
NC_035785.1,47212265,47234221,47212265,47234221,111101163,XM_022433515.1,uncharacterized LOC111101163,21956
NC_035785.1,3503649,3518084,3503649,3518084,111101172,XM_022433538.1,uncharacterized LOC111101172,14435
NC_035780.1,4096590,4100442,4096590,4100442,111101176,XM_022433547.1,uncharacterized LOC111101176,3852
NC_035785.1,40912071,40914622,40912071,40914622,111101179,XM_022433548.1,uncharacterized LOC111101179,2551
NC_035785.1,896798,900994,896798,900994,111101182,XM_022433552.1,uncharacterized LOC111101182,4196
NC_035785.1,38362063,38371150,38362063,38371150,111101183,XM_022433553.1,uncharacterized LOC111101183,9087
NC_035785.1,13932620,13975098,13932620,13971091,111101184,XM_022433555.1,uncharacterized LOC111101184,38471
NC_035785.1,13932620,13975098,13932620,13975098,111101184,XM_022433554.1,uncharacterized LOC111101184,42478
NC_035785.1,17888378,17895004,17888378,17895004,111101188,XM_022433556.1,uncharacterized LOC111101188,6626
NC_035785.1,17841542,17849880,17841542,17849880,111101189,XM_022433558.1,uncharacterized LOC111101189,8338
NC_035785.1,17931878,17939699,17931932,17939699,111101190,XM_022433564.1,uncharacterized LOC111101190,7767
NC_035785.1,17931878,17939699,17931930,17939699,111101190,XM_022433561.1,uncharacterized LOC111101190,7769
NC_035785.1,17931878,17939699,17931878,17939699,111101190,XM_022433562.1,uncharacterized LOC111101190,7821
NC_035785.1,17983082,17997268,17983082,17997268,111101191,XM_022433565.1,uncharacterized LOC111101191,14186
NC_035785.1,17970472,17979026,17970472,17979026,111101194,XM_022433569.1,uncharacterized LOC111101194,8554
NC_035785.1,17954888,17955922,17954888,17955922,111101195,XM_022433570.1,uncharacterized LOC111101195,1034
NC_035785.1,17866854,17874697,17866854,17874697,111101196,XM_022433571.1,uncharacterized LOC111101196,7843
NC_035785.1,21768977,21771638,21768977,21771638,111101198,XM_022433574.1,uncharacterized LOC111101198,2661
NC_035785.1,22692871,22695104,22692871,22695104,111101202,XM_022433580.1,uncharacterized LOC111101202,2233
NC_035785.1,787045,791325,787045,791325,111101204,XM_022433582.1,uncharacterized LOC111101204,4280
NC_035780.1,39081089,39084700,39081089,39084700,111101213,XM_022433610.1,uncharacterized LOC111101213,3611
NC_035780.1,8635765,8643465,8635790,8643465,111101216,XM_022433632.1,uncharacterized LOC111101216,7675
NC_035780.1,8635765,8643465,8635765,8643465,111101216,XM_022433624.1,uncharacterized LOC111101216,7700
NC_035785.1,31816918,31819493,31816918,31819493,111101217,XM_022433621.1,uncharacterized LOC111101217,2575
NC_035785.1,3071051,3072424,3071051,3072424,111101218,XM_022433622.1,uncharacterized LOC111101218,1373
NC_035785.1,36305221,36312463,36305221,36312463,111101220,XM_022433625.1,uncharacterized LOC111101220,7242
NC_035785.1,36297144,36302818,36297144,36302818,111101221,XM_022433626.1,uncharacterized LOC111101221,5674
NC_035785.1,37871270,37878151,37871270,37877366,111101225,XM_022433634.1,uncharacterized LOC111101225,6096
NC_035785.1,37871270,37878151,37871270,37877384,111101225,XM_022433638.1,uncharacterized LOC111101225,6114
NC_035785.1,37871270,37878151,37871270,37877463,111101225,XM_022433635.1,uncharacterized LOC111101225,6193
NC_035785.1,37871270,37878151,37871270,37878151,111101225,XM_022433637.1,uncharacterized LOC111101225,6881
NC_035785.1,19333246,19339635,19333246,19339635,111101229,XM_022433645.1,uncharacterized LOC111101229,6389
NC_035785.1,5575737,5582162,5575737,5582162,111101235,XM_022433661.1,uncharacterized LOC111101235,6425
NC_035785.1,9885810,9903728,9885810,9903728,111101236,XM_022433662.1,uncharacterized LOC111101236,17918
NC_035785.1,24869196,24871772,24869196,24871772,111101239,XM_022433666.1,uncharacterized LOC111101239,2576
NC_035785.1,12529967,12533230,12529967,12533230,111101240,XM_022433667.1,uncharacterized LOC111101240,3263
NC_035785.1,9812693,9815642,9812693,9815642,111101242,XM_022433671.1,uncharacterized LOC111101242,2949
NC_035785.1,36358908,36370149,36358909,36370148,111101243,XM_022433672.1,uncharacterized LOC111101243,11239
NC_035785.1,36358908,36370149,36358908,36370149,111101243,XM_022433673.1,uncharacterized LOC111101243,11241
NC_035785.1,28585243,28586967,28585243,28586967,111101244,XM_022433674.1,uncharacterized LOC111101244,1724
NC_035785.1,11306973,11316058,11306973,11316058,111101246,XM_022433677.1,uncharacterized LOC111101246,9085
NC_035785.1,5562477,5572491,5562477,5572491,111101247,XM_022433678.1,uncharacterized LOC111101247,10014
NC_035785.1,22675768,22680982,22675769,22680982,111101248,XM_022433680.1,uncharacterized LOC111101248,5213
NC_035785.1,22675768,22680982,22675768,22680982,111101248,XM_022433679.1,uncharacterized LOC111101248,5214
NC_035780.1,281547,293861,281696,293861,111101250,XM_022433693.1,uncharacterized LOC111101250,12165
NC_035780.1,281547,293861,281547,293861,111101250,XM_022433686.1,uncharacterized LOC111101250,12314
NC_035785.1,27996358,28006041,27996358,28006041,111101252,XM_022433685.1,uncharacterized LOC111101252,9683
NC_035785.1,4932700,4943718,4932700,4943718,111101255,XM_022433688.1,uncharacterized LOC111101255,11018
NC_035785.1,11133483,11176063,11134540,11176063,111101258,XM_022433695.1,uncharacterized LOC111101258,41523
NC_035785.1,11133483,11176063,11134539,11176063,111101258,XM_022433698.1,uncharacterized LOC111101258,41524
NC_035785.1,11133483,11176063,11133483,11176063,111101258,XM_022433696.1,uncharacterized LOC111101258,42580
NC_035780.1,43895396,43896972,43895396,43896972,111101259,XM_022433732.1,uncharacterized LOC111101259,1576
NC_035785.1,6706743,6713369,6706743,6713369,111101264,XM_022433704.1,uncharacterized LOC111101264,6626
NC_035785.1,33514142,33523682,33514142,33523682,111101267,XM_022433707.1,uncharacterized LOC111101267,9540
NC_035785.1,34843686,34846057,34843686,34846057,111101269,XM_022433709.1,uncharacterized LOC111101269,2371
NC_035785.1,11920426,11928894,11920426,11927298,111101272,XM_022433710.1,uncharacterized LOC111101272,6872
NC_035785.1,1771936,1782249,1771936,1782249,111101274,XM_022433713.1,uncharacterized LOC111101274,10313
NC_035785.1,1771936,1782249,1771936,1781484,111101274,XM_022433712.1,uncharacterized LOC111101274,9548
NC_035785.1,46153482,46160658,46154536,46160658,111101276,XM_022433717.1,uncharacterized LOC111101276,6122
NC_035785.1,46153482,46160658,46153482,46160658,111101276,XM_022433718.1,uncharacterized LOC111101276,7176
NC_035785.1,46139733,46184620,46150815,46184620,111101277,XM_022433720.1,uncharacterized LOC111101277,33805
NC_035785.1,46139733,46184620,46139733,46184620,111101277,XM_022433719.1,uncharacterized LOC111101277,44887
NC_035785.1,37248872,37250184,37248872,37250184,111101279,XM_022433721.1,uncharacterized LOC111101279,1312
NC_035785.1,31826197,31829601,31826197,31829601,111101294,XM_022433736.1,uncharacterized LOC111101294,3404
NC_035785.1,12145438,12150302,12145438,12150302,111101295,XM_022433738.1,uncharacterized LOC111101295,4864
NC_035785.1,12005292,12020893,12005292,12020893,111101296,XM_022433739.1,uncharacterized LOC111101296,15601
NC_035780.1,47465608,47474142,47465608,47474142,111101300,XM_022433748.1,uncharacterized LOC111101300,8534
NC_035785.1,45156857,45186292,45156857,45175526,111101301,XM_022433747.1,uncharacterized LOC111101301,18669
NC_035785.1,45156857,45186292,45156857,45166039,111101301,XM_022433746.1,uncharacterized LOC111101301,9182
NC_035785.1,45156857,45186292,45156857,45166675,111101301,XM_022433745.1,uncharacterized LOC111101301,9818
NC_035785.1,9802770,9806302,9802770,9806302,111101302,XM_022433749.1,uncharacterized LOC111101302,3532
NC_035780.1,62705769,62708781,62705769,62708781,111101303,XM_022433753.1,uncharacterized LOC111101303,3012
NC_035785.1,39115351,39152171,39115351,39134516,111101311,XM_022433760.1,uncharacterized LOC111101311,19165
NC_035785.1,39115351,39152171,39115351,39152171,111101311,XM_022433759.1,uncharacterized LOC111101311,36820
NC_035785.1,35596250,35604368,35596250,35604368,111101314,XM_022433761.1,uncharacterized LOC111101314,8118
NC_035785.1,33818377,33828334,33818377,33828334,111101315,XM_022433762.1,uncharacterized LOC111101315,9957
NC_035785.1,36510371,36517208,36510371,36517208,111101316,XM_022433763.1,uncharacterized LOC111101316,6837
NC_035785.1,32132495,32134098,32132495,32134098,111101319,XM_022433765.1,uncharacterized LOC111101319,1603
NC_035785.1,21189424,21195205,21189424,21195205,111101320,XM_022433766.1,uncharacterized LOC111101320,5781
NC_035785.1,9403282,9409280,9403282,9405143,111101326,XM_022433773.1,uncharacterized LOC111101326,1861
NC_035785.1,9403282,9409280,9404653,9409280,111101326,XM_022433772.1,uncharacterized LOC111101326,4627
NC_035785.1,9089234,9118310,9100011,9118310,111101329,XM_022433778.1,uncharacterized LOC111101329,18299
NC_035785.1,9089234,9118310,9089234,9118310,111101329,XM_022433780.1,uncharacterized LOC111101329,29076
NC_035785.1,9089234,9118310,9115033,9118310,111101329,XM_022433779.1,uncharacterized LOC111101329,3277
NC_035785.1,9598679,9604903,9601611,9604903,111101330,XM_022433781.1,uncharacterized LOC111101330,3292
NC_035785.1,9598679,9604903,9598679,9604902,111101330,XM_022433782.1,uncharacterized LOC111101330,6223
NC_035785.1,9091858,9096253,9091858,9096253,111101332,XM_022433784.1,uncharacterized LOC111101332,4395
NC_035785.1,9570936,9574263,9570936,9574263,111101333,XM_022433787.1,uncharacterized LOC111101333,3327
NC_035785.1,9547884,9552279,9547884,9552279,111101334,XM_022433788.1,uncharacterized LOC111101334,4395
NC_035785.1,9576546,9583968,9576546,9583968,111101335,XM_022433789.1,uncharacterized LOC111101335,7422
NC_035785.1,9066933,9070228,9066933,9070228,111101336,XM_022433790.1,uncharacterized LOC111101336,3295
NC_035785.1,9118843,9122533,9118843,9122533,111101337,XM_022433791.1,uncharacterized LOC111101337,3690
NC_035785.1,9074378,9078724,9074378,9078724,111101338,XM_022433792.1,uncharacterized LOC111101338,4346
NC_035785.1,9164630,9167032,9164630,9167032,111101339,XM_022433793.1,uncharacterized LOC111101339,2402
NC_035785.1,9490442,9493249,9491396,9493249,111101341,XM_022433795.1,uncharacterized LOC111101341,1853
NC_035785.1,9490442,9493249,9490442,9493249,111101341,XM_022433794.1,uncharacterized LOC111101341,2807
NC_035785.1,9482655,9484572,9482655,9484572,111101342,XM_022433796.1,uncharacterized LOC111101342,1917
NC_035785.1,9498117,9499882,9498117,9499882,111101343,XM_022433797.1,uncharacterized LOC111101343,1765
NC_035785.1,9465515,9471855,9465515,9471855,111101344,XM_022433799.1,uncharacterized LOC111101344,6340
NC_035785.1,9517062,9518835,9517062,9518835,111101345,XM_022433800.1,uncharacterized LOC111101345,1773
NC_035785.1,9140070,9142346,9140070,9142346,111101346,XM_022433801.1,uncharacterized LOC111101346,2276
NC_035780.1,57053031,57059574,57053031,57059574,111101347,XM_022433839.1,uncharacterized LOC111101347,6543
NC_035785.1,9290099,9293993,9290099,9293993,111101351,XM_022433806.1,uncharacterized LOC111101351,3894
NC_035785.1,9168046,9170320,9168046,9170320,111101352,XM_022433807.1,uncharacterized LOC111101352,2274
NC_035785.1,9199060,9245820,9243500,9245820,111101353,XM_022433808.1,uncharacterized LOC111101353,2320
NC_035785.1,9199060,9245820,9199060,9245820,111101353,XM_022433809.1,uncharacterized LOC111101353,46760
NC_035785.1,9203920,9205433,9203920,9205433,111101354,XM_022433811.1,uncharacterized LOC111101354,1513
NC_035785.1,9214419,9216951,9214419,9216951,111101355,XM_022433812.1,uncharacterized LOC111101355,2532
NC_035785.1,9237998,9246352,9237998,9246352,111101356,XM_022433813.1,uncharacterized LOC111101356,8354
NC_035785.1,9561073,9564464,9561105,9564464,111101357,XM_022433814.1,uncharacterized LOC111101357,3359
NC_035785.1,36015217,36022613,36015217,36022613,111101363,XM_022433817.1,uncharacterized LOC111101363,7396
NC_035785.1,11374118,11376027,11374118,11376027,111101369,XM_022433828.1,uncharacterized LOC111101369,1909
NC_035785.1,38281613,38292988,38281613,38292988,111101370,XM_022433832.1,uncharacterized LOC111101370,11375
NC_035785.1,38281613,38292988,38283935,38292988,111101370,XM_022433834.1,uncharacterized LOC111101370,9053
NC_035785.1,25581487,25586677,25581506,25586677,111101371,XM_022433838.1,uncharacterized LOC111101371,5171
NC_035785.1,25581487,25586677,25581487,25586677,111101371,XM_022433837.1,uncharacterized LOC111101371,5190
NC_035785.1,33886993,33898484,33886993,33898484,111101378,XM_022433847.1,uncharacterized LOC111101378,11491
NC_035785.1,29118908,29131735,29118908,29131735,111101380,XM_022433848.1,uncharacterized LOC111101380,12827
NC_035785.1,1395560,1421294,1396477,1421294,111101381,XM_022433853.1,uncharacterized LOC111101381,24817
NC_035785.1,1395560,1421294,1395560,1421294,111101381,XM_022433850.1,uncharacterized LOC111101381,25734
NC_035785.1,49539849,49542267,49539849,49542267,111101383,XM_022433854.1,uncharacterized LOC111101383,2418
NC_035785.1,31635848,31638834,31635848,31638834,111101385,XM_022433855.1,uncharacterized LOC111101385,2986
NC_035785.1,11620690,11624499,11620690,11624499,111101389,XM_022433860.1,uncharacterized LOC111101389,3809
NC_035785.1,36642887,36646316,36642888,36646316,111101390,XM_022433861.1,uncharacterized LOC111101390,3428
NC_035785.1,36642887,36646316,36642887,36646316,111101390,XM_022433862.1,uncharacterized LOC111101390,3429
NC_035785.1,8871589,8879483,8871589,8879483,111101396,XM_022433867.1,uncharacterized LOC111101396,7894
NC_035785.1,18634193,18646350,18634193,18646350,111101398,XM_022433868.1,uncharacterized LOC111101398,12157
NC_035785.1,16823242,16830514,16823242,16830514,111101402,XM_022433874.1,uncharacterized LOC111101402,7272
NC_035785.1,11635546,11646495,11635546,11646495,111101404,XM_022433878.1,uncharacterized LOC111101404,10949
NC_035785.1,11635546,11646495,11635547,11644935,111101404,XM_022433877.1,uncharacterized LOC111101404,9388
NC_035785.1,34859064,34860559,34859064,34860559,111101408,XM_022433880.1,uncharacterized LOC111101408,1495
NC_035785.1,43561319,43565156,43561319,43565156,111101409,XM_022433881.1,uncharacterized LOC111101409,3837
NC_035785.1,4162402,4167135,4162402,4167135,111101411,XM_022433885.1,uncharacterized LOC111101411,4733
NC_035785.1,9868343,9881163,9868344,9881163,111101412,XM_022433893.1,uncharacterized LOC111101412,12819
NC_035785.1,9868343,9881163,9868343,9881163,111101412,XM_022433886.1,uncharacterized LOC111101412,12820
NC_035785.1,9868343,9881163,9877418,9881163,111101412,XM_022433889.1,uncharacterized LOC111101412,3745
NC_035785.1,41304046,41307342,41304153,41307342,111101414,XM_022433896.1,uncharacterized LOC111101414,3189
NC_035785.1,41304046,41307342,41304046,41307342,111101414,XM_022433895.1,uncharacterized LOC111101414,3296
NC_035785.1,206623,213400,207698,213400,111101415,XM_022433898.1,uncharacterized LOC111101415,5702
NC_035785.1,206623,213400,206623,213399,111101415,XM_022433897.1,uncharacterized LOC111101415,6776
NC_035785.1,47341171,47342981,47341171,47342981,111101416,XM_022433899.1,uncharacterized LOC111101416,1810
NC_035785.1,35340401,35342369,35340401,35342369,111101417,XM_022433901.1,uncharacterized LOC111101417,1968
NC_035785.1,40287995,40291054,40289361,40291054,111101418,XM_022433902.1,uncharacterized LOC111101418,1693
NC_035785.1,40287995,40291054,40288907,40291052,111101418,XM_022433903.1,uncharacterized LOC111101418,2145
NC_035785.1,40287995,40291054,40288000,40291053,111101418,XM_022433905.1,uncharacterized LOC111101418,3053
NC_035785.1,40287995,40291054,40287995,40291053,111101418,XM_022433904.1,uncharacterized LOC111101418,3058
NC_035785.1,44556511,44562148,44556511,44562148,111101422,XM_022433910.1,uncharacterized LOC111101422,5637
NC_035780.1,57036386,57043004,57036386,57043004,111101427,XM_022433949.1,uncharacterized LOC111101427,6618
NC_035785.1,51148286,51162106,51148332,51162106,111101428,XM_022433917.1,uncharacterized LOC111101428,13774
NC_035785.1,51148286,51162106,51148286,51162106,111101428,XM_022433916.1,uncharacterized LOC111101428,13820
NC_035785.1,44866989,44889186,44866989,44889186,111101429,XM_022433918.1,uncharacterized LOC111101429,22197
NC_035785.1,33876505,33880982,33876505,33880982,111101432,XM_022433919.1,uncharacterized LOC111101432,4477
NC_035785.1,33854066,33868760,33854066,33868760,111101433,XM_022433921.1,uncharacterized LOC111101433,14694
NC_035785.1,33854066,33868760,33854066,33859184,111101433,XM_022433920.1,uncharacterized LOC111101433,5118
NC_035785.1,18025950,18027900,18025950,18027900,111101434,XM_022433923.1,uncharacterized LOC111101434,1950
NC_035785.1,1031816,1048258,1031816,1048227,111101438,XM_022433927.1,uncharacterized LOC111101438,16411
NC_035785.1,1031816,1048258,1031816,1048258,111101438,XM_022433926.1,uncharacterized LOC111101438,16442
NC_035785.1,14099880,14103598,14099880,14103598,111101439,XM_022433928.1,uncharacterized LOC111101439,3718
NC_035785.1,28181422,28193319,28181422,28193319,111101441,XM_022433929.1,uncharacterized LOC111101441,11897
NC_035785.1,21539841,21546042,21539841,21546042,111101444,XM_022433931.1,uncharacterized LOC111101444,6201
NC_035785.1,50457664,50463336,50457664,50463319,111101445,XM_022433934.1,uncharacterized LOC111101445,5655
NC_035785.1,50457664,50463336,50457664,50463336,111101445,XM_022433933.1,uncharacterized LOC111101445,5672
NC_035780.1,9943497,9949595,9944197,9946861,111101449,XM_022433940.1,uncharacterized LOC111101449,2664
NC_035780.1,9943497,9949595,9943497,9946861,111101449,XM_022433950.1,uncharacterized LOC111101449,3364
NC_035780.1,9943497,9949595,9944196,9949595,111101449,XM_022433959.1,uncharacterized LOC111101449,5399
NC_035785.1,22672893,22674663,22672893,22674663,111101452,XM_022433943.1,uncharacterized LOC111101452,1770
NC_035785.1,37331619,37333520,37331619,37333520,111101454,XM_022433945.1,uncharacterized LOC111101454,1901
NC_035785.1,8129680,8139825,8129680,8139825,111101455,XM_022433946.1,uncharacterized LOC111101455,10145
NC_035785.1,8129680,8139825,8131753,8139825,111101455,XM_022433947.1,uncharacterized LOC111101455,8072
NC_035785.1,41274470,41281166,41274470,41281166,111101459,XM_022433958.1,uncharacterized LOC111101459,6696
NC_035785.1,19014164,19016076,19014164,19016076,111101461,XM_022433962.1,uncharacterized LOC111101461,1912
NC_035785.1,24997577,25000136,24997577,25000136,111101463,XM_022433963.1,uncharacterized LOC111101463,2559
NC_035785.1,24966624,24970034,24966624,24969477,111101464,XM_022433964.1,uncharacterized LOC111101464,2853
NC_035785.1,24966624,24970034,24966624,24970034,111101464,XM_022433965.1,uncharacterized LOC111101464,3410
NC_035785.1,47926169,47931599,47926169,47931599,111101469,XM_022433972.1,uncharacterized LOC111101469,5430
NC_035785.1,43416620,43428707,43416620,43428707,111101473,XM_022433979.1,uncharacterized LOC111101473,12087
NC_035785.1,4155563,4159269,4155563,4159269,111101474,XM_022433982.1,uncharacterized LOC111101474,3706
NC_035785.1,18405272,18407712,18405272,18407712,111101475,XM_022433983.1,uncharacterized LOC111101475,2440
NC_035785.1,20236712,20244024,20236712,20244024,111101476,XM_022433984.1,uncharacterized LOC111101476,7312
NC_035785.1,35472578,35481217,35472578,35481217,111101478,XM_022433987.1,uncharacterized LOC111101478,8639
NC_035785.1,35937635,35938846,35937635,35938846,111101482,XM_022433991.1,uncharacterized LOC111101482,1211
NC_035785.1,4907594,4911583,4907594,4911583,111101486,XM_022433997.1,uncharacterized LOC111101486,3989
NC_035785.1,45737193,45756697,45737229,45750727,111101489,XM_022434004.1,uncharacterized LOC111101489,13498
NC_035785.1,45737193,45756697,45737193,45750727,111101489,XM_022434003.1,uncharacterized LOC111101489,13534
NC_035785.1,45737193,45756697,45740788,45756697,111101489,XM_022434005.1,uncharacterized LOC111101489,15909
NC_035785.1,45737193,45756697,45754596,45756697,111101489,XM_022434000.1,uncharacterized LOC111101489,2101
NC_035785.1,45737193,45756697,45740785,45750727,111101489,XM_022434001.1,uncharacterized LOC111101489,9942
NC_035785.1,8167526,8177086,8167526,8177086,111101490,XM_022434008.1,uncharacterized LOC111101490,9560
NC_035785.1,35538865,35540757,35538865,35540757,111101493,XM_022434012.1,uncharacterized LOC111101493,1892
NC_035785.1,1154697,1165306,1154697,1165306,111101494,XM_022434013.1,uncharacterized LOC111101494,10609
NC_035785.1,21443696,21458416,21443696,21458416,111101495,XM_022434015.1,uncharacterized LOC111101495,14720
NC_035785.1,41086181,41087754,41086181,41087754,111101497,XM_022434017.1,uncharacterized LOC111101497,1573
NC_035785.1,12171519,12179094,12171519,12179094,111101499,XM_022434019.1,uncharacterized LOC111101499,7575
NC_035785.1,6168299,6177833,6169074,6177833,111101503,XM_022434022.1,uncharacterized LOC111101503,8759
NC_035785.1,49499333,49501624,49499333,49501624,111101506,XM_022434027.1,uncharacterized LOC111101506,2291
NC_035785.1,28577396,28580226,28577396,28580226,111101509,XM_022434033.1,uncharacterized LOC111101509,2830
NC_035785.1,32808678,32820880,32808678,32820880,111101516,XM_022434040.1,uncharacterized LOC111101516,12202
NC_035785.1,2215033,2220686,2215033,2220686,111101520,XM_022434045.1,uncharacterized LOC111101520,5653
NC_035785.1,47445975,47479147,47445975,47479147,111101525,XM_022434051.1,uncharacterized LOC111101525,33172
NC_035785.1,30513858,30521754,30513858,30521754,111101528,XM_022434053.1,uncharacterized LOC111101528,7896
NC_035785.1,1473412,1498134,1473412,1498134,111101534,XM_022434058.1,uncharacterized LOC111101534,24722
NC_035785.1,47163297,47164037,47163297,47164037,111101535,XM_022434059.1,uncharacterized LOC111101535,740
NC_035785.1,16434186,16450726,16434186,16445452,111101543,XM_022434068.1,uncharacterized LOC111101543,11266
NC_035785.1,16434186,16450726,16434186,16450719,111101543,XM_022434065.1,uncharacterized LOC111101543,16533
NC_035785.1,16434186,16450726,16434186,16450726,111101543,XM_022434066.1,uncharacterized LOC111101543,16540
NC_035785.1,16316682,16338147,16316833,16338147,111101545,XM_022434072.1,uncharacterized LOC111101545,21314
NC_035785.1,16316682,16338147,16316682,16338147,111101545,XM_022434071.1,uncharacterized LOC111101545,21465
NC_035785.1,16316682,16338147,16332969,16338147,111101545,XM_022434073.1,uncharacterized LOC111101545,5178
NC_035785.1,16208480,16226887,16208480,16226887,111101546,XM_022434074.1,uncharacterized LOC111101546,18407
NC_035785.1,16246967,16253846,16246967,16253846,111101547,XM_022434075.1,uncharacterized LOC111101547,6879
NC_035785.1,16275905,16355473,16275905,16296052,111101549,XM_022434079.1,uncharacterized LOC111101549,20147
NC_035785.1,16275905,16355473,16275905,16355473,111101549,XM_022434082.1,uncharacterized LOC111101549,79568
NC_035785.1,16504661,16507148,16504661,16507148,111101551,XM_022434087.1,uncharacterized LOC111101551,2487
NC_035785.1,16572981,16576460,16572981,16576460,111101556,XM_022434093.1,uncharacterized LOC111101556,3479
NC_035780.1,26399207,26401560,26399207,26401560,111101564,XM_022434099.1,uncharacterized LOC111101564,2353
NC_035785.1,73510,77770,73510,77770,111101566,XM_022434097.1,uncharacterized LOC111101566,4260
NC_035785.1,5312027,5316567,5312027,5316567,111101567,XM_022434098.1,uncharacterized LOC111101567,4540
NC_035785.1,50799426,50805647,50799426,50805647,111101568,XM_022434100.1,uncharacterized LOC111101568,6221
NC_035785.1,27819208,27822700,27819208,27822700,111101569,XM_022434101.1,uncharacterized LOC111101569,3492
NC_035785.1,14126620,14128681,14126620,14128681,111101570,XM_022434102.1,uncharacterized LOC111101570,2061
NC_035785.1,19050668,19053960,19050668,19053960,111101572,XM_022434103.1,uncharacterized LOC111101572,3292
NC_035780.1,10637198,10649002,10637198,10649002,111101576,XM_022434110.1,uncharacterized LOC111101576,11804
NC_035785.1,1063378,1074656,1063378,1074656,111101577,XM_022434107.1,uncharacterized LOC111101577,11278
NC_035785.1,1057218,1063379,1057218,1063379,111101578,XM_022434108.1,uncharacterized LOC111101578,6161
NC_035785.1,46516035,46526270,46516035,46526270,111101582,XM_022434112.1,uncharacterized LOC111101582,10235
NC_035785.1,28706393,28714024,28706393,28709865,111101584,XM_022434114.1,uncharacterized LOC111101584,3472
NC_035785.1,28706393,28714024,28706393,28714024,111101584,XM_022434113.1,uncharacterized LOC111101584,7631
NC_035780.1,40450621,40457335,40450621,40457335,111101587,XM_022434119.1,uncharacterized LOC111101587,6714
NC_035785.1,32024367,32056522,32024367,32038747,111101588,XM_022434121.1,uncharacterized LOC111101588,14380
NC_035785.1,32024367,32056522,32024375,32056522,111101588,XM_022434117.1,uncharacterized LOC111101588,32147
NC_035785.1,32024367,32056522,32024374,32056522,111101588,XM_022434116.1,uncharacterized LOC111101588,32148
NC_035785.1,32024367,32056522,32024370,32056522,111101588,XM_022434118.1,uncharacterized LOC111101588,32152
NC_035785.1,32062051,32075242,32062051,32075242,111101589,XM_022434122.1,uncharacterized LOC111101589,13191
NC_035785.1,11604503,11610856,11604503,11610856,111101591,XM_022434124.1,uncharacterized LOC111101591,6353
NC_035785.1,12228668,12233255,12228668,12233255,111101595,XM_022434128.1,uncharacterized LOC111101595,4587
NC_035785.1,11890097,11892713,11890097,11892713,111101597,XM_022434130.1,uncharacterized LOC111101597,2616
NC_035785.1,38554626,38589314,38554626,38589314,111101599,XM_022434132.1,uncharacterized LOC111101599,34688
NC_035785.1,17626179,17628230,17626179,17628230,111101601,XM_022434134.1,uncharacterized LOC111101601,2051
NC_035785.1,47620010,47626296,47620012,47626296,111101604,XM_022434140.1,uncharacterized LOC111101604,6284
NC_035785.1,47620010,47626296,47620010,47626296,111101604,XM_022434139.1,uncharacterized LOC111101604,6286
NC_035785.1,36965359,36971272,36968658,36971272,111101607,XM_022434149.1,uncharacterized LOC111101607,2614
NC_035785.1,36965359,36971272,36968284,36971272,111101607,XM_022434148.1,uncharacterized LOC111101607,2988
NC_035785.1,36965359,36971272,36967628,36971272,111101607,XM_022434146.1,uncharacterized LOC111101607,3644
NC_035785.1,36965359,36971272,36967034,36971272,111101607,XM_022434147.1,uncharacterized LOC111101607,4238
NC_035785.1,36965359,36971272,36966451,36971272,111101607,XM_022434145.1,uncharacterized LOC111101607,4821
NC_035785.1,36965359,36971272,36965359,36971272,111101607,XM_022434144.1,uncharacterized LOC111101607,5913
NC_035785.1,36959092,36968096,36959092,36962116,111101608,XM_022434150.1,uncharacterized LOC111101608,3024
NC_035785.1,36959092,36968096,36959092,36962321,111101608,XM_022434151.1,uncharacterized LOC111101608,3229
NC_035785.1,36959092,36968096,36959092,36967617,111101608,XM_022434152.1,uncharacterized LOC111101608,8525
NC_035785.1,36959092,36968096,36959092,36968096,111101608,XM_022434154.1,uncharacterized LOC111101608,9004
NC_035785.1,46255304,46270356,46255304,46270356,111101612,XM_022434157.1,uncharacterized LOC111101612,15052
NC_035785.1,46255304,46270356,46261231,46270356,111101612,XM_022434158.1,uncharacterized LOC111101612,9125
NC_035785.1,46255304,46270356,46260874,46270356,111101612,XM_022434159.1,uncharacterized LOC111101612,9482
NC_035785.1,18243879,18250531,18243879,18250531,111101615,XM_022434170.1,uncharacterized LOC111101615,6652
NC_035785.1,67114,70842,67114,70842,111101616,XM_022434171.1,uncharacterized LOC111101616,3728
NC_035785.1,29803886,29805466,29803886,29805466,111101617,XM_022434172.1,uncharacterized LOC111101617,1580
NC_035785.1,47145200,47149305,47145200,47149305,111101618,XM_022434173.1,uncharacterized LOC111101618,4105
NC_035785.1,44375477,44377150,44375477,44377150,111101619,XM_022434175.1,uncharacterized LOC111101619,1673
NC_035785.1,377852,392364,381514,392364,111101620,XM_022434178.1,uncharacterized LOC111101620,10850
NC_035785.1,377852,392364,377852,392364,111101620,XM_022434177.1,uncharacterized LOC111101620,14512
NC_035785.1,20305850,20308988,20305850,20308988,111101621,XM_022434185.1,uncharacterized LOC111101621,3138
NC_035785.1,17071973,17074012,17071973,17074012,111101622,XM_022434186.1,uncharacterized LOC111101622,2039
NC_035785.1,39828310,39857696,39836669,39857696,111101625,XM_022434192.1,uncharacterized LOC111101625,21027
NC_035785.1,39828310,39857696,39828982,39855610,111101625,XM_022434190.1,uncharacterized LOC111101625,26628
NC_035785.1,39828310,39857696,39828983,39857696,111101625,XM_022434189.1,uncharacterized LOC111101625,28713
NC_035785.1,39828310,39857696,39828310,39857696,111101625,XM_022434193.1,uncharacterized LOC111101625,29386
NC_035785.1,5996093,6000327,5998005,6000327,111101631,XM_022434199.1,uncharacterized LOC111101631,2322
NC_035785.1,5996093,6000327,5996093,6000326,111101631,XM_022434198.1,uncharacterized LOC111101631,4233
NC_035785.1,48009449,48019782,48009449,48019782,111101633,XM_022434201.1,uncharacterized LOC111101633,10333
NC_035785.1,45298318,45303625,45298318,45303625,111101634,XM_022434202.1,uncharacterized LOC111101634,5307
NC_035785.1,47427416,47429530,47427416,47429530,111101637,XM_022434205.1,uncharacterized LOC111101637,2114
NC_035785.1,4763479,4767781,4763479,4767781,111101641,XM_022434213.1,uncharacterized LOC111101641,4302
NC_035785.1,7751005,7755489,7751005,7754523,111101643,XM_022434219.1,uncharacterized LOC111101643,3518
NC_035785.1,7751005,7755489,7751005,7755489,111101643,XM_022434218.1,uncharacterized LOC111101643,4484
NC_035785.1,7496119,7500039,7496119,7500033,111101647,XM_022434226.1,uncharacterized LOC111101647,3914
NC_035785.1,7496119,7500039,7496119,7500035,111101647,XM_022434224.1,uncharacterized LOC111101647,3916
NC_035785.1,7496119,7500039,7496119,7500039,111101647,XM_022434225.1,uncharacterized LOC111101647,3920
NC_035785.1,7444956,7447269,7444956,7447269,111101650,XM_022434228.1,uncharacterized LOC111101650,2313
NC_035785.1,7102023,7115779,7102023,7115779,111101651,XM_022434231.1,uncharacterized LOC111101651,13756
NC_035785.1,7484689,7494621,7487928,7494621,111101652,XM_022434233.1,uncharacterized LOC111101652,6693
NC_035785.1,7484689,7494621,7484689,7491986,111101652,XM_022434235.1,uncharacterized LOC111101652,7297
NC_035785.1,6841723,6846855,6841723,6846855,111101653,XM_022434238.1,uncharacterized LOC111101653,5132
NC_035785.1,6801871,6805213,6801871,6805213,111101656,XM_022434240.1,uncharacterized LOC111101656,3342
NC_035785.1,6874865,6883811,6874865,6883811,111101657,XM_022434241.1,uncharacterized LOC111101657,8946
NC_035785.1,7076608,7080526,7076608,7079290,111101658,XM_022434244.1,uncharacterized LOC111101658,2682
NC_035785.1,7360727,7366044,7363508,7366044,111101659,XM_022434245.1,uncharacterized LOC111101659,2536
NC_035785.1,7360727,7366044,7362385,7366041,111101659,XM_022434246.1,uncharacterized LOC111101659,3656
NC_035785.1,7195880,7197120,7195880,7197120,111101660,XM_022434248.1,uncharacterized LOC111101660,1240
NC_035785.1,7257775,7261150,7257775,7261150,111101661,XM_022434249.1,uncharacterized LOC111101661,3375
NC_035780.1,59680734,59684049,59680734,59684049,111101662,XM_022434255.1,uncharacterized LOC111101662,3315
NC_035785.1,7415922,7416765,7415922,7416724,111101663,XM_022434250.1,uncharacterized LOC111101663,802
NC_035785.1,7415922,7416765,7415922,7416765,111101663,XM_022434251.1,uncharacterized LOC111101663,843
NC_035785.1,6840363,6841599,6840363,6841599,111101664,XM_022434253.1,uncharacterized LOC111101664,1236
NC_035785.1,6860681,6861422,6860681,6861422,111101665,XM_022434256.1,uncharacterized LOC111101665,741
NC_035785.1,1325602,1338676,1325602,1338676,111101677,XM_022434260.1,uncharacterized LOC111101677,13074
NC_035785.1,11002100,11029767,11002100,11029767,111101678,XM_022434261.1,uncharacterized LOC111101678,27667
NC_035780.1,38744011,38753199,38744011,38753199,111101681,XM_022434268.1,uncharacterized LOC111101681,9188
NC_035785.1,49025099,49026685,49025099,49026685,111101694,XM_022434278.1,uncharacterized LOC111101694,1586
NC_035785.1,27570334,27580923,27570334,27580923,111101695,XM_022434279.1,uncharacterized LOC111101695,10589
NC_035785.1,33724561,33737504,33724561,33737504,111101697,XM_022434281.1,uncharacterized LOC111101697,12943
NC_035785.1,41419988,41421361,41419988,41421361,111101698,XM_022434282.1,uncharacterized LOC111101698,1373
NC_035785.1,37968725,37972033,37968725,37972033,111101699,XM_022434284.1,uncharacterized LOC111101699,3308
NC_035785.1,8882260,8884976,8882260,8884976,111101700,XM_022434285.1,uncharacterized LOC111101700,2716
NC_035785.1,44851097,44861950,44851097,44861950,111101702,XM_022434287.1,uncharacterized LOC111101702,10853
NC_035785.1,33017547,33022534,33017547,33022534,111101703,XM_022434288.1,uncharacterized LOC111101703,4987
NC_035785.1,45640132,45646136,45640132,45646136,111101704,XM_022434289.1,uncharacterized LOC111101704,6004
NC_035785.1,38695121,38702753,38695121,38702753,111101709,XM_022434291.1,uncharacterized LOC111101709,7632
NC_035785.1,48350878,48364156,48350878,48364156,111101713,XM_022434299.1,uncharacterized LOC111101713,13278
NC_035785.1,6568440,6577938,6568440,6577938,111101714,XM_022434300.1,uncharacterized LOC111101714,9498
NC_035785.1,4861011,4866233,4861011,4866233,111101715,XM_022434302.1,uncharacterized LOC111101715,5222
NC_035780.1,52267410,52279262,52267410,52279262,111101718,XM_022434309.1,uncharacterized LOC111101718,11852
NC_035785.1,20269110,20280358,20269110,20280358,111101719,XM_022434310.1,uncharacterized LOC111101719,11248
NC_035785.1,33210847,33212651,33210847,33212651,111101721,XM_022434313.1,uncharacterized LOC111101721,1804
NC_035785.1,44170525,44192234,44170525,44192234,111101722,XM_022434314.1,uncharacterized LOC111101722,21709
NC_035785.1,12023427,12024960,12023427,12024960,111101724,XM_022434315.1,uncharacterized LOC111101724,1533
NC_035785.1,22767616,22771033,22767616,22771021,111101727,XM_022434316.1,uncharacterized LOC111101727,3405
NC_035785.1,22767616,22771033,22767616,22771033,111101727,XM_022434317.1,uncharacterized LOC111101727,3417
NC_035785.1,1273598,1283469,1273598,1283469,111101728,XM_022434318.1,uncharacterized LOC111101728,9871
NC_035785.1,31672141,31678263,31672141,31678263,111101731,XM_022434321.1,uncharacterized LOC111101731,6122
NC_035785.1,50709229,50715788,50709229,50715788,111101734,XM_022434323.1,uncharacterized LOC111101734,6559
NC_035780.1,13308671,13312617,13308671,13312617,111101737,XM_022434330.1,uncharacterized LOC111101737,3946
NC_035785.1,49527409,49530621,49527409,49530621,111101739,XM_022434332.1,uncharacterized LOC111101739,3212
NC_035785.1,9677874,9680849,9677874,9680849,111101740,XM_022434333.1,uncharacterized LOC111101740,2975
NC_035785.1,16649452,16652147,16649453,16652146,111101741,XM_022434334.1,uncharacterized LOC111101741,2693
NC_035785.1,16649452,16652147,16649452,16652147,111101741,XM_022434335.1,uncharacterized LOC111101741,2695
NC_035785.1,33669022,33672050,33669022,33672050,111101745,XM_022434340.1,uncharacterized LOC111101745,3028
NC_035785.1,48928721,48936039,48928852,48936039,111101750,XM_022434345.1,uncharacterized LOC111101750,7187
NC_035785.1,48928721,48936039,48928830,48936039,111101750,XM_022434348.1,uncharacterized LOC111101750,7209
NC_035785.1,48928721,48936039,48928762,48936039,111101750,XM_022434349.1,uncharacterized LOC111101750,7277
NC_035785.1,48928721,48936039,48928758,48936039,111101750,XM_022434346.1,uncharacterized LOC111101750,7281
NC_035785.1,48928721,48936039,48928721,48936039,111101750,XM_022434347.1,uncharacterized LOC111101750,7318
NC_035780.1,41898186,41901071,41898205,41901071,111101751,XM_022434357.1,uncharacterized LOC111101751,2866
NC_035780.1,41898186,41901071,41898186,41901071,111101751,XM_022434353.1,uncharacterized LOC111101751,2885
NC_035785.1,4078571,4093644,4078571,4093644,111101752,XM_022434351.1,uncharacterized LOC111101752,15073
NC_035785.1,40222604,40262253,40222604,40262253,111101753,XM_022434354.1,uncharacterized LOC111101753,39649
NC_035785.1,40203824,40233426,40203824,40228287,111101754,XM_022434355.1,uncharacterized LOC111101754,24463
NC_035785.1,47323279,47325082,47323279,47325081,111101759,XM_022434358.1,uncharacterized LOC111101759,1802
NC_035785.1,47323279,47325082,47323279,47325082,111101759,XM_022434359.1,uncharacterized LOC111101759,1803
NC_035785.1,23767538,23769939,23767538,23769939,111101760,XM_022434360.1,uncharacterized LOC111101760,2401
NC_035785.1,6373421,6390504,6374303,6390504,111101767,XM_022434369.1,uncharacterized LOC111101767,16201
NC_035785.1,6373421,6390504,6373421,6390502,111101767,XM_022434370.1,uncharacterized LOC111101767,17081
NC_035785.1,41115511,41117337,41115511,41117337,111101768,XM_022434371.1,uncharacterized LOC111101768,1826
NC_035785.1,32881743,32886655,32881743,32886651,111101772,XM_022434375.1,uncharacterized LOC111101772,4908
NC_035785.1,32881743,32886655,32881743,32886655,111101772,XM_022434376.1,uncharacterized LOC111101772,4912
NC_035785.1,35554211,35565584,35554211,35565584,111101774,XM_022434377.1,uncharacterized LOC111101774,11373
NC_035785.1,21530523,21533924,21530523,21533924,111101778,XM_022434381.1,uncharacterized LOC111101778,3401
NC_035785.1,39872200,39875594,39872200,39875594,111101780,XM_022434383.1,uncharacterized LOC111101780,3394
NC_035780.1,40438370,40441582,40438370,40441582,111101782,XM_022434388.1,uncharacterized LOC111101782,3212
NC_035785.1,23734377,23739760,23734377,23739760,111101783,XM_022434386.1,uncharacterized LOC111101783,5383
NC_035785.1,20027347,20043090,20027347,20043090,111101793,XM_022434398.1,uncharacterized LOC111101793,15743
NC_035785.1,38378832,38381684,38378832,38381684,111101794,XM_022434399.1,uncharacterized LOC111101794,2852
NC_035785.1,25010100,25012589,25010100,25012589,111101796,XM_022434401.1,uncharacterized LOC111101796,2489
NC_035785.1,23644610,23646970,23644610,23646970,111101798,XM_022434403.1,uncharacterized LOC111101798,2360
NC_035785.1,45239021,45264034,45239021,45264034,111101803,XM_022434409.1,uncharacterized LOC111101803,25013
NC_035785.1,5974923,5982697,5974923,5982697,111101804,XM_022434410.1,uncharacterized LOC111101804,7774
NC_035785.1,40322864,40327823,40322864,40327823,111101806,XM_022434412.1,uncharacterized LOC111101806,4959
NC_035780.1,23384222,23386381,23384222,23386378,111101809,XM_022434417.1,uncharacterized LOC111101809,2156
NC_035780.1,23384222,23386381,23384222,23386381,111101809,XM_022434426.1,uncharacterized LOC111101809,2159
NC_035785.1,34447803,34451728,34447803,34449749,111101810,XM_022434416.1,uncharacterized LOC111101810,1946
NC_035785.1,34447803,34451728,34447803,34450286,111101810,XM_022434415.1,uncharacterized LOC111101810,2483
NC_035785.1,27674547,27679833,27676219,27679829,111101812,XM_022434419.1,uncharacterized LOC111101812,3610
NC_035785.1,27674547,27679833,27676210,27679828,111101812,XM_022434418.1,uncharacterized LOC111101812,3618
NC_035785.1,17529464,17569558,17535030,17566653,111101815,XM_022434427.1,uncharacterized LOC111101815,31623
NC_035785.1,17529464,17569558,17535029,17566653,111101815,XM_022434430.1,uncharacterized LOC111101815,31624
NC_035785.1,17529464,17569558,17535030,17569558,111101815,XM_022434428.1,uncharacterized LOC111101815,34528
NC_035785.1,17529464,17569558,17529464,17566653,111101815,XM_022434429.1,uncharacterized LOC111101815,37189
NC_035785.1,17503129,17520528,17503129,17520115,111101816,XM_022434432.1,uncharacterized LOC111101816,16986
NC_035785.1,17503129,17520528,17503129,17520528,111101816,XM_022434431.1,uncharacterized LOC111101816,17399
NC_035785.1,17586535,17605303,17586535,17605303,111101817,XM_022434433.1,uncharacterized LOC111101817,18768
NC_035780.1,44196974,44219218,44196974,44219218,111101819,XM_022434439.1,uncharacterized LOC111101819,22244
NC_035785.1,17542806,17545310,17542806,17545310,111101821,XM_022434440.1,uncharacterized LOC111101821,2504
NC_035785.1,46066417,46079599,46066417,46079599,111101824,XM_022434445.1,uncharacterized LOC111101824,13182
NC_035785.1,38644253,38683377,38644253,38683377,111101829,XM_022434447.1,uncharacterized LOC111101829,39124
NC_035785.1,48795934,48801182,48795934,48801182,111101831,XM_022434451.1,uncharacterized LOC111101831,5248
NC_035785.1,41033975,41045222,41033975,41045222,111101834,XM_022434455.1,uncharacterized LOC111101834,11247
NC_035785.1,29267874,29275766,29267874,29275766,111101843,XM_022434461.1,uncharacterized LOC111101843,7892
NC_035785.1,44071771,44076788,44071771,44076788,111101844,XM_022434462.1,uncharacterized LOC111101844,5017
NC_035785.1,49338728,49341669,49338728,49341574,111101845,XM_022434464.1,uncharacterized LOC111101845,2846
NC_035785.1,49338728,49341669,49338728,49341669,111101845,XM_022434463.1,uncharacterized LOC111101845,2941
NC_035785.1,47593363,47596733,47593363,47596733,111101846,XM_022434465.1,uncharacterized LOC111101846,3370
NC_035785.1,40965054,41005631,40979687,41005631,111101853,XM_022434478.1,uncharacterized LOC111101853,25944
NC_035785.1,40965054,41005631,41003000,41005631,111101853,XM_022434480.1,uncharacterized LOC111101853,2631
NC_035785.1,40965054,41005631,40965054,41005631,111101853,XM_022434481.1,uncharacterized LOC111101853,40577
NC_035785.1,3407034,3409564,3407034,3409564,111101866,XM_022434501.1,uncharacterized LOC111101866,2530
NC_035785.1,48838684,48839557,48838776,48839557,111101869,XM_022434504.1,uncharacterized LOC111101869,781
NC_035785.1,29832311,29839578,29832311,29839578,111101873,XM_022434511.1,uncharacterized LOC111101873,7267
NC_035785.1,26586836,26603233,26586836,26603233,111101874,XM_022434512.1,uncharacterized LOC111101874,16397
NC_035785.1,28833350,28838665,28833350,28838665,111101875,XM_022434514.1,uncharacterized LOC111101875,5315
NC_035780.1,58600125,58603223,58600125,58603223,111101877,XM_022434526.1,uncharacterized LOC111101877,3098
NC_035785.1,27827271,27866172,27827271,27866172,111101882,XM_022434528.1,uncharacterized LOC111101882,38901
NC_035785.1,38136031,38139075,38136031,38139069,111101888,XM_022434538.1,uncharacterized LOC111101888,3038
NC_035785.1,36615556,36628187,36615556,36626430,111101893,XM_022434545.1,uncharacterized LOC111101893,10874
NC_035785.1,36615556,36628187,36615556,36628187,111101893,XM_022434543.1,uncharacterized LOC111101893,12631
NC_035780.1,48533401,48540483,48533401,48539499,111101894,XM_022434556.1,uncharacterized LOC111101894,6098
NC_035780.1,48533401,48540483,48533401,48539581,111101894,XM_022434563.1,uncharacterized LOC111101894,6180
NC_035780.1,48533401,48540483,48533401,48540483,111101894,XM_022434548.1,uncharacterized LOC111101894,7082
NC_035785.1,8975304,8994363,8975304,8994363,111101897,XM_022434551.1,uncharacterized LOC111101897,19059
NC_035785.1,9034594,9035490,9034594,9035490,111101898,XM_022434552.1,uncharacterized LOC111101898,896
NC_035785.1,9177254,9178927,9177254,9178927,111101899,XM_022434553.1,uncharacterized LOC111101899,1673
NC_035785.1,9186980,9188275,9186980,9188275,111101900,XM_022434554.1,uncharacterized LOC111101900,1295
NC_035785.1,9394757,9395221,9394757,9395221,111101905,XM_022434559.1,uncharacterized LOC111101905,464
NC_035785.1,9475125,9477397,9475125,9477397,111101906,XM_022434560.1,uncharacterized LOC111101906,2272
NC_035785.1,9501791,9503700,9501791,9503700,111101907,XM_022434561.1,uncharacterized LOC111101907,1909
NC_035785.1,9511558,9512538,9511558,9512538,111101908,XM_022434562.1,uncharacterized LOC111101908,980
NC_035785.1,9520407,9521062,9520407,9521062,111101909,XM_022434564.1,uncharacterized LOC111101909,655
NC_035785.1,9616592,9618273,9616592,9618273,111101910,XM_022434565.1,uncharacterized LOC111101910,1681
NC_035785.1,9618743,9623795,9618743,9623795,111101911,XM_022434566.1,uncharacterized LOC111101911,5052
NC_035785.1,9806375,9810140,9806375,9810140,111101912,XM_022434567.1,uncharacterized LOC111101912,3765
NC_035785.1,9909825,9911083,9909825,9911083,111101913,XM_022434568.1,uncharacterized LOC111101913,1258
NC_035785.1,9913894,9917912,9913894,9917912,111101914,XM_022434569.1,uncharacterized LOC111101914,4018
NC_035785.1,11124561,11127748,11124561,11127748,111101918,XM_022434572.1,uncharacterized LOC111101918,3187
NC_035785.1,11270141,11296744,11270141,11296744,111101919,XM_022434573.1,uncharacterized LOC111101919,26603
NC_035785.1,11376230,11385354,11376230,11385354,111101920,XM_022434574.1,uncharacterized LOC111101920,9124
NC_035785.1,11551614,11561867,11551614,11561867,111101921,XM_022434575.1,uncharacterized LOC111101921,10253
NC_035785.1,11787408,11789786,11787408,11789786,111101923,XM_022434577.1,uncharacterized LOC111101923,2378
NC_035785.1,11806695,11812334,11806695,11812334,111101924,XM_022434578.1,uncharacterized LOC111101924,5639
NC_035785.1,12149060,12151180,12149060,12151180,111101927,XM_022434580.1,uncharacterized LOC111101927,2120
NC_035785.1,12157923,12166240,12157923,12166240,111101928,XM_022434581.1,uncharacterized LOC111101928,8317
NC_035785.1,12475488,12476871,12475488,12476871,111101932,XM_022434585.1,uncharacterized LOC111101932,1383
NC_035780.1,65580707,65606822,65580707,65606822,111101935,XM_022434591.1,uncharacterized LOC111101935,26115
NC_035785.1,13605179,13605912,13605179,13605912,111101936,XM_022434588.1,uncharacterized LOC111101936,733
NC_035785.1,13715841,13748580,13715841,13748580,111101937,XM_022434589.1,uncharacterized LOC111101937,32739
NC_035785.1,14160413,14165201,14160413,14165201,111101939,XM_022434592.1,uncharacterized LOC111101939,4788
NC_035785.1,14167531,14169556,14167531,14169556,111101940,XM_022434593.1,uncharacterized LOC111101940,2025
NC_035785.1,14272437,14273981,14272437,14273981,111101941,XM_022434594.1,uncharacterized LOC111101941,1544
NC_035785.1,14289418,14304500,14289418,14304500,111101942,XM_022434595.1,uncharacterized LOC111101942,15082
NC_035785.1,14800710,14801414,14800710,14801414,111101944,XM_022434597.1,uncharacterized LOC111101944,704
NC_035785.1,15379359,15380099,15379359,15380099,111101945,XM_022434598.1,uncharacterized LOC111101945,740
NC_035780.1,65471685,65555896,65471698,65503224,111101946,XM_022434608.1,uncharacterized LOC111101946,31526
NC_035780.1,65471685,65555896,65471697,65555743,111101946,XM_022434616.1,uncharacterized LOC111101946,84046
NC_035780.1,65471685,65555896,65471685,65555896,111101946,XM_022434601.1,uncharacterized LOC111101946,84211
NC_035785.1,15385049,15386693,15385049,15386693,111101947,XM_022434599.1,uncharacterized LOC111101947,1644
NC_035785.1,15390479,15392115,15390479,15392115,111101948,XM_022434600.1,uncharacterized LOC111101948,1636
NC_035785.1,15397896,15398579,15397896,15398579,111101949,XM_022434602.1,uncharacterized LOC111101949,683
NC_035785.1,15444178,15445851,15444178,15445851,111101950,XM_022434603.1,uncharacterized LOC111101950,1673
NC_035785.1,15446284,15449380,15446284,15449380,111101951,XM_022434604.1,uncharacterized LOC111101951,3096
NC_035785.1,15469733,15471346,15469733,15471346,111101952,XM_022434605.1,uncharacterized LOC111101952,1613
NC_035785.1,15618584,15621302,15618584,15621302,111101954,XM_022434607.1,uncharacterized LOC111101954,2718
NC_035785.1,15778193,15779557,15778193,15779557,111101955,XM_022434609.1,uncharacterized LOC111101955,1364
NC_035785.1,15846458,15848837,15846458,15848837,111101956,XM_022434610.1,uncharacterized LOC111101956,2379
NC_035785.1,16121249,16121671,16121249,16121671,111101959,XM_022434613.1,uncharacterized LOC111101959,422
NC_035785.1,16154979,16156571,16154979,16156571,111101960,XM_022434614.1,uncharacterized LOC111101960,1592
NC_035785.1,16530945,16549875,16530945,16549875,111101965,XM_022434620.1,uncharacterized LOC111101965,18930
NC_035785.1,16587894,16593092,16587894,16593092,111101966,XM_022434621.1,uncharacterized LOC111101966,5198
NC_035785.1,16632964,16637387,16632964,16637387,111101967,XM_022434622.1,uncharacterized LOC111101967,4423
NC_035780.1,65621638,65645891,65621638,65645891,111101969,XM_022434626.1,uncharacterized LOC111101969,24253
NC_035785.1,16892350,16983036,16892350,16983036,111101970,XM_022434624.1,uncharacterized LOC111101970,90686
NC_035785.1,17033529,17035121,17033529,17035121,111101971,XM_022434625.1,uncharacterized LOC111101971,1592
NC_035785.1,17197580,17215792,17197580,17215792,111101973,XM_022434628.1,uncharacterized LOC111101973,18212
NC_035785.1,17276685,17284224,17276685,17284224,111101974,XM_022434629.1,uncharacterized LOC111101974,7539
NC_035785.1,17412250,17436729,17412250,17436729,111101975,XM_022434630.1,uncharacterized LOC111101975,24479
NC_035785.1,17837480,17840475,17837480,17840475,111101976,XM_022434631.1,uncharacterized LOC111101976,2995
NC_035785.1,17852641,17866799,17852641,17866799,111101977,XM_022434632.1,uncharacterized LOC111101977,14158
NC_035785.1,18140327,18146316,18140327,18146316,111101982,XM_022434636.1,uncharacterized LOC111101982,5989
NC_035785.1,18366180,18373009,18366180,18373009,111101985,XM_022434639.1,uncharacterized LOC111101985,6829
NC_035785.1,18468000,18469215,18468000,18469215,111101986,XM_022434640.1,uncharacterized LOC111101986,1215
NC_035785.1,18526097,18527812,18526097,18527812,111101987,XM_022434641.1,uncharacterized LOC111101987,1715
NC_035785.1,18693576,18694277,18693576,18694277,111101988,XM_022434642.1,uncharacterized LOC111101988,701
NC_035785.1,19001132,19002370,19001132,19002370,111101990,XM_022434644.1,uncharacterized LOC111101990,1238
NC_035785.1,19039146,19044152,19039146,19044152,111101991,XM_022434646.1,uncharacterized LOC111101991,5006
NC_035785.1,19183089,19187727,19183089,19187727,111101994,XM_022434649.1,uncharacterized LOC111101994,4638
NC_035785.1,19528424,19529401,19528424,19529401,111101995,XM_022434650.1,uncharacterized LOC111101995,977
NC_035785.1,19879730,19885940,19879730,19885940,111101996,XM_022434651.1,uncharacterized LOC111101996,6210
NC_035785.1,19942632,19947304,19942632,19947304,111101999,XM_022434653.1,uncharacterized LOC111101999,4672
NC_035785.1,19987972,19998446,19987972,19998446,111102000,XM_022434654.1,uncharacterized LOC111102000,10474
NC_035785.1,20214991,20217701,20214991,20217701,111102001,XM_022434655.1,uncharacterized LOC111102001,2710
NC_035785.1,20654537,20656811,20654537,20656811,111102007,XM_022434661.1,uncharacterized LOC111102007,2274
NC_035785.1,20657329,20673872,20657329,20673872,111102008,XM_022434662.1,uncharacterized LOC111102008,16543
NC_035780.1,65538924,65540902,65538924,65540902,111102009,XM_022434666.1,uncharacterized LOC111102009,1978
NC_035785.1,20684036,20688001,20684036,20688001,111102010,XM_022434663.1,uncharacterized LOC111102010,3965
NC_035785.1,20797790,20799139,20797790,20799139,111102012,XM_022434665.1,uncharacterized LOC111102012,1349
NC_035785.1,20811741,20812286,20811741,20812286,111102013,XM_022434667.1,uncharacterized LOC111102013,545
NC_035785.1,20862387,20865818,20862387,20865818,111102014,XM_022434668.1,uncharacterized LOC111102014,3431
NC_035785.1,21153917,21156641,21153917,21156641,111102015,XM_022434669.1,uncharacterized LOC111102015,2724
NC_035785.1,21249222,21251205,21249222,21251205,111102016,XM_022434670.1,uncharacterized LOC111102016,1983
NC_035785.1,21317671,21320305,21317671,21320305,111102017,XM_022434671.1,uncharacterized LOC111102017,2634
NC_035785.1,21743293,21749504,21743293,21749504,111102023,XM_022434677.1,uncharacterized LOC111102023,6211
NC_035785.1,22071582,22080091,22071582,22080091,111102026,XM_022434681.1,uncharacterized LOC111102026,8509
NC_035785.1,22806757,22811741,22806757,22811741,111102027,XM_022434682.1,uncharacterized LOC111102027,4984
NC_035785.1,23010939,23012980,23010939,23012980,111102028,XM_022434684.1,uncharacterized LOC111102028,2041
NC_035785.1,23354699,23365664,23354699,23365664,111102030,XM_022434686.1,uncharacterized LOC111102030,10965
NC_035785.1,23370662,23372761,23370662,23372761,111102031,XM_022434687.1,uncharacterized LOC111102031,2099
NC_035785.1,23484665,23487827,23484665,23487827,111102033,XM_022434689.1,uncharacterized LOC111102033,3162
NC_035785.1,23772684,23777848,23772684,23777848,111102037,XM_022434692.1,uncharacterized LOC111102037,5164
NC_035785.1,23879808,23886983,23879808,23886983,111102042,XM_022434696.1,uncharacterized LOC111102042,7175
NC_035780.1,11278499,11287767,11278499,11287767,111102044,XM_022434700.1,uncharacterized LOC111102044,9268
NC_035785.1,24211080,24212292,24211080,24212292,111102045,XM_022434698.1,uncharacterized LOC111102045,1212
NC_035785.1,24588953,24593548,24588953,24593548,111102048,XM_022434702.1,uncharacterized LOC111102048,4595
NC_035785.1,24595753,24597041,24595753,24597041,111102049,XM_022434703.1,uncharacterized LOC111102049,1288
NC_035785.1,24596635,24604252,24596635,24604252,111102050,XM_022434704.1,uncharacterized LOC111102050,7617
NC_035785.1,24614757,24620501,24614757,24620501,111102051,XM_022434705.1,uncharacterized LOC111102051,5744
NC_035785.1,25507141,25512186,25507141,25512186,111102057,XM_022434710.1,uncharacterized LOC111102057,5045
NC_035785.1,25848548,25856207,25848548,25856207,111102059,XM_022434712.1,uncharacterized LOC111102059,7659
NC_035785.1,25939793,25941438,25939793,25941438,111102060,XM_022434713.1,uncharacterized LOC111102060,1645
NC_035785.1,26170104,26238980,26170104,26238980,111102063,XM_022434716.1,uncharacterized LOC111102063,68876
NC_035785.1,26441473,26443687,26441473,26443687,111102066,XM_022434718.1,uncharacterized LOC111102066,2214
NC_035785.1,26529339,26535181,26529339,26535181,111102067,XM_022434720.1,uncharacterized LOC111102067,5842
NC_035785.1,26706319,26719177,26706319,26719177,111102068,XM_022434721.1,uncharacterized LOC111102068,12858
NC_035785.1,26870827,26873151,26870827,26873151,111102070,XM_022434722.1,uncharacterized LOC111102070,2324
NC_035785.1,27035923,27182703,27035923,27182703,111102071,XM_022434723.1,uncharacterized LOC111102071,146780
NC_035785.1,27622531,27623910,27622531,27623910,111102078,XM_022434729.1,uncharacterized LOC111102078,1379
NC_035785.1,27721924,27722641,27721924,27722641,111102080,XM_022434731.1,uncharacterized LOC111102080,717
NC_035780.1,53216237,53219921,53216237,53219921,111102081,XM_022434735.1,uncharacterized LOC111102081,3684
NC_035785.1,28070360,28071223,28070360,28071223,111102083,XM_022434733.1,uncharacterized LOC111102083,863
NC_035780.1,6137421,6148478,6137421,6148478,111102085,XM_022434769.1,uncharacterized LOC111102085,11057
NC_035785.1,28281937,28287874,28281937,28287874,111102086,XM_022434736.1,uncharacterized LOC111102086,5937
NC_035785.1,28574717,28577296,28574717,28577296,111102087,XM_022434737.1,uncharacterized LOC111102087,2579
NC_035785.1,28849083,28853171,28849083,28853171,111102090,XM_022434741.1,uncharacterized LOC111102090,4088
NC_035785.1,29625557,29637688,29625557,29637688,111102094,XM_022434744.1,uncharacterized LOC111102094,12131
NC_035785.1,29639626,29654385,29639626,29654385,111102095,XM_022434745.1,uncharacterized LOC111102095,14759
NC_035785.1,30043993,30074271,30043993,30074271,111102099,XM_022434750.1,uncharacterized LOC111102099,30278
NC_035785.1,30076082,30084627,30076082,30084627,111102100,XM_022434751.1,uncharacterized LOC111102100,8545
NC_035785.1,30271591,30335217,30271591,30335217,111102103,XM_022434755.1,uncharacterized LOC111102103,63626
NC_035785.1,30359422,30378237,30359422,30378237,111102104,XM_022434756.1,uncharacterized LOC111102104,18815
NC_035785.1,30423438,30427376,30423438,30427376,111102107,XM_022434759.1,uncharacterized LOC111102107,3938
NC_035785.1,31337916,31361900,31337916,31361900,111102109,XM_022434762.1,uncharacterized LOC111102109,23984
NC_035785.1,31617308,31618721,31617308,31618721,111102111,XM_022434764.1,uncharacterized LOC111102111,1413
NC_035785.1,32001568,32019888,32001568,32019888,111102113,XM_022434766.1,uncharacterized LOC111102113,18320
NC_035780.1,53992273,53995705,53992273,53995705,111102114,XM_022434770.1,uncharacterized LOC111102114,3432
NC_035785.1,32591010,32592233,32591010,32592233,111102116,XM_022434768.1,uncharacterized LOC111102116,1223
NC_035785.1,33406908,33407669,33406908,33407669,111102120,XM_022434771.1,uncharacterized LOC111102120,761
NC_035785.1,33594026,33595785,33594026,33595785,111102121,XM_022434772.1,uncharacterized LOC111102121,1759
NC_035785.1,33860472,33863486,33860472,33863486,111102122,XM_022434773.1,uncharacterized LOC111102122,3014
NC_035780.1,55641540,55664462,55641540,55664462,111102125,XM_022434777.1,uncharacterized LOC111102125,22922
NC_035785.1,34471125,34471808,34471125,34471808,111102126,XM_022434776.1,uncharacterized LOC111102126,683
NC_035785.1,34896874,34899998,34896874,34899998,111102131,XM_022434782.1,uncharacterized LOC111102131,3124
NC_035785.1,35418434,35438386,35418434,35438386,111102133,XM_022434784.1,uncharacterized LOC111102133,19952
NC_035785.1,35568667,35570929,35568667,35570929,111102136,XM_022434786.1,uncharacterized LOC111102136,2262
NC_035785.1,36038458,36048850,36038458,36048850,111102138,XM_022434788.1,uncharacterized LOC111102138,10392
NC_035785.1,36927623,36928107,36927623,36928107,111102141,XM_022434791.1,uncharacterized LOC111102141,484
NC_035785.1,37003775,37012375,37003775,37012375,111102142,XM_022434792.1,uncharacterized LOC111102142,8600
NC_035785.1,37492138,37506645,37492138,37506645,111102143,XM_022434793.1,uncharacterized LOC111102143,14507
NC_035780.1,43344181,43352848,43345198,43352848,111102144,XM_022434797.1,uncharacterized LOC111102144,7650
NC_035780.1,43344181,43352848,43345019,43352847,111102144,XM_022434811.1,uncharacterized LOC111102144,7828
NC_035780.1,43344181,43352848,43344181,43352847,111102144,XM_022434803.1,uncharacterized LOC111102144,8666
NC_035785.1,38043741,38105330,38043741,38105330,111102148,XM_022434798.1,uncharacterized LOC111102148,61589
NC_035785.1,38302018,38303211,38302018,38303211,111102149,XM_022434799.1,uncharacterized LOC111102149,1193
NC_035780.1,18266853,18268020,18266853,18268020,111102150,XM_022435168.1,uncharacterized LOC111102150,1167
NC_035785.1,39502993,39506480,39502993,39506480,111102155,XM_022434805.1,uncharacterized LOC111102155,3487
NC_035785.1,39506984,39508573,39506984,39508573,111102156,XM_022434806.1,uncharacterized LOC111102156,1589
NC_035785.1,39690119,39694643,39690119,39694643,111102157,XM_022434807.1,uncharacterized LOC111102157,4524
NC_035785.1,39818002,39819661,39818002,39819661,111102158,XM_022434808.1,uncharacterized LOC111102158,1659
NC_035785.1,39948201,39949358,39948201,39949358,111102160,XM_022434810.1,uncharacterized LOC111102160,1157
NC_035785.1,40129943,40149281,40129943,40149281,111102161,XM_022434812.1,uncharacterized LOC111102161,19338
NC_035785.1,40170976,40176654,40170976,40176654,111102162,XM_022434813.1,uncharacterized LOC111102162,5678
NC_035785.1,41052700,41053551,41052700,41053551,111102165,XM_022434816.1,uncharacterized LOC111102165,851
NC_035785.1,41068583,41069308,41068583,41069308,111102166,XM_022434817.1,uncharacterized LOC111102166,725
NC_035785.1,41332863,41351561,41332863,41351561,111102171,XM_022434822.1,uncharacterized LOC111102171,18698
NC_035785.1,41365624,41367352,41365624,41367352,111102172,XM_022434823.1,uncharacterized LOC111102172,1728
NC_035785.1,41368186,41373838,41368186,41373838,111102173,XM_022434824.1,uncharacterized LOC111102173,5652
NC_035785.1,41417686,41419005,41417686,41419005,111102174,XM_022434825.1,uncharacterized LOC111102174,1319
NC_035785.1,41674702,41675553,41674702,41675553,111102175,XM_022434826.1,uncharacterized LOC111102175,851
NC_035785.1,41865035,41878411,41865035,41878411,111102176,XM_022434827.1,uncharacterized LOC111102176,13376
NC_035785.1,42161910,42167642,42161910,42167642,111102177,XM_022434828.1,uncharacterized LOC111102177,5732
NC_035785.1,42329078,42362689,42329078,42362689,111102179,XM_022434831.1,uncharacterized LOC111102179,33611
NC_035785.1,43317092,43331560,43317092,43331560,111102180,XM_022434832.1,uncharacterized LOC111102180,14468
NC_035785.1,43588533,43589216,43588533,43589216,111102182,XM_022434834.1,uncharacterized LOC111102182,683
NC_035780.1,38757410,38758680,38757410,38758680,111102184,XM_022434845.1,uncharacterized LOC111102184,1270
NC_035785.1,43855794,43857353,43855794,43857353,111102185,XM_022434835.1,uncharacterized LOC111102185,1559
NC_035785.1,43931217,43934441,43931217,43934441,111102186,XM_022434836.1,uncharacterized LOC111102186,3224
NC_035785.1,44081272,44085243,44081272,44085243,111102187,XM_022434837.1,uncharacterized LOC111102187,3971
NC_035785.1,44210166,44211117,44210166,44211117,111102189,XM_022434840.1,uncharacterized LOC111102189,951
NC_035785.1,44947827,44950439,44947827,44950439,111102191,XM_022434842.1,uncharacterized LOC111102191,2612
NC_035785.1,44977380,44979708,44977380,44979708,111102193,XM_022434844.1,uncharacterized LOC111102193,2328
NC_035785.1,45388389,45394208,45388389,45394208,111102195,XM_022434847.1,uncharacterized LOC111102195,5819
NC_035785.1,45763250,45777082,45763250,45777082,111102197,XM_022434849.1,uncharacterized LOC111102197,13832
NC_035780.1,29241673,29256145,29241673,29256145,111102200,XM_022434855.1,uncharacterized LOC111102200,14472
NC_035785.1,46433247,46462450,46433247,46462450,111102201,XM_022434852.1,uncharacterized LOC111102201,29203
NC_035785.1,46767682,46777493,46767682,46777493,111102202,XM_022434853.1,uncharacterized LOC111102202,9811
NC_035785.1,46848756,46908142,46848756,46908142,111102203,XM_022434854.1,uncharacterized LOC111102203,59386
NC_035785.1,47694308,47720042,47694308,47720042,111102206,XM_022434858.1,uncharacterized LOC111102206,25734
NC_035785.1,47767656,47795306,47767656,47795306,111102207,XM_022434859.1,uncharacterized LOC111102207,27650
NC_035785.1,47910249,47913904,47910249,47913904,111102208,XM_022434860.1,uncharacterized LOC111102208,3655
NC_035785.1,48026567,48029502,48026567,48029502,111102209,XM_022434861.1,uncharacterized LOC111102209,2935
NC_035785.1,48047476,48065480,48047476,48065480,111102210,XM_022434862.1,uncharacterized LOC111102210,18004
NC_035785.1,48082609,48089088,48082609,48089088,111102212,XM_022434863.1,uncharacterized LOC111102212,6479
NC_035785.1,48792581,48809264,48792581,48809264,111102216,XM_022434868.1,uncharacterized LOC111102216,16683
NC_035785.1,48835659,48837734,48835659,48837734,111102217,XM_022434869.1,uncharacterized LOC111102217,2075
NC_035780.1,35512800,35514202,35512800,35514202,111102221,XM_022434876.1,uncharacterized LOC111102221,1402
NC_035785.1,49840069,49848567,49840069,49848567,111102222,XM_022434874.1,uncharacterized LOC111102222,8498
NC_035785.1,50124815,50125972,50124815,50125972,111102225,XM_022434878.1,uncharacterized LOC111102225,1157
NC_035785.1,50581727,50582269,50581727,50582269,111102227,XM_022434880.1,uncharacterized LOC111102227,542
NC_035785.1,50658047,50661146,50658047,50661146,111102228,XM_022434881.1,uncharacterized LOC111102228,3099
NC_035785.1,51205315,51207408,51205315,51207408,111102231,XM_022434883.1,uncharacterized LOC111102231,2093
NC_035785.1,51244038,51244720,51244038,51244720,111102232,XM_022434884.1,uncharacterized LOC111102232,682
NC_035785.1,14070003,14076415,14070628,14076415,111102233,XM_022434886.1,uncharacterized LOC111102233,5787
NC_035785.1,14070003,14076415,14070004,14076415,111102233,XM_022434885.1,uncharacterized LOC111102233,6411
NC_035785.1,14070003,14076415,14070003,14076415,111102233,XM_022434890.1,uncharacterized LOC111102233,6412
NC_035785.1,47027688,47070497,47027688,47048850,111102236,XM_022434895.1,uncharacterized LOC111102236,21162
NC_035785.1,12543629,12550926,12543629,12550926,111102239,XM_022434900.1,uncharacterized LOC111102239,7297
NC_035785.1,50822773,50824489,50822773,50824489,111102242,XM_022434907.1,uncharacterized LOC111102242,1716
NC_035785.1,18497367,18500364,18497367,18500364,111102244,XM_022434910.1,uncharacterized LOC111102244,2997
NC_035785.1,18495164,18497383,18495164,18497383,111102245,XM_022434911.1,uncharacterized LOC111102245,2219
NC_035785.1,12103515,12126991,12103515,12126991,111102246,XM_022434912.1,uncharacterized LOC111102246,23476
NC_035785.1,23434567,23444658,23434567,23444658,111102248,XM_022434913.1,uncharacterized LOC111102248,10091
NC_035785.1,6657887,6662725,6657887,6662725,111102250,XM_022434916.1,uncharacterized LOC111102250,4838
NC_035785.1,38707610,38719527,38707610,38719527,111102256,XM_022434923.1,uncharacterized LOC111102256,11917
NC_035785.1,38707610,38719527,38707610,38716410,111102256,XM_022434924.1,uncharacterized LOC111102256,8800
NC_035785.1,49517325,49519397,49517329,49519397,111102257,XM_022434925.1,uncharacterized LOC111102257,2068
NC_035785.1,49517325,49519397,49517325,49519397,111102257,XM_022434926.1,uncharacterized LOC111102257,2072
NC_035785.1,33410681,33416318,33410681,33416318,111102258,XM_022434927.1,uncharacterized LOC111102258,5637
NC_035785.1,18303892,18323627,18303892,18323627,111102259,XM_022434928.1,uncharacterized LOC111102259,19735
NC_035785.1,4790607,4805103,4790607,4805103,111102262,XM_022434931.1,uncharacterized LOC111102262,14496
NC_035785.1,29492124,29494600,29492124,29494600,111102264,XM_022434933.1,uncharacterized LOC111102264,2476
NC_035785.1,29481901,29484643,29481901,29484643,111102265,XM_022434934.1,uncharacterized LOC111102265,2742
NC_035785.1,20934229,20941285,20934229,20941285,111102267,XM_022434935.1,uncharacterized LOC111102267,7056
NC_035785.1,27607071,27620776,27607071,27620776,111102271,XM_022434939.1,uncharacterized LOC111102271,13705
NC_035785.1,11743947,11756832,11743947,11756832,111102273,XM_022434941.1,uncharacterized LOC111102273,12885
NC_035785.1,12511190,12519466,12512672,12519465,111102275,XM_022434944.1,uncharacterized LOC111102275,6793
NC_035785.1,12511190,12519466,12511190,12519466,111102275,XM_022434942.1,uncharacterized LOC111102275,8276
NC_035785.1,19114010,19121532,19116457,19121532,111102283,XM_022434962.1,uncharacterized LOC111102283,5075
NC_035785.1,19114010,19121532,19115618,19121532,111102283,XM_022434961.1,uncharacterized LOC111102283,5914
NC_035785.1,19114010,19121532,19114031,19121532,111102283,XM_022434958.1,uncharacterized LOC111102283,7501
NC_035785.1,19114010,19121532,19114010,19121532,111102283,XM_022434959.1,uncharacterized LOC111102283,7522
NC_035785.1,33687811,33692019,33687811,33692019,111102284,XM_022434963.1,uncharacterized LOC111102284,4208
NC_035785.1,9627928,9644482,9627928,9644482,111102285,XM_022434965.1,uncharacterized LOC111102285,16554
NC_035785.1,30918119,30924444,30918119,30924444,111102286,XM_022434966.1,uncharacterized LOC111102286,6325
NC_035785.1,40306124,40307848,40306124,40307848,111102287,XM_022434967.1,uncharacterized LOC111102287,1724
NC_035785.1,41101992,41106999,41101992,41106999,111102288,XM_022434969.1,uncharacterized LOC111102288,5007
NC_035785.1,42372251,42410824,42372251,42410824,111102290,XM_022434972.1,uncharacterized LOC111102290,38573
NC_035785.1,14081879,14095523,14081879,14095523,111102296,XM_022434979.1,uncharacterized LOC111102296,13644
NC_035785.1,14081879,14095523,14092241,14095523,111102296,XM_022434978.1,uncharacterized LOC111102296,3282
NC_035785.1,40265046,40266679,40265385,40266679,111102299,XM_022434985.1,uncharacterized LOC111102299,1294
NC_035785.1,40265046,40266679,40265046,40266679,111102299,XM_022434984.1,uncharacterized LOC111102299,1633
NC_035785.1,30609112,30609974,30609112,30609974,111102300,XM_022434986.1,uncharacterized LOC111102300,862
NC_035785.1,36083942,36099378,36083942,36099378,111102305,XM_022434994.1,uncharacterized LOC111102305,15436
NC_035785.1,36066982,36073374,36066982,36073374,111102306,XM_022434995.1,uncharacterized LOC111102306,6392
NC_035785.1,18006402,18008452,18006402,18008452,111102308,XM_022434997.1,uncharacterized LOC111102308,2050
NC_035780.1,64077517,64081707,64077517,64081707,111102334,XM_022435005.1,uncharacterized LOC111102334,4190
NC_035786.1,14948348,14975899,14948348,14975899,111102336,XM_022435002.1,uncharacterized LOC111102336,27551
NC_035786.1,44701686,44732385,44701686,44732385,111102341,XM_022435015.1,uncharacterized LOC111102341,30699
NC_035780.1,12848461,12852461,12848461,12852461,111102342,XM_022435049.1,uncharacterized LOC111102342,4000
NC_035786.1,24532058,24535180,24532058,24535180,111102343,XM_022435016.1,uncharacterized LOC111102343,3122
NC_035786.1,47456361,47481942,47456361,47481942,111102344,XM_022435018.1,uncharacterized LOC111102344,25581
NC_035786.1,41319799,41341666,41319799,41336550,111102349,XM_022435021.1,uncharacterized LOC111102349,16751
NC_035786.1,41319799,41341666,41319799,41341666,111102349,XM_022435020.1,uncharacterized LOC111102349,21867
NC_035786.1,33572758,33576805,33572758,33576805,111102350,XM_022435023.1,uncharacterized LOC111102350,4047
NC_035786.1,5211111,5213816,5212067,5213816,111102352,XM_022435026.1,uncharacterized LOC111102352,1749
NC_035786.1,5211111,5213816,5211111,5213816,111102352,XM_022435025.1,uncharacterized LOC111102352,2705
NC_035786.1,57751152,57766004,57753882,57765019,111102353,XM_022435031.1,uncharacterized LOC111102353,11137
NC_035786.1,57751152,57766004,57751152,57762775,111102353,XM_022435029.1,uncharacterized LOC111102353,11623
NC_035786.1,57751152,57766004,57753926,57766004,111102353,XM_022435030.1,uncharacterized LOC111102353,12078
NC_035786.1,57751152,57766004,57751152,57763354,111102353,XM_022435028.1,uncharacterized LOC111102353,12202
NC_035786.1,16957072,16958784,16957072,16958784,111102354,XM_022435033.1,uncharacterized LOC111102354,1712
NC_035786.1,20314777,20316032,20314777,20316032,111102355,XM_022435034.1,uncharacterized LOC111102355,1255
NC_035786.1,22833341,22837529,22833341,22837529,111102356,XM_022435035.1,uncharacterized LOC111102356,4188
NC_035780.1,18970485,18987374,18970485,18987374,111102362,XM_022435169.1,uncharacterized LOC111102362,16889
NC_035786.1,461750,465504,461750,465504,111102363,XM_022435056.1,uncharacterized LOC111102363,3754
NC_035780.1,11181146,11190506,11182444,11190506,111102366,XM_022435061.1,uncharacterized LOC111102366,8062
NC_035780.1,11181146,11190506,11181146,11190506,111102366,XM_022435069.1,uncharacterized LOC111102366,9360
NC_035786.1,14344332,14346706,14344332,14346706,111102368,XM_022435059.1,uncharacterized LOC111102368,2374
NC_035786.1,41433125,41437316,41433125,41437316,111102373,XM_022435067.1,uncharacterized LOC111102373,4191
NC_035786.1,46731907,46734684,46731907,46734684,111102375,XM_022435072.1,uncharacterized LOC111102375,2777
NC_035786.1,14900637,14906077,14900637,14906077,111102382,XM_022435083.1,uncharacterized LOC111102382,5440
NC_035786.1,54615002,54622647,54615002,54622647,111102383,XM_022435087.1,uncharacterized LOC111102383,7645
NC_035786.1,34172204,34177542,34172257,34177542,111102385,XM_022435089.1,uncharacterized LOC111102385,5285
NC_035786.1,34172204,34177542,34172204,34177542,111102385,XM_022435088.1,uncharacterized LOC111102385,5338
NC_035786.1,15602061,15604547,15602061,15604547,111102386,XM_022435090.1,uncharacterized LOC111102386,2486
NC_035786.1,19509965,19514441,19509965,19514441,111102389,XM_022435095.1,uncharacterized LOC111102389,4476
NC_035786.1,19509965,19514441,19513676,19514441,111102389,XM_022435094.1,uncharacterized LOC111102389,765
NC_035786.1,41780095,41781124,41780095,41781124,111102392,XM_022435098.1,uncharacterized LOC111102392,1029
NC_035786.1,53181287,53184227,53181287,53184227,111102394,XM_022435099.1,uncharacterized LOC111102394,2940
NC_035786.1,17111185,17112551,17111185,17112551,111102396,XM_022435100.1,uncharacterized LOC111102396,1366
NC_035786.1,4420328,4448071,4420328,4448071,111102397,XM_022435102.1,uncharacterized LOC111102397,27743
NC_035786.1,15280491,15326066,15280491,15326066,111102402,XM_022435109.1,uncharacterized LOC111102402,45575
NC_035786.1,13100444,13104699,13100444,13104699,111102404,XM_022435111.1,uncharacterized LOC111102404,4255
NC_035786.1,15262194,15263490,15262194,15263490,111102405,XM_022435113.1,uncharacterized LOC111102405,1296
NC_035786.1,22783853,22818280,22783853,22818280,111102406,XM_022435114.1,uncharacterized LOC111102406,34427
NC_035786.1,482475,487667,482475,487667,111102407,XM_022435115.1,uncharacterized LOC111102407,5192
NC_035786.1,40291695,40294816,40291695,40294816,111102410,XM_022435118.1,uncharacterized LOC111102410,3121
NC_035786.1,56632931,56641355,56632931,56641355,111102413,XM_022435121.1,uncharacterized LOC111102413,8424
NC_035786.1,20632447,20647525,20632447,20647525,111102420,XM_022435127.1,uncharacterized LOC111102420,15078
NC_035780.1,7232704,7235333,7232704,7235333,111102427,XM_022435136.1,uncharacterized LOC111102427,2629
NC_035786.1,49734465,49738092,49734465,49738092,111102431,XM_022435171.1,uncharacterized LOC111102431,3627
NC_035786.1,16831322,16842297,16831322,16842297,111102433,XM_022435173.1,uncharacterized LOC111102433,10975
NC_035786.1,25446610,25463985,25452640,25463976,111102435,XM_022435179.1,uncharacterized LOC111102435,11336
NC_035786.1,25446610,25463985,25452640,25463984,111102435,XM_022435181.1,uncharacterized LOC111102435,11344
NC_035786.1,25446610,25463985,25446610,25463985,111102435,XM_022435182.1,uncharacterized LOC111102435,17375
NC_035786.1,42452738,42453911,42452738,42453911,111102436,XM_022435183.1,uncharacterized LOC111102436,1173
NC_035780.1,1878806,1881983,1878806,1881983,111102439,XM_022435187.1,uncharacterized LOC111102439,3177
NC_035786.1,54300235,54301519,54300235,54301519,111102440,XM_022435185.1,uncharacterized LOC111102440,1284
NC_035786.1,34640768,34644486,34640769,34644486,111102446,XM_022435191.1,uncharacterized LOC111102446,3717
NC_035786.1,34640768,34644486,34640768,34644486,111102446,XM_022435194.1,uncharacterized LOC111102446,3718
NC_035786.1,48576098,48576928,48576098,48576928,111102447,XM_022435195.1,uncharacterized LOC111102447,830
NC_035786.1,49454361,49465812,49461280,49465812,111102449,XM_022435196.1,uncharacterized LOC111102449,4532
NC_035786.1,13033476,13034692,13033476,13034692,111102452,XM_022435199.1,uncharacterized LOC111102452,1216
NC_035786.1,11769454,11770807,11769454,11770701,111102453,XM_022435201.1,uncharacterized LOC111102453,1247
NC_035786.1,11769454,11770807,11769454,11770807,111102453,XM_022435200.1,uncharacterized LOC111102453,1353
NC_035786.1,49314275,49325625,49314275,49325625,111102454,XM_022435202.1,uncharacterized LOC111102454,11350
NC_035786.1,49314275,49325625,49321314,49325625,111102454,XM_022435203.1,uncharacterized LOC111102454,4311
NC_035786.1,12637363,12668160,12637363,12668160,111102455,XM_022435204.1,uncharacterized LOC111102455,30797
NC_035786.1,45926454,45931388,45926454,45931388,111102457,XM_022435206.1,uncharacterized LOC111102457,4934
NC_035786.1,32789878,32795830,32789878,32795830,111102460,XM_022435210.1,uncharacterized LOC111102460,5952
NC_035786.1,7317211,7320069,7317211,7320069,111102462,XM_022435212.1,uncharacterized LOC111102462,2858
NC_035786.1,7489807,7492800,7489807,7492800,111102469,XM_022435223.1,uncharacterized LOC111102469,2993
NC_035786.1,20301654,20302897,20301654,20302897,111102473,XM_022435226.1,uncharacterized LOC111102473,1243
NC_035786.1,55876971,55885961,55876971,55885961,111102479,XM_022435237.1,uncharacterized LOC111102479,8990
NC_035786.1,49304650,49313167,49304650,49313167,111102480,XM_022435238.1,uncharacterized LOC111102480,8517
NC_035786.1,22381287,22418704,22381287,22418704,111102481,XM_022435240.1,uncharacterized LOC111102481,37417
NC_035786.1,43931699,43937212,43933027,43937212,111102482,XM_022435242.1,uncharacterized LOC111102482,4185
NC_035786.1,43931699,43937212,43931699,43937212,111102482,XM_022435241.1,uncharacterized LOC111102482,5513
NC_035786.1,9845175,9854555,9845175,9854555,111102483,XM_022435243.1,uncharacterized LOC111102483,9380
NC_035786.1,5584670,5587110,5584670,5587110,111102486,XM_022435253.1,uncharacterized LOC111102486,2440
NC_035786.1,16179089,16183883,16179089,16183883,111102487,XM_022435254.1,uncharacterized LOC111102487,4794
NC_035786.1,33063699,33103991,33063699,33103991,111102491,XM_022435257.1,uncharacterized LOC111102491,40292
NC_035786.1,24836853,24840779,24836853,24840779,111102493,XM_022435263.1,uncharacterized LOC111102493,3926
NC_035786.1,18523548,18529075,18523548,18529075,111102503,XM_022435287.1,uncharacterized LOC111102503,5527
NC_035786.1,53248350,53253206,53248350,53253206,111102506,XM_022435292.1,uncharacterized LOC111102506,4856
NC_035786.1,21624523,21627488,21624523,21627488,111102508,XM_022435295.1,uncharacterized LOC111102508,2965
NC_035780.1,46583477,46586701,46583477,46586701,111102511,XM_022435302.1,uncharacterized LOC111102511,3224
NC_035786.1,34850846,34854164,34850846,34854157,111102515,XM_022435303.1,uncharacterized LOC111102515,3311
NC_035786.1,34850846,34854164,34850846,34854164,111102515,XM_022435304.1,uncharacterized LOC111102515,3318
NC_035786.1,4834046,4837461,4834046,4837461,111102518,XM_022435306.1,uncharacterized LOC111102518,3415
NC_035786.1,18197946,18201830,18197946,18201830,111102519,XM_022435308.1,uncharacterized LOC111102519,3884
NC_035786.1,18145582,18150448,18145582,18150448,111102523,XM_022435313.1,uncharacterized LOC111102523,4866
NC_035786.1,39835672,39852188,39835672,39852188,111102524,XM_022435314.1,uncharacterized LOC111102524,16516
NC_035786.1,9739186,9741609,9739186,9741609,111102527,XM_022435320.1,uncharacterized LOC111102527,2423
NC_035786.1,46473886,46477019,46473886,46477019,111102532,XM_022435325.1,uncharacterized LOC111102532,3133
NC_035786.1,30036210,30040166,30036210,30040166,111102534,XM_022435327.1,uncharacterized LOC111102534,3956
NC_035786.1,30024395,30028558,30024395,30028558,111102535,XM_022435328.1,uncharacterized LOC111102535,4163
NC_035786.1,30061663,30064811,30061663,30064811,111102536,XM_022435330.1,uncharacterized LOC111102536,3148
NC_035786.1,52129188,52134355,52129188,52134355,111102539,XM_022435333.1,uncharacterized LOC111102539,5167
NC_035786.1,20665403,20668515,20665403,20668515,111102540,XM_022435334.1,uncharacterized LOC111102540,3112
NC_035786.1,40050103,40052259,40050103,40052259,111102542,XM_022435337.1,uncharacterized LOC111102542,2156
NC_035786.1,39395714,39403922,39395714,39403922,111102549,XM_022435342.1,uncharacterized LOC111102549,8208
NC_035786.1,5795438,5800153,5795438,5800153,111102551,XM_022435344.1,uncharacterized LOC111102551,4715
NC_035780.1,8155358,8158602,8155358,8158602,111102556,XM_022435352.1,uncharacterized LOC111102556,3244
NC_035786.1,10642576,10643691,10642576,10643691,111102557,XM_022435349.1,uncharacterized LOC111102557,1115
NC_035786.1,27362158,27378470,27362158,27378470,111102558,XM_022435350.1,uncharacterized LOC111102558,16312
NC_035786.1,17528133,17530387,17528133,17530387,111102562,XM_022435355.1,uncharacterized LOC111102562,2254
NC_035786.1,23953800,23975309,23954838,23975309,111102567,XM_022435364.1,uncharacterized LOC111102567,20471
NC_035786.1,23953800,23975309,23953800,23975309,111102567,XM_022435363.1,uncharacterized LOC111102567,21509
NC_035786.1,23953800,23975309,23972046,23975309,111102567,XM_022435362.1,uncharacterized LOC111102567,3263
NC_035786.1,23960768,23962652,23960768,23962652,111102568,XM_022435365.1,uncharacterized LOC111102568,1884
NC_035786.1,22649766,22674194,22649766,22674194,111102569,XM_022435368.1,uncharacterized LOC111102569,24428
NC_035786.1,50030427,50039233,50030427,50039233,111102577,XM_022435380.1,uncharacterized LOC111102577,8806
NC_035786.1,50038563,50042066,50038563,50042066,111102579,XM_022435381.1,uncharacterized LOC111102579,3503
NC_035786.1,526228,529547,526228,529547,111102583,XM_022435386.1,uncharacterized LOC111102583,3319
NC_035786.1,15838195,15861388,15845079,15861388,111102584,XM_022435389.1,uncharacterized LOC111102584,16309
NC_035786.1,15838195,15861388,15845066,15861388,111102584,XM_022435387.1,uncharacterized LOC111102584,16322
NC_035786.1,15838195,15861388,15838260,15861388,111102584,XM_022435394.1,uncharacterized LOC111102584,23128
NC_035786.1,15838195,15861388,15838195,15861388,111102584,XM_022435388.1,uncharacterized LOC111102584,23193
NC_035786.1,15838195,15861388,15852108,15861388,111102584,XM_022435393.1,uncharacterized LOC111102584,9280
NC_035786.1,15838195,15861388,15851846,15861388,111102584,XM_022435391.1,uncharacterized LOC111102584,9542
NC_035786.1,15838195,15861388,15851563,15861388,111102584,XM_022435392.1,uncharacterized LOC111102584,9825
NC_035786.1,39482591,39488387,39482592,39488387,111102587,XM_022435400.1,uncharacterized LOC111102587,5795
NC_035786.1,39482591,39488387,39482591,39488387,111102587,XM_022435397.1,uncharacterized LOC111102587,5796
NC_035786.1,43560332,43562610,43560332,43562610,111102591,XM_022435404.1,uncharacterized LOC111102591,2278
NC_035786.1,35989878,36001824,35989878,36001824,111102597,XM_022435412.1,uncharacterized LOC111102597,11946
NC_035786.1,35989878,36001824,35991957,36001823,111102597,XM_022435411.1,uncharacterized LOC111102597,9866
NC_035786.1,35995796,35999780,35995796,35999780,111102598,XM_022435414.1,uncharacterized LOC111102598,3984
NC_035786.1,9386184,9390455,9386184,9390455,111102599,XM_022435415.1,uncharacterized LOC111102599,4271
NC_035786.1,51053305,51059947,51053305,51059947,111102600,XM_022435416.1,uncharacterized LOC111102600,6642
NC_035780.1,23000421,23003889,23000421,23003889,111102604,XM_022435423.1,uncharacterized LOC111102604,3468
NC_035786.1,54159602,54165132,54159602,54165132,111102606,XM_022435420.1,uncharacterized LOC111102606,5530
NC_035786.1,23606177,23610062,23606177,23610062,111102611,XM_022435429.1,uncharacterized LOC111102611,3885
NC_035780.1,22997745,23001045,22998060,23001045,111102613,XM_022435442.1,uncharacterized LOC111102613,2985
NC_035780.1,22997745,23001045,22997745,23000916,111102613,XM_022435445.1,uncharacterized LOC111102613,3171
NC_035780.1,22997745,23001045,22997745,23001045,111102613,XM_022435434.1,uncharacterized LOC111102613,3300
NC_035786.1,53543871,53546562,53543871,53546562,111102616,XM_022435435.1,uncharacterized LOC111102616,2691
NC_035786.1,35001745,35003504,35001745,35003504,111102617,XM_022435436.1,uncharacterized LOC111102617,1759
NC_035786.1,55455537,55500452,55455537,55500452,111102620,XM_022435440.1,uncharacterized LOC111102620,44915
NC_035786.1,35429307,35432807,35429307,35432807,111102622,XM_022435441.1,uncharacterized LOC111102622,3500
NC_035786.1,5566347,5571645,5566347,5571645,111102624,XM_022435444.1,uncharacterized LOC111102624,5298
NC_035786.1,3260028,3269118,3260028,3268819,111102627,XM_022435449.1,uncharacterized LOC111102627,8791
NC_035786.1,3260028,3269118,3260028,3269118,111102627,XM_022435448.1,uncharacterized LOC111102627,9090
NC_035786.1,14241682,14248408,14241682,14248408,111102630,XM_022435452.1,uncharacterized LOC111102630,6726
NC_035786.1,39420063,39424184,39420063,39424071,111102633,XM_022435456.1,uncharacterized LOC111102633,4008
NC_035786.1,39420063,39424184,39420063,39424184,111102633,XM_022435455.1,uncharacterized LOC111102633,4121
NC_035780.1,23780358,23783411,23780358,23783411,111102634,XM_022435459.1,uncharacterized LOC111102634,3053
NC_035786.1,16950215,16952107,16950215,16952107,111102635,XM_022435457.1,uncharacterized LOC111102635,1892
NC_035786.1,47969092,47974899,47969093,47972043,111102643,XM_022435468.1,uncharacterized LOC111102643,2950
NC_035786.1,47969092,47974899,47969092,47974299,111102643,XM_022435466.1,uncharacterized LOC111102643,5207
NC_035786.1,47969092,47974899,47969092,47974899,111102643,XM_022435467.1,uncharacterized LOC111102643,5807
NC_035786.1,37782281,37792820,37782281,37792820,111102645,XM_022435469.1,uncharacterized LOC111102645,10539
NC_035786.1,37404255,37405494,37404255,37405494,111102647,XM_022435472.1,uncharacterized LOC111102647,1239
NC_035786.1,4337557,4342827,4337557,4342827,111102650,XM_022435476.1,uncharacterized LOC111102650,5270
NC_035786.1,7086909,7089792,7086909,7089792,111102653,XM_022435479.1,uncharacterized LOC111102653,2883
NC_035786.1,42661380,42663052,42661380,42663052,111102659,XM_022435482.1,uncharacterized LOC111102659,1672
NC_035780.1,55482623,55484919,55482623,55484919,111102661,XM_022435488.1,uncharacterized LOC111102661,2296
NC_035786.1,31992855,32005224,31992855,32005224,111102667,XM_022435498.1,uncharacterized LOC111102667,12369
NC_035786.1,10570053,10572488,10570053,10572488,111102680,XM_022435524.1,uncharacterized LOC111102680,2435
NC_035786.1,25983512,25984490,25983512,25984490,111102681,XM_022435525.1,uncharacterized LOC111102681,978
NC_035786.1,29508387,29517020,29508387,29517020,111102689,XM_022435538.1,uncharacterized LOC111102689,8633
NC_035786.1,54137493,54153878,54137493,54153878,111102691,XM_022435540.1,uncharacterized LOC111102691,16385
NC_035786.1,30757368,30762956,30757368,30762956,111102699,XM_022435547.1,uncharacterized LOC111102699,5588
NC_035786.1,30767276,30776098,30767276,30776098,111102700,XM_022435550.1,uncharacterized LOC111102700,8822
NC_035786.1,30721674,30731083,30721674,30731083,111102701,XM_022435551.1,uncharacterized LOC111102701,9409
NC_035786.1,30864526,30870917,30864526,30870917,111102702,XM_022435552.1,uncharacterized LOC111102702,6391
NC_035780.1,43444879,43448102,43444879,43448102,111102704,XM_022435557.1,uncharacterized LOC111102704,3223
NC_035786.1,30848479,30852694,30848479,30852694,111102706,XM_022435555.1,uncharacterized LOC111102706,4215
NC_035786.1,30780654,30784658,30780654,30784658,111102707,XM_022435556.1,uncharacterized LOC111102707,4004
NC_035786.1,30792946,30809997,30792946,30809997,111102708,XM_022435559.1,uncharacterized LOC111102708,17051
NC_035786.1,30948674,30960384,30948674,30960384,111102709,XM_022435561.1,uncharacterized LOC111102709,11710
NC_035786.1,30816153,30829573,30816153,30829573,111102711,XM_022435563.1,uncharacterized LOC111102711,13420
NC_035780.1,54779828,54787602,54785082,54787602,111102714,XM_022435577.1,uncharacterized LOC111102714,2520
NC_035780.1,54779828,54787602,54779828,54787602,111102714,XM_022435569.1,uncharacterized LOC111102714,7774
NC_035786.1,37224642,37243001,37224642,37243001,111102716,XM_022435567.1,uncharacterized LOC111102716,18359
NC_035786.1,14385157,14406166,14385431,14406166,111102717,XM_022435573.1,uncharacterized LOC111102717,20735
NC_035786.1,14385157,14406166,14385235,14406166,111102717,XM_022435571.1,uncharacterized LOC111102717,20931
NC_035786.1,14385157,14406166,14385225,14406166,111102717,XM_022435572.1,uncharacterized LOC111102717,20941
NC_035786.1,14385157,14406166,14385157,14406166,111102717,XM_022435574.1,uncharacterized LOC111102717,21009
NC_035786.1,14385157,14406166,14385157,14389689,111102717,XM_022435570.1,uncharacterized LOC111102717,4532
NC_035786.1,47805442,47814865,47805442,47814863,111102718,XM_022435575.1,uncharacterized LOC111102718,9421
NC_035786.1,47805442,47814865,47805442,47814865,111102718,XM_022435576.1,uncharacterized LOC111102718,9423
NC_035786.1,43577714,43596618,43579259,43596618,111102719,XM_022435580.1,uncharacterized LOC111102719,17359
NC_035786.1,43577714,43596618,43577714,43596618,111102719,XM_022435579.1,uncharacterized LOC111102719,18904
NC_035786.1,43577714,43596618,43590734,43596618,111102719,XM_022435581.1,uncharacterized LOC111102719,5884
NC_035786.1,47538477,47541775,47538477,47541775,111102720,XM_022435582.1,uncharacterized LOC111102720,3298
NC_035786.1,3409884,3419035,3409884,3412823,111102721,XM_022435584.1,uncharacterized LOC111102721,2939
NC_035786.1,3409884,3419035,3412218,3419035,111102721,XM_022435585.1,uncharacterized LOC111102721,6817
NC_035786.1,3409884,3419035,3409884,3419035,111102721,XM_022435583.1,uncharacterized LOC111102721,9151
NC_035780.1,17057575,17063111,17057575,17063111,111102723,XM_022435595.1,uncharacterized LOC111102723,5536
NC_035786.1,8901563,8928427,8901563,8928427,111102724,XM_022435586.1,uncharacterized LOC111102724,26864
NC_035786.1,15901345,15903602,15901345,15903602,111102728,XM_022435589.1,uncharacterized LOC111102728,2257
NC_035786.1,4317941,4324460,4317941,4324460,111102729,XM_022435590.1,uncharacterized LOC111102729,6519
NC_035786.1,15152506,15192062,15152507,15192062,111102730,XM_022435593.1,uncharacterized LOC111102730,39555
NC_035786.1,15152506,15192062,15152506,15192062,111102730,XM_022435592.1,uncharacterized LOC111102730,39556
NC_035786.1,30622465,30625058,30622465,30625058,111102731,XM_022435594.1,uncharacterized LOC111102731,2593
NC_035786.1,56759439,56764853,56759439,56764853,111102733,XM_022435596.1,uncharacterized LOC111102733,5414
NC_035786.1,56780637,56784643,56780637,56784643,111102734,XM_022435597.1,uncharacterized LOC111102734,4006
NC_035786.1,56711342,56805560,56801321,56805560,111102735,XM_022435598.1,uncharacterized LOC111102735,4239
NC_035786.1,56711342,56805560,56711342,56801985,111102735,XM_022435599.1,uncharacterized LOC111102735,90643
NC_035786.1,56720804,56726208,56720804,56726207,111102736,XM_022435600.1,uncharacterized LOC111102736,5403
NC_035786.1,56720804,56726208,56720804,56726208,111102736,XM_022435601.1,uncharacterized LOC111102736,5404
NC_035786.1,56744414,56747865,56744415,56747865,111102737,XM_022435605.1,uncharacterized LOC111102737,3450
NC_035786.1,56744414,56747865,56744414,56747865,111102737,XM_022435603.1,uncharacterized LOC111102737,3451
NC_035786.1,56811858,56816427,56811858,56816427,111102739,XM_022435606.1,uncharacterized LOC111102739,4569
NC_035786.1,56818653,56820357,56818653,56820357,111102740,XM_022435608.1,uncharacterized LOC111102740,1704
NC_035786.1,56773736,56836535,56834179,56836535,111102741,XM_022435609.1,uncharacterized LOC111102741,2356
NC_035786.1,56773736,56836535,56773736,56836535,111102741,XM_022435610.1,uncharacterized LOC111102741,62799
NC_035786.1,2061527,2067449,2061527,2067449,111102743,XM_022435611.1,uncharacterized LOC111102743,5922
NC_035786.1,7818445,7823449,7818445,7823449,111102748,XM_022435613.1,uncharacterized LOC111102748,5004
NC_035786.1,33285862,33361157,33285862,33361157,111102752,XM_022435616.1,uncharacterized LOC111102752,75295
NC_035786.1,40526732,40530456,40526732,40530456,111102754,XM_022435618.1,uncharacterized LOC111102754,3724
NC_035786.1,38600444,38602018,38600444,38602018,111102755,XM_022435619.1,uncharacterized LOC111102755,1574
NC_035786.1,56201707,56215652,56201707,56215652,111102758,XM_022435622.1,uncharacterized LOC111102758,13945
NC_035786.1,56201707,56215652,56213614,56215652,111102758,XM_022435625.1,uncharacterized LOC111102758,2038
NC_035786.1,56201707,56215652,56213273,56215652,111102758,XM_022435623.1,uncharacterized LOC111102758,2379
NC_035786.1,56201707,56215652,56210430,56215652,111102758,XM_022435624.1,uncharacterized LOC111102758,5222
NC_035786.1,56201707,56215652,56206549,56215652,111102758,XM_022435626.1,uncharacterized LOC111102758,9103
NC_035786.1,6154466,6158069,6154466,6158069,111102765,XM_022435631.1,uncharacterized LOC111102765,3603
NC_035786.1,27319685,27321867,27319685,27321867,111102766,XM_022435633.1,uncharacterized LOC111102766,2182
NC_035786.1,19027137,19029794,19027137,19029794,111102768,XM_022435635.1,uncharacterized LOC111102768,2657
NC_035786.1,19024520,19028396,19024520,19028396,111102769,XM_022435636.1,uncharacterized LOC111102769,3876
NC_035780.1,17044335,17048407,17044335,17048407,111102772,XM_022435640.1,uncharacterized LOC111102772,4072
NC_035786.1,57106164,57109289,57106164,57109289,111102774,XM_022435639.1,uncharacterized LOC111102774,3125
NC_035786.1,26124838,26143406,26124838,26143406,111102776,XM_022435641.1,uncharacterized LOC111102776,18568
NC_035786.1,6737461,6742221,6737461,6742221,111102777,XM_022435642.1,uncharacterized LOC111102777,4760
NC_035786.1,7330693,7354804,7330693,7354804,111102778,XM_022435643.1,uncharacterized LOC111102778,24111
NC_035786.1,34104347,34129158,34104349,34129156,111102779,XM_022435646.1,uncharacterized LOC111102779,24807
NC_035786.1,34104347,34129158,34104348,34129158,111102779,XM_022435645.1,uncharacterized LOC111102779,24810
NC_035786.1,34104347,34129158,34104347,34129158,111102779,XM_022435644.1,uncharacterized LOC111102779,24811
NC_035786.1,34131346,34133968,34131346,34133968,111102780,XM_022435647.1,uncharacterized LOC111102780,2622
NC_035780.1,14497098,14500922,14497098,14500922,111102782,XM_022435651.1,uncharacterized LOC111102782,3824
NC_035786.1,25235214,25241470,25235214,25241470,111102784,XM_022435650.1,uncharacterized LOC111102784,6256
NC_035786.1,16308165,16310432,16308165,16310432,111102785,XM_022435652.1,uncharacterized LOC111102785,2267
NC_035786.1,48046679,48079286,48046679,48074755,111102786,XM_022435657.1,uncharacterized LOC111102786,28076
NC_035786.1,48046679,48079286,48046679,48074765,111102786,XM_022435656.1,uncharacterized LOC111102786,28086
NC_035786.1,48046679,48079286,48046682,48079286,111102786,XM_022435655.1,uncharacterized LOC111102786,32604
NC_035786.1,48046679,48079286,48046679,48079286,111102786,XM_022435654.1,uncharacterized LOC111102786,32607
NC_035786.1,52940011,52952637,52940698,52952637,111102787,XM_022435658.1,uncharacterized LOC111102787,11939
NC_035786.1,52940011,52952637,52940011,52952637,111102787,XM_022435659.1,uncharacterized LOC111102787,12626
NC_035786.1,24905438,24910009,24907384,24910009,111102791,XM_022435661.1,uncharacterized LOC111102791,2625
NC_035786.1,24905438,24910009,24905438,24910009,111102791,XM_022435660.1,uncharacterized LOC111102791,4571
NC_035786.1,48375089,48411803,48375089,48411803,111102794,XM_022435664.1,uncharacterized LOC111102794,36714
NC_035786.1,41775592,41777845,41775592,41777845,111102797,XM_022435665.1,uncharacterized LOC111102797,2253
NC_035786.1,3969631,3975887,3969631,3975887,111102799,XM_022435667.1,uncharacterized LOC111102799,6256
NC_035786.1,3958240,3965439,3958242,3963366,111102801,XM_022435668.1,uncharacterized LOC111102801,5124
NC_035786.1,3958240,3965439,3958240,3963366,111102801,XM_022435671.1,uncharacterized LOC111102801,5126
NC_035786.1,3958240,3965439,3958240,3964161,111102801,XM_022435673.1,uncharacterized LOC111102801,5921
NC_035786.1,3958240,3965439,3958240,3965439,111102801,XM_022435670.1,uncharacterized LOC111102801,7199
NC_035786.1,29888052,29890651,29888052,29890651,111102802,XM_022435674.1,uncharacterized LOC111102802,2599
NC_035786.1,114046,156085,114046,153872,111102810,XM_022435685.1,uncharacterized LOC111102810,39826
NC_035786.1,114046,156085,114046,156084,111102810,XM_022435684.1,uncharacterized LOC111102810,42038
NC_035786.1,114046,156085,114046,156085,111102810,XM_022435686.1,uncharacterized LOC111102810,42039
NC_035786.1,4815015,4819964,4815015,4819964,111102812,XM_022435689.1,uncharacterized LOC111102812,4949
NC_035786.1,47051901,47061296,47051901,47061295,111102813,XM_022435690.1,uncharacterized LOC111102813,9394
NC_035786.1,47051901,47061296,47051901,47061296,111102813,XM_022435691.1,uncharacterized LOC111102813,9395
NC_035786.1,47985511,47988689,47985511,47988689,111102816,XM_022435693.1,uncharacterized LOC111102816,3178
NC_035786.1,1528444,1530445,1528444,1530445,111102819,XM_022435704.1,uncharacterized LOC111102819,2001
NC_035786.1,1530468,1532874,1530468,1532873,111102820,XM_022435708.1,uncharacterized LOC111102820,2405
NC_035786.1,1530468,1532874,1530468,1532874,111102820,XM_022435705.1,uncharacterized LOC111102820,2406
NC_035786.1,50283773,50287515,50283773,50287515,111102821,XM_022435709.1,uncharacterized LOC111102821,3742
NC_035786.1,8083661,8106232,8103086,8106232,111102824,XM_022435713.1,uncharacterized LOC111102824,3146
NC_035786.1,8083661,8106232,8083661,8087123,111102824,XM_022435712.1,uncharacterized LOC111102824,3462
NC_035780.1,46588188,46594876,46588188,46594876,111102826,XM_022435719.1,uncharacterized LOC111102826,6688
NC_035786.1,57218831,57238767,57218831,57238766,111102827,XM_022435715.1,uncharacterized LOC111102827,19935
NC_035786.1,57218831,57238767,57218831,57238767,111102827,XM_022435716.1,uncharacterized LOC111102827,19936
NC_035786.1,57360612,57416673,57391638,57416673,111102828,XM_022435717.1,uncharacterized LOC111102828,25035
NC_035786.1,57360612,57416673,57361766,57416673,111102828,XM_022435720.1,uncharacterized LOC111102828,54907
NC_035786.1,57360612,57416673,57360612,57416673,111102828,XM_022435721.1,uncharacterized LOC111102828,56061
NC_035786.1,57423063,57429730,57423063,57429730,111102832,XM_022435728.1,uncharacterized LOC111102832,6667
NC_035786.1,57278699,57585350,57278699,57289363,111102834,XM_022435730.1,uncharacterized LOC111102834,10664
NC_035786.1,57278699,57585350,57278699,57289368,111102834,XM_022435731.1,uncharacterized LOC111102834,10669
NC_035786.1,57278699,57585350,57278699,57289383,111102834,XM_022435729.1,uncharacterized LOC111102834,10684
NC_035786.1,57278699,57585350,57278699,57585350,111102834,XM_022435732.1,uncharacterized LOC111102834,306651
NC_035786.1,9135574,9159730,9141843,9159729,111102839,XM_022435741.1,uncharacterized LOC111102839,17886
NC_035786.1,9135574,9159730,9141843,9159730,111102839,XM_022435740.1,uncharacterized LOC111102839,17887
NC_035786.1,9135574,9159730,9141837,9159730,111102839,XM_022435743.1,uncharacterized LOC111102839,17893
NC_035786.1,9135574,9159730,9135574,9159730,111102839,XM_022435742.1,uncharacterized LOC111102839,24156
NC_035786.1,29424188,29436601,29424188,29436601,111102840,XM_022435745.1,uncharacterized LOC111102840,12413
NC_035786.1,52718619,52721291,52718619,52721291,111102845,XM_022435756.1,uncharacterized LOC111102845,2672
NC_035786.1,13442395,13456259,13442395,13456259,111102848,XM_022435758.1,uncharacterized LOC111102848,13864
NC_035786.1,2026971,2028701,2026971,2028701,111102849,XM_022435759.1,uncharacterized LOC111102849,1730
NC_035786.1,7827055,7828421,7827055,7828421,111102851,XM_022435766.1,uncharacterized LOC111102851,1366
NC_035786.1,52771043,52780144,52771043,52780038,111102852,XM_022435768.1,uncharacterized LOC111102852,8995
NC_035786.1,52771043,52780144,52771043,52780144,111102852,XM_022435767.1,uncharacterized LOC111102852,9101
NC_035780.1,15349772,15350358,15349772,15350358,111102855,XM_022435809.1,uncharacterized LOC111102855,586
NC_035786.1,36246587,36255249,36246587,36255249,111102859,XM_022435776.1,uncharacterized LOC111102859,8662
NC_035786.1,52117105,52121000,52117105,52121000,111102860,XM_022435778.1,uncharacterized LOC111102860,3895
NC_035786.1,25941008,25948267,25941008,25948267,111102861,XM_022435779.1,uncharacterized LOC111102861,7259
NC_035786.1,30122020,30123208,30122020,30123208,111102864,XM_022435781.1,uncharacterized LOC111102864,1188
NC_035786.1,13353455,13361795,13353455,13361150,111102865,XM_022435782.1,uncharacterized LOC111102865,7695
NC_035786.1,13353455,13361795,13353455,13361192,111102865,XM_022435785.1,uncharacterized LOC111102865,7737
NC_035786.1,13353455,13361795,13353455,13361795,111102865,XM_022435783.1,uncharacterized LOC111102865,8340
NC_035786.1,5810420,5815377,5810420,5815377,111102867,XM_022435786.1,uncharacterized LOC111102867,4957
NC_035786.1,13205498,13224726,13205498,13224726,111102868,XM_022435788.1,uncharacterized LOC111102868,19228
NC_035786.1,36531028,36534800,36531028,36534800,111102869,XM_022435789.1,uncharacterized LOC111102869,3772
NC_035786.1,41792926,41809484,41794463,41809484,111102870,XM_022435790.1,uncharacterized LOC111102870,15021
NC_035786.1,41792926,41809484,41792926,41809484,111102870,XM_022435791.1,uncharacterized LOC111102870,16558
NC_035786.1,9746185,9754486,9746191,9754486,111102872,XM_022435795.1,uncharacterized LOC111102872,8295
NC_035786.1,9746185,9754486,9746190,9754486,111102872,XM_022435796.1,uncharacterized LOC111102872,8296
NC_035786.1,9746185,9754486,9746189,9754486,111102872,XM_022435794.1,uncharacterized LOC111102872,8297
NC_035786.1,18222967,18238804,18222967,18238804,111102877,XM_022435802.1,uncharacterized LOC111102877,15837
NC_035786.1,15968208,16022662,15968208,15989851,111102878,XM_022435804.1,uncharacterized LOC111102878,21643
NC_035786.1,15968208,16022662,15968211,16022662,111102878,XM_022435803.1,uncharacterized LOC111102878,54451
NC_035786.1,15968208,16022662,15968210,16022662,111102878,XM_022435805.1,uncharacterized LOC111102878,54452
NC_035786.1,15949739,15964520,15949739,15964520,111102879,XM_022435807.1,uncharacterized LOC111102879,14781
NC_035786.1,12359505,12361868,12359505,12361868,111102883,XM_022435811.1,uncharacterized LOC111102883,2363
NC_035786.1,35425228,35428766,35425228,35428766,111102884,XM_022435812.1,uncharacterized LOC111102884,3538
NC_035786.1,179792,181935,179792,181935,111102886,XM_022435814.1,uncharacterized LOC111102886,2143
NC_035786.1,32011712,32058940,32023875,32058940,111102888,XM_022435820.1,uncharacterized LOC111102888,35065
NC_035786.1,32011712,32058940,32021028,32058940,111102888,XM_022435818.1,uncharacterized LOC111102888,37912
NC_035786.1,32011712,32058940,32011712,32058940,111102888,XM_022435819.1,uncharacterized LOC111102888,47228
NC_035786.1,43107680,43112009,43107681,43112004,111102889,XM_022435823.1,uncharacterized LOC111102889,4323
NC_035786.1,43107680,43112009,43107680,43112009,111102889,XM_022435821.1,uncharacterized LOC111102889,4329
NC_035786.1,43096043,43100214,43096043,43100214,111102890,XM_022435824.1,uncharacterized LOC111102890,4171
NC_035786.1,43136016,43151921,43136016,43151921,111102891,XM_022435825.1,uncharacterized LOC111102891,15905
NC_035786.1,43084433,43089857,43084433,43089857,111102892,XM_022435826.1,uncharacterized LOC111102892,5424
NC_035786.1,21456965,21465097,21456965,21465097,111102897,XM_022435831.1,uncharacterized LOC111102897,8132
NC_035786.1,10224956,10281129,10224956,10279839,111102899,XM_022435835.1,uncharacterized LOC111102899,54883
NC_035786.1,10224956,10281129,10224956,10281058,111102899,XM_022435834.1,uncharacterized LOC111102899,56102
NC_035786.1,10224956,10281129,10224956,10281129,111102899,XM_022435833.1,uncharacterized LOC111102899,56173
NC_035786.1,17797844,17799484,17797844,17799484,111102900,XM_022435836.1,uncharacterized LOC111102900,1640
NC_035786.1,28842348,28844683,28842348,28844683,111102904,XM_022435844.1,uncharacterized LOC111102904,2335
NC_035786.1,13272270,13283709,13272270,13283709,111102905,XM_022435845.1,uncharacterized LOC111102905,11439
NC_035786.1,53107696,53111388,53107696,53111388,111102910,XM_022435850.1,uncharacterized LOC111102910,3692
NC_035786.1,45938754,45942110,45938754,45942110,111102914,XM_022435859.1,uncharacterized LOC111102914,3356
NC_035786.1,379115,397537,379115,397537,111102915,XM_022435861.1,uncharacterized LOC111102915,18422
NC_035786.1,47446790,47451218,47446790,47451218,111102917,XM_022435863.1,uncharacterized LOC111102917,4428
NC_035786.1,28646550,28657633,28646550,28657633,111102921,XM_022435866.1,uncharacterized LOC111102921,11083
NC_035786.1,28662667,28675212,28662667,28675212,111102922,XM_022435868.1,uncharacterized LOC111102922,12545
NC_035786.1,28546162,28565701,28546162,28562279,111102923,XM_022435871.1,uncharacterized LOC111102923,16117
NC_035786.1,28546162,28565701,28546162,28565701,111102923,XM_022435869.1,uncharacterized LOC111102923,19539
NC_035786.1,28625741,28640735,28625928,28640732,111102924,XM_022435874.1,uncharacterized LOC111102924,14804
NC_035786.1,28625741,28640735,28625741,28640735,111102924,XM_022435873.1,uncharacterized LOC111102924,14994
NC_035786.1,28591325,28606099,28591325,28606099,111102925,XM_022435875.1,uncharacterized LOC111102925,14774
NC_035786.1,28570742,28579472,28570742,28579472,111102926,XM_022435877.1,uncharacterized LOC111102926,8730
NC_035786.1,28689998,28696569,28689998,28696569,111102927,XM_022435878.1,uncharacterized LOC111102927,6571
NC_035786.1,28526680,28529075,28526680,28529075,111102928,XM_022435879.1,uncharacterized LOC111102928,2395
NC_035786.1,158775,166169,158775,166168,111102930,XM_022435881.1,uncharacterized LOC111102930,7393
NC_035786.1,158775,166169,158775,166169,111102930,XM_022435882.1,uncharacterized LOC111102930,7394
NC_035786.1,57083863,57093832,57083863,57089149,111102932,XM_022435887.1,uncharacterized LOC111102932,5286
NC_035786.1,57083863,57093832,57083863,57091344,111102932,XM_022435888.1,uncharacterized LOC111102932,7481
NC_035786.1,57083863,57093832,57083863,57093832,111102932,XM_022435886.1,uncharacterized LOC111102932,9969
NC_035780.1,19179676,19214852,19180689,19212963,111102933,XM_022436070.1,uncharacterized LOC111102933,32274
NC_035780.1,19179676,19214852,19179676,19212963,111102933,XM_022435919.1,uncharacterized LOC111102933,33287
NC_035780.1,19179676,19214852,19179676,19214852,111102933,XM_022435996.1,uncharacterized LOC111102933,35176
NC_035786.1,1763764,1766829,1763764,1766829,111102936,XM_022435891.1,uncharacterized LOC111102936,3065
NC_035786.1,45853391,45855483,45853391,45855483,111102938,XM_022435893.1,uncharacterized LOC111102938,2092
NC_035786.1,24645504,24651766,24645504,24651766,111102939,XM_022435894.1,uncharacterized LOC111102939,6262
NC_035786.1,18377212,18380743,18377212,18380743,111102945,XM_022435900.1,uncharacterized LOC111102945,3531
NC_035786.1,7564907,7568886,7566583,7568886,111102946,XM_022435902.1,uncharacterized LOC111102946,2303
NC_035786.1,7564907,7568886,7564907,7568886,111102946,XM_022435901.1,uncharacterized LOC111102946,3979
NC_035786.1,16433014,16434112,16433014,16434112,111102952,XM_022435907.1,uncharacterized LOC111102952,1098
NC_035786.1,50589050,50591175,50589050,50591175,111102953,XM_022435908.1,uncharacterized LOC111102953,2125
NC_035786.1,57782562,57795972,57782562,57795972,111102955,XM_022435910.1,uncharacterized LOC111102955,13410
NC_035786.1,7114362,7115975,7114362,7115975,111102956,XM_022435911.1,uncharacterized LOC111102956,1613
NC_035786.1,13526208,13529600,13526208,13529600,111102957,XM_022435912.1,uncharacterized LOC111102957,3392
NC_035786.1,14880263,14897403,14880263,14897393,111102960,XM_022435917.1,uncharacterized LOC111102960,17130
NC_035786.1,14880263,14897403,14880264,14897399,111102960,XM_022435915.1,uncharacterized LOC111102960,17135
NC_035786.1,14880263,14897403,14880265,14897403,111102960,XM_022435914.1,uncharacterized LOC111102960,17138
NC_035786.1,14880263,14897403,14880264,14897403,111102960,XM_022435916.1,uncharacterized LOC111102960,17139
NC_035780.1,26759952,26767588,26759952,26767588,111102962,XM_022436303.1,uncharacterized LOC111102962,7636
NC_035786.1,55753135,55755887,55753135,55755887,111102965,XM_022435922.1,uncharacterized LOC111102965,2752
NC_035786.1,25811836,25845997,25811836,25835384,111102967,XM_022435923.1,uncharacterized LOC111102967,23548
NC_035780.1,47725729,47732307,47725729,47732307,111102971,XM_022435933.1,uncharacterized LOC111102971,6578
NC_035786.1,47630012,47636340,47630012,47636340,111102972,XM_022435931.1,uncharacterized LOC111102972,6328
NC_035786.1,53338332,53341933,53338332,53341933,111102973,XM_022435932.1,uncharacterized LOC111102973,3601
NC_035786.1,44889269,44895330,44889269,44895330,111102978,XM_022435937.1,uncharacterized LOC111102978,6061
NC_035786.1,44995225,45105250,44995225,45105250,111102979,XM_022435940.1,uncharacterized LOC111102979,110025
NC_035786.1,44883899,44889166,44884493,44889166,111102981,XM_022435942.1,uncharacterized LOC111102981,4673
NC_035786.1,44883899,44889166,44883899,44889166,111102981,XM_022435941.1,uncharacterized LOC111102981,5267
NC_035786.1,44908556,44920689,44908556,44920689,111102984,XM_022435949.1,uncharacterized LOC111102984,12133
NC_035786.1,44840905,44844780,44840905,44844780,111102985,XM_022435950.1,uncharacterized LOC111102985,3875
NC_035786.1,49949448,49954487,49953426,49954487,111102986,XM_022435952.1,uncharacterized LOC111102986,1061
NC_035786.1,27199138,27207799,27205050,27207799,111102989,XM_022435956.1,uncharacterized LOC111102989,2749
NC_035786.1,27199138,27207799,27199138,27207799,111102989,XM_022435955.1,uncharacterized LOC111102989,8661
NC_035786.1,8344151,8381400,8344151,8381400,111102991,XM_022435959.1,uncharacterized LOC111102991,37249
NC_035786.1,16304713,16308128,16304713,16308128,111102992,XM_022435960.1,uncharacterized LOC111102992,3415
NC_035786.1,54426102,54428791,54426102,54428791,111102993,XM_022435961.1,uncharacterized LOC111102993,2689
NC_035786.1,56873622,56894697,56873622,56893949,111102995,XM_022435962.1,uncharacterized LOC111102995,20327
NC_035786.1,56873622,56894697,56873622,56894697,111102995,XM_022435964.1,uncharacterized LOC111102995,21075
NC_035786.1,56889648,56893654,56889648,56893654,111102996,XM_022435965.1,uncharacterized LOC111102996,4006
NC_035786.1,22130452,22140721,22130452,22140721,111102997,XM_022435967.1,uncharacterized LOC111102997,10269
NC_035786.1,11062925,11068818,11062925,11068818,111102998,XM_022435968.1,uncharacterized LOC111102998,5893
NC_035786.1,11068729,11073570,11068729,11072970,111102999,XM_022435971.1,uncharacterized LOC111102999,4241
NC_035786.1,11068729,11073570,11068729,11073559,111102999,XM_022435970.1,uncharacterized LOC111102999,4830
NC_035786.1,11068729,11073570,11068729,11073570,111102999,XM_022435973.1,uncharacterized LOC111102999,4841
NC_035786.1,27468096,27475335,27468102,27471428,111103003,XM_022435979.1,uncharacterized LOC111103003,3326
NC_035786.1,27468096,27475335,27468096,27471428,111103003,XM_022435983.1,uncharacterized LOC111103003,3332
NC_035786.1,27452386,27462505,27452386,27462505,111103005,XM_022435985.1,uncharacterized LOC111103005,10119
NC_035786.1,5596671,5601284,5596671,5601284,111103007,XM_022435986.1,uncharacterized LOC111103007,4613
NC_035786.1,16233994,16239614,16233994,16239614,111103008,XM_022435987.1,uncharacterized LOC111103008,5620
NC_035786.1,12997478,12998224,12997478,12998224,111103009,XM_022435989.1,uncharacterized LOC111103009,746
NC_035786.1,19161359,19167408,19161359,19167408,111103011,XM_022435990.1,uncharacterized LOC111103011,6049
NC_035786.1,56325816,56339555,56325816,56339555,111103014,XM_022435994.1,uncharacterized LOC111103014,13739
NC_035780.1,56560094,56563415,56561923,56563415,111103016,XM_022436011.1,uncharacterized LOC111103016,1492
NC_035780.1,56560094,56563415,56560094,56563415,111103016,XM_022436002.1,uncharacterized LOC111103016,3321
NC_035786.1,56576970,56585564,56577003,56580958,111103018,XM_022436008.1,uncharacterized LOC111103018,3955
NC_035786.1,56576970,56585564,56577003,56585564,111103018,XM_022436005.1,uncharacterized LOC111103018,8561
NC_035786.1,56576970,56585564,56576970,56585564,111103018,XM_022436006.1,uncharacterized LOC111103018,8594
NC_035786.1,56495621,56510639,56497853,56510639,111103019,XM_022436012.1,uncharacterized LOC111103019,12786
NC_035786.1,56495621,56510639,56497666,56510639,111103019,XM_022436010.1,uncharacterized LOC111103019,12973
NC_035786.1,56495621,56510639,56495621,56510639,111103019,XM_022436013.1,uncharacterized LOC111103019,15018
NC_035786.1,56535203,56546513,56535203,56546513,111103020,XM_022436016.1,uncharacterized LOC111103020,11310
NC_035780.1,56563431,56567413,56563431,56567413,111103023,XM_022436021.1,uncharacterized LOC111103023,3982
NC_035786.1,4843305,4845982,4843305,4845982,111103025,XM_022436020.1,uncharacterized LOC111103025,2677
NC_035786.1,11362399,11379335,11362400,11379335,111103027,XM_022436023.1,uncharacterized LOC111103027,16935
NC_035786.1,11362399,11379335,11362399,11379335,111103027,XM_022436024.1,uncharacterized LOC111103027,16936
NC_035786.1,10194891,10204155,10194891,10204155,111103028,XM_022436026.1,uncharacterized LOC111103028,9264
NC_035786.1,23774126,23779640,23774126,23779640,111103029,XM_022436027.1,uncharacterized LOC111103029,5514
NC_035786.1,18757356,18758720,18757356,18758720,111103033,XM_022436030.1,uncharacterized LOC111103033,1364
NC_035786.1,18256997,18265551,18256997,18265551,111103036,XM_022436033.1,uncharacterized LOC111103036,8554
NC_035786.1,5991401,5993575,5991401,5992407,111103037,XM_022436034.1,uncharacterized LOC111103037,1006
NC_035786.1,5991401,5993575,5991401,5993575,111103037,XM_022436035.1,uncharacterized LOC111103037,2174
NC_035786.1,5993606,5995230,5993606,5995230,111103038,XM_022436036.1,uncharacterized LOC111103038,1624
NC_035786.1,48617403,48623469,48618375,48623469,111103039,XM_022436037.1,uncharacterized LOC111103039,5094
NC_035786.1,18608868,18614753,18608868,18614753,111103041,XM_022436039.1,uncharacterized LOC111103041,5885
NC_035786.1,12945274,12978830,12945274,12978830,111103043,XM_022436041.1,uncharacterized LOC111103043,33556
NC_035786.1,42131298,42133373,42131298,42133373,111103045,XM_022436045.1,uncharacterized LOC111103045,2075
NC_035786.1,37286326,37290319,37286326,37290319,111103046,XM_022436046.1,uncharacterized LOC111103046,3993
NC_035786.1,53121722,53128507,53121722,53128507,111103049,XM_022436048.1,uncharacterized LOC111103049,6785
NC_035786.1,3290325,3330588,3290325,3330588,111103052,XM_022436051.1,uncharacterized LOC111103052,40263
NC_035786.1,22849857,22887855,22849952,22887855,111103055,XM_022436053.1,uncharacterized LOC111103055,37903
NC_035786.1,22849857,22887855,22849857,22887855,111103055,XM_022436054.1,uncharacterized LOC111103055,37998
NC_035786.1,48571300,48572079,48571300,48572079,111103056,XM_022436055.1,uncharacterized LOC111103056,779
NC_035786.1,45934495,45936876,45934495,45936876,111103057,XM_022436056.1,uncharacterized LOC111103057,2381
NC_035786.1,3872255,3876045,3872255,3876045,111103059,XM_022436057.1,uncharacterized LOC111103059,3790
NC_035786.1,47144119,47153821,47144119,47153821,111103060,XM_022436058.1,uncharacterized LOC111103060,9702
NC_035786.1,45976399,45976934,45976399,45976934,111103062,XM_022436067.1,uncharacterized LOC111103062,535
NC_035786.1,9707535,9715277,9707535,9715277,111103071,XM_022436073.1,uncharacterized LOC111103071,7742
NC_035786.1,46057060,46064936,46057060,46064936,111103074,XM_022436076.1,uncharacterized LOC111103074,7876
NC_035786.1,46066168,46083828,46066168,46083828,111103075,XM_022436080.1,uncharacterized LOC111103075,17660
NC_035786.1,46066168,46083828,46066168,46072806,111103075,XM_022436077.1,uncharacterized LOC111103075,6638
NC_035786.1,46066168,46083828,46066168,46074825,111103075,XM_022436079.1,uncharacterized LOC111103075,8657
NC_035786.1,46066168,46083828,46066168,46074828,111103075,XM_022436081.1,uncharacterized LOC111103075,8660
NC_035786.1,46041471,46050155,46041471,46050155,111103076,XM_022436082.1,uncharacterized LOC111103076,8684
NC_035786.1,46070023,46071675,46070023,46071675,111103077,XM_022436083.1,uncharacterized LOC111103077,1652
NC_035786.1,36014300,36045171,36017329,36045171,111103078,XM_022436086.1,uncharacterized LOC111103078,27842
NC_035786.1,36014300,36045171,36014300,36045171,111103078,XM_022436084.1,uncharacterized LOC111103078,30871
NC_035786.1,36034585,36036605,36034585,36036605,111103079,XM_022436088.1,uncharacterized LOC111103079,2020
NC_035786.1,36034585,36036605,36035934,36036605,111103079,XM_022436087.1,uncharacterized LOC111103079,671
NC_035786.1,51501544,51504159,51501544,51504159,111103081,XM_022436089.1,uncharacterized LOC111103081,2615
NC_035786.1,9433541,9434729,9433541,9434729,111103083,XM_022436091.1,uncharacterized LOC111103083,1188
NC_035786.1,29385243,29399784,29385243,29399784,111103084,XM_022436092.1,uncharacterized LOC111103084,14541
NC_035786.1,34026341,34031793,34026341,34031793,111103086,XM_022436094.1,uncharacterized LOC111103086,5452
NC_035786.1,29865758,29868821,29865758,29867598,111103087,XM_022436097.1,uncharacterized LOC111103087,1840
NC_035786.1,29865758,29868821,29865758,29868180,111103087,XM_022436096.1,uncharacterized LOC111103087,2422
NC_035786.1,29865758,29868821,29865758,29868821,111103087,XM_022436095.1,uncharacterized LOC111103087,3063
NC_035786.1,46872334,46882109,46872695,46882109,111103091,XM_022436106.1,uncharacterized LOC111103091,9414
NC_035786.1,46872334,46882109,46872334,46882109,111103091,XM_022436108.1,uncharacterized LOC111103091,9775
NC_035786.1,27394000,27411500,27394000,27411500,111103092,XM_022436111.1,uncharacterized LOC111103092,17500
NC_035786.1,27394000,27411500,27407117,27411500,111103092,XM_022436110.1,uncharacterized LOC111103092,4383
NC_035786.1,27394000,27411500,27404328,27411500,111103092,XM_022436109.1,uncharacterized LOC111103092,7172
NC_035786.1,51265634,51271892,51265634,51271892,111103094,XM_022436113.1,uncharacterized LOC111103094,6258
NC_035786.1,20223040,20224526,20223040,20224526,111103103,XM_022436132.1,uncharacterized LOC111103103,1486
NC_035786.1,24633686,24638656,24633686,24638656,111103104,XM_022436133.1,uncharacterized LOC111103104,4970
NC_035786.1,47406602,47414338,47406602,47414338,111103105,XM_022436134.1,uncharacterized LOC111103105,7736
NC_035786.1,47377613,47385429,47377613,47385429,111103106,XM_022436135.1,uncharacterized LOC111103106,7816
NC_035786.1,47355272,47360428,47355272,47360178,111103107,XM_022436137.1,uncharacterized LOC111103107,4906
NC_035786.1,47355272,47360428,47355272,47360428,111103107,XM_022436136.1,uncharacterized LOC111103107,5156
NC_035786.1,47421945,47427424,47421945,47427424,111103111,XM_022436140.1,uncharacterized LOC111103111,5479
NC_035786.1,18312533,18321430,18312586,18321430,111103112,XM_022436141.1,uncharacterized LOC111103112,8844
NC_035786.1,18312533,18321430,18312533,18321430,111103112,XM_022436142.1,uncharacterized LOC111103112,8897
NC_035780.1,12863496,12869862,12863496,12869862,111103114,XM_022436148.1,uncharacterized LOC111103114,6366
NC_035786.1,43946691,43950435,43946691,43950435,111103118,XM_022436157.1,uncharacterized LOC111103118,3744
NC_035786.1,43950459,43951849,43950459,43951849,111103120,XM_022436158.1,uncharacterized LOC111103120,1390
NC_035786.1,7502134,7506587,7502134,7506587,111103121,XM_022436159.1,uncharacterized LOC111103121,4453
NC_035786.1,9561721,9576684,9561721,9576684,111103125,XM_022436164.1,uncharacterized LOC111103125,14963
NC_035786.1,11076833,11080509,11076833,11080114,111103128,XM_022436167.1,uncharacterized LOC111103128,3281
NC_035786.1,11076833,11080509,11076833,11080509,111103128,XM_022436169.1,uncharacterized LOC111103128,3676
NC_035786.1,49810497,49823933,49810497,49823933,111103131,XM_022436171.1,uncharacterized LOC111103131,13436
NC_035786.1,53133052,53163267,53133052,53163267,111103132,XM_022436173.1,uncharacterized LOC111103132,30215
NC_035786.1,25590470,25593342,25590470,25593342,111103134,XM_022436175.1,uncharacterized LOC111103134,2872
NC_035786.1,23229035,23232415,23229035,23232415,111103136,XM_022436178.1,uncharacterized LOC111103136,3380
NC_035786.1,47429450,47437701,47430580,47437701,111103137,XM_022436181.1,uncharacterized LOC111103137,7121
NC_035786.1,47429450,47437701,47429456,47437701,111103137,XM_022436180.1,uncharacterized LOC111103137,8245
NC_035786.1,47429450,47437701,47429450,47437701,111103137,XM_022436179.1,uncharacterized LOC111103137,8251
NC_035786.1,33967350,34014230,33967350,34014230,111103141,XM_022436183.1,uncharacterized LOC111103141,46880
NC_035786.1,30326891,30337655,30331174,30335628,111103143,XM_022436187.1,uncharacterized LOC111103143,4454
NC_035786.1,30326891,30337655,30331174,30337655,111103143,XM_022436188.1,uncharacterized LOC111103143,6481
NC_035786.1,16663408,16672286,16663408,16672286,111103145,XM_022436192.1,uncharacterized LOC111103145,8878
NC_035786.1,2382094,2425837,2383995,2425837,111103148,XM_022436195.1,uncharacterized LOC111103148,41842
NC_035786.1,2382094,2425837,2383992,2425837,111103148,XM_022436197.1,uncharacterized LOC111103148,41845
NC_035786.1,2382094,2425837,2382094,2425837,111103148,XM_022436194.1,uncharacterized LOC111103148,43743
NC_035786.1,14164911,14166000,14164911,14166000,111103152,XM_022436201.1,uncharacterized LOC111103152,1089
NC_035786.1,29804096,29815864,29804096,29815864,111103156,XM_022436209.1,uncharacterized LOC111103156,11768
NC_035786.1,29825240,29828273,29825240,29828273,111103160,XM_022436218.1,uncharacterized LOC111103160,3033
NC_035786.1,27184115,27189829,27184115,27189829,111103164,XM_022436220.1,uncharacterized LOC111103164,5714
NC_035786.1,46696609,46703416,46696609,46703416,111103165,XM_022436221.1,uncharacterized LOC111103165,6807
NC_035786.1,46708199,46715607,46708199,46715607,111103166,XM_022436222.1,uncharacterized LOC111103166,7408
NC_035786.1,46673059,46678257,46673059,46677978,111103167,XM_022436225.1,uncharacterized LOC111103167,4919
NC_035786.1,46673059,46678257,46673059,46678257,111103167,XM_022436224.1,uncharacterized LOC111103167,5198
NC_035786.1,9769262,9774641,9769262,9773859,111103172,XM_022436233.1,uncharacterized LOC111103172,4597
NC_035786.1,9769262,9774641,9769262,9774639,111103172,XM_022436231.1,uncharacterized LOC111103172,5377
NC_035786.1,9769262,9774641,9769262,9774641,111103172,XM_022436232.1,uncharacterized LOC111103172,5379
NC_035786.1,53024680,53031603,53024680,53031603,111103173,XM_022436234.1,uncharacterized LOC111103173,6923
NC_035786.1,10818072,10827227,10818072,10826327,111103174,XM_022436237.1,uncharacterized LOC111103174,8255
NC_035786.1,10818072,10827227,10818072,10827227,111103174,XM_022436236.1,uncharacterized LOC111103174,9155
NC_035786.1,10790731,10814385,10790731,10814385,111103175,XM_022436240.1,uncharacterized LOC111103175,23654
NC_035786.1,10747853,10906463,10748274,10906463,111103176,XM_022436241.1,uncharacterized LOC111103176,158189
NC_035786.1,10747853,10906463,10747853,10906463,111103176,XM_022436242.1,uncharacterized LOC111103176,158610
NC_035786.1,10747853,10906463,10748274,10768152,111103176,XM_022436244.1,uncharacterized LOC111103176,19878
NC_035786.1,10747853,10906463,10748274,10769794,111103176,XM_022436243.1,uncharacterized LOC111103176,21520
NC_035780.1,1840607,1842557,1840607,1842557,111103177,XM_022436247.1,uncharacterized LOC111103177,1950
NC_035786.1,10896412,10897736,10896412,10897736,111103178,XM_022436245.1,uncharacterized LOC111103178,1324
NC_035786.1,22570705,22575597,22570705,22575597,111103179,XM_022436246.1,uncharacterized LOC111103179,4892
NC_035786.1,48803895,48805970,48803895,48805247,111103180,XM_022436249.1,uncharacterized LOC111103180,1352
NC_035786.1,9954906,9961977,9956518,9961977,111103182,XM_022436253.1,uncharacterized LOC111103182,5459
NC_035786.1,9954906,9961977,9956332,9961977,111103182,XM_022436251.1,uncharacterized LOC111103182,5645
NC_035786.1,9954906,9961977,9956328,9961977,111103182,XM_022436252.1,uncharacterized LOC111103182,5649
NC_035786.1,9954906,9961977,9954906,9961977,111103182,XM_022436254.1,uncharacterized LOC111103182,7071
NC_035786.1,34968442,34971881,34968442,34971881,111103186,XM_022436256.1,uncharacterized LOC111103186,3439
NC_035786.1,2869699,2983380,2869699,2983380,111103187,XM_022436257.1,uncharacterized LOC111103187,113681
NC_035780.1,27680734,27684449,27680734,27684449,111103194,XM_022436271.1,uncharacterized LOC111103194,3715
NC_035780.1,786318,790538,788661,790538,111103204,XM_022436295.1,uncharacterized LOC111103204,1877
NC_035780.1,786318,790538,786340,790538,111103204,XM_022436288.1,uncharacterized LOC111103204,4198
NC_035780.1,786318,790538,786318,790538,111103204,XM_022436281.1,uncharacterized LOC111103204,4220
NC_035786.1,43597123,43601623,43598423,43601623,111103207,XM_022436280.1,uncharacterized LOC111103207,3200
NC_035786.1,43597123,43601623,43597123,43601623,111103207,XM_022436279.1,uncharacterized LOC111103207,4500
NC_035786.1,6490012,6496489,6490012,6496489,111103208,XM_022436282.1,uncharacterized LOC111103208,6477
NC_035786.1,9407274,9409668,9407274,9409668,111103209,XM_022436283.1,uncharacterized LOC111103209,2394
NC_035786.1,46357036,46365978,46357036,46365978,111103210,XM_022436284.1,uncharacterized LOC111103210,8942
NC_035786.1,34771471,34773216,34771471,34773216,111103212,XM_022436285.1,uncharacterized LOC111103212,1745
NC_035786.1,25768817,25770113,25768817,25770113,111103213,XM_022436286.1,uncharacterized LOC111103213,1296
NC_035786.1,13386525,13415891,13386525,13409320,111103214,XM_022436289.1,uncharacterized LOC111103214,22795
NC_035786.1,13386525,13415891,13386525,13415890,111103214,XM_022436287.1,uncharacterized LOC111103214,29365
NC_035786.1,13386525,13415891,13386525,13415891,111103214,XM_022436290.1,uncharacterized LOC111103214,29366
NC_035786.1,13371481,13380173,13371481,13379216,111103215,XM_022436292.1,uncharacterized LOC111103215,7735
NC_035786.1,13371481,13380173,13371481,13380173,111103215,XM_022436291.1,uncharacterized LOC111103215,8692
NC_035786.1,44610436,44665509,44610436,44665509,111103221,XM_022436301.1,uncharacterized LOC111103221,55073
NC_035780.1,790827,792748,790827,792748,111103224,XM_022436309.1,uncharacterized LOC111103224,1921
NC_035786.1,34069807,34074813,34069807,34074813,111103225,XM_022436312.1,uncharacterized LOC111103225,5006
NC_035786.1,51696336,51698757,51696336,51698757,111103231,XM_022436316.1,uncharacterized LOC111103231,2421
NC_035786.1,22528261,22552599,22551007,22552599,111103236,XM_022436325.1,uncharacterized LOC111103236,1592
NC_035786.1,22528261,22552599,22528261,22552599,111103236,XM_022436326.1,uncharacterized LOC111103236,24338
NC_035786.1,22528261,22552599,22528290,22531034,111103236,XM_022436327.1,uncharacterized LOC111103236,2744
NC_035786.1,22557162,22558925,22557162,22558925,111103237,XM_022436328.1,uncharacterized LOC111103237,1763
NC_035786.1,22535783,22537276,22535783,22537276,111103239,XM_022436329.1,uncharacterized LOC111103239,1493
NC_035780.1,2650087,2651517,2650087,2651517,111103245,XM_022436368.1,uncharacterized LOC111103245,1430
NC_035786.1,23810337,23812744,23810337,23812744,111103247,XM_022436374.1,uncharacterized LOC111103247,2407
NC_035786.1,31136707,31145591,31136707,31145591,111103249,XM_022436375.1,uncharacterized LOC111103249,8884
NC_035786.1,31065355,31074071,31065355,31074071,111103251,XM_022436376.1,uncharacterized LOC111103251,8716
NC_035786.1,31091393,31101324,31091393,31101324,111103252,XM_022436377.1,uncharacterized LOC111103252,9931
NC_035786.1,30992883,31031384,31018774,31031384,111103253,XM_022436378.1,uncharacterized LOC111103253,12610
NC_035786.1,30992883,31031384,30992883,30996706,111103253,XM_022436381.1,uncharacterized LOC111103253,3823
NC_035786.1,30992883,31031384,30992883,31031384,111103253,XM_022436379.1,uncharacterized LOC111103253,38501
NC_035786.1,31223983,31228088,31223983,31228088,111103254,XM_022436382.1,uncharacterized LOC111103254,4105
NC_035786.1,31159054,31162161,31159054,31162161,111103255,XM_022436383.1,uncharacterized LOC111103255,3107
NC_035786.1,31046754,31058395,31046754,31058395,111103257,XM_022436385.1,uncharacterized LOC111103257,11641
NC_035786.1,31199266,31201355,31199266,31201355,111103259,XM_022436387.1,uncharacterized LOC111103259,2089
NC_035786.1,52187638,52198692,52187638,52198692,111103264,XM_022436393.1,uncharacterized LOC111103264,11054
NC_035786.1,52174386,52183033,52174386,52183033,111103265,XM_022436394.1,uncharacterized LOC111103265,8647
NC_035786.1,49243313,49263602,49243943,49257005,111103267,XM_022436397.1,uncharacterized LOC111103267,13062
NC_035786.1,49243313,49263602,49243313,49257005,111103267,XM_022436398.1,uncharacterized LOC111103267,13692
NC_035786.1,49243313,49263602,49243313,49263602,111103267,XM_022436396.1,uncharacterized LOC111103267,20289
NC_035786.1,14273702,14278522,14273702,14278522,111103269,XM_022436399.1,uncharacterized LOC111103269,4820
NC_035780.1,9425057,9428046,9425059,9428046,111103274,XM_022436431.1,uncharacterized LOC111103274,2987
NC_035780.1,9425057,9428046,9425058,9428046,111103274,XM_022436415.1,uncharacterized LOC111103274,2988
NC_035780.1,9425057,9428046,9425057,9428046,111103274,XM_022436421.1,uncharacterized LOC111103274,2989
NC_035786.1,30096987,30102419,30096987,30102419,111103277,XM_022436414.1,uncharacterized LOC111103277,5432
NC_035786.1,41850385,41933795,41850385,41933795,111103279,XM_022436416.1,uncharacterized LOC111103279,83410
NC_035786.1,20335447,20345062,20336312,20343254,111103291,XM_022436460.1,uncharacterized LOC111103291,6942
NC_035786.1,20335447,20345062,20336321,20345062,111103291,XM_022436461.1,uncharacterized LOC111103291,8741
NC_035786.1,20335447,20345062,20335447,20345062,111103291,XM_022436462.1,uncharacterized LOC111103291,9615
NC_035786.1,50346663,50353800,50346663,50353800,111103299,XM_022436470.1,uncharacterized LOC111103299,7137
NC_035786.1,18153994,18156573,18153994,18156573,111103303,XM_022436471.1,uncharacterized LOC111103303,2579
NC_035786.1,39061838,39075644,39061838,39075644,111103310,XM_022436486.1,uncharacterized LOC111103310,13806
NC_035786.1,29280050,29295854,29281736,29295854,111103316,XM_022436501.1,uncharacterized LOC111103316,14118
NC_035786.1,29280050,29295854,29280050,29295846,111103316,XM_022436498.1,uncharacterized LOC111103316,15796
NC_035786.1,29280050,29295854,29280050,29295848,111103316,XM_022436502.1,uncharacterized LOC111103316,15798
NC_035786.1,29253814,29257382,29253814,29257382,111103318,XM_022436504.1,uncharacterized LOC111103318,3568
NC_035786.1,29263274,29268715,29263274,29268715,111103319,XM_022436505.1,uncharacterized LOC111103319,5441
NC_035786.1,29260269,29262189,29260269,29262189,111103321,XM_022436507.1,uncharacterized LOC111103321,1920
NC_035786.1,19695608,19700610,19695608,19700610,111103336,XM_022436521.1,uncharacterized LOC111103336,5002
NC_035786.1,13830948,13841333,13830948,13841333,111103340,XM_022436534.1,uncharacterized LOC111103340,10385
NC_035786.1,52041715,52054896,52041715,52054896,111103342,XM_022436538.1,uncharacterized LOC111103342,13181
NC_035786.1,52041715,52054896,52041715,52050329,111103342,XM_022436537.1,uncharacterized LOC111103342,8614
NC_035786.1,52029843,52035672,52029843,52035672,111103343,XM_022436539.1,uncharacterized LOC111103343,5829
NC_035786.1,56666748,56703568,56666748,56681871,111103347,XM_022436545.1,uncharacterized LOC111103347,15123
NC_035786.1,56666748,56703568,56685739,56703568,111103347,XM_022436542.1,uncharacterized LOC111103347,17829
NC_035786.1,56666748,56703568,56666748,56703568,111103347,XM_022436544.1,uncharacterized LOC111103347,36820
NC_035780.1,19416060,19417948,19416060,19417946,111103348,XM_022436679.1,uncharacterized LOC111103348,1886
NC_035780.1,19416060,19417948,19416060,19417948,111103348,XM_022436590.1,uncharacterized LOC111103348,1888
NC_035786.1,39744821,39746831,39744821,39746831,111103355,XM_022436555.1,uncharacterized LOC111103355,2010
NC_035786.1,43246586,43275815,43249828,43266474,111103357,XM_022436576.1,uncharacterized LOC111103357,16646
NC_035786.1,43246586,43275815,43249824,43266476,111103357,XM_022436570.1,uncharacterized LOC111103357,16652
NC_035786.1,43246586,43275815,43249823,43266476,111103357,XM_022436569.1,uncharacterized LOC111103357,16653
NC_035786.1,43246586,43275815,43249019,43266476,111103357,XM_022436566.1,uncharacterized LOC111103357,17457
NC_035786.1,43246586,43275815,43246587,43266474,111103357,XM_022436567.1,uncharacterized LOC111103357,19887
NC_035786.1,43246586,43275815,43246586,43266475,111103357,XM_022436568.1,uncharacterized LOC111103357,19889
NC_035786.1,43246586,43275815,43246586,43266476,111103357,XM_022436572.1,uncharacterized LOC111103357,19890
NC_035786.1,43246586,43275815,43246586,43275811,111103357,XM_022436575.1,uncharacterized LOC111103357,29225
NC_035786.1,43246586,43275815,43246586,43275815,111103357,XM_022436571.1,uncharacterized LOC111103357,29229
NC_035780.1,5474916,5505507,5474916,5505507,111103358,XM_022436573.1,uncharacterized LOC111103358,30591
NC_035780.1,5768957,5772628,5768957,5772628,111103376,XM_022436612.1,uncharacterized LOC111103376,3671
NC_035786.1,27602350,27615645,27602350,27615645,111103378,XM_022436613.1,uncharacterized LOC111103378,13295
NC_035786.1,46214447,46225908,46214447,46225908,111103387,XM_022436628.1,uncharacterized LOC111103387,11461
NC_035786.1,46214447,46225908,46216390,46225908,111103387,XM_022436627.1,uncharacterized LOC111103387,9518
NC_035786.1,46214447,46225908,46216232,46225908,111103387,XM_022436625.1,uncharacterized LOC111103387,9676
NC_035786.1,46214447,46225908,46216223,46225908,111103387,XM_022436624.1,uncharacterized LOC111103387,9685
NC_035786.1,32418102,32421923,32418102,32421923,111103391,XM_022436633.1,uncharacterized LOC111103391,3821
NC_035786.1,31807976,31816320,31807976,31816313,111103400,XM_022436669.1,uncharacterized LOC111103400,8337
NC_035786.1,31807976,31816320,31807976,31816320,111103400,XM_022436668.1,uncharacterized LOC111103400,8344
NC_035786.1,31329578,31336069,31331921,31336069,111103402,XM_022436672.1,uncharacterized LOC111103402,4148
NC_035786.1,31329578,31336069,31329578,31334388,111103402,XM_022436671.1,uncharacterized LOC111103402,4810
NC_035786.1,31724877,31734882,31724877,31734882,111103405,XM_022436681.1,uncharacterized LOC111103405,10005
NC_035786.1,31724877,31734882,31724877,31732835,111103405,XM_022436678.1,uncharacterized LOC111103405,7958
NC_035786.1,31319477,31322955,31319477,31322955,111103410,XM_022436688.1,uncharacterized LOC111103410,3478
NC_035786.1,31470883,31479154,31470883,31479154,111103411,XM_022436689.1,uncharacterized LOC111103411,8271
NC_035786.1,31353010,31360996,31353010,31360996,111103413,XM_022436691.1,uncharacterized LOC111103413,7986
NC_035786.1,31381766,31396297,31381766,31396297,111103420,XM_022436700.1,uncharacterized LOC111103420,14531
NC_035786.1,31381766,31396297,31387842,31396297,111103420,XM_022436701.1,uncharacterized LOC111103420,8455
NC_035786.1,50110938,50114680,50110938,50114680,111103437,XM_022436718.1,uncharacterized LOC111103437,3742
NC_035786.1,50124150,50127784,50124150,50127784,111103438,XM_022436719.1,uncharacterized LOC111103438,3634
NC_035786.1,16027497,16088557,16066742,16088557,111103441,XM_022436724.1,uncharacterized LOC111103441,21815
NC_035786.1,16027497,16088557,16051082,16088557,111103441,XM_022436726.1,uncharacterized LOC111103441,37475
NC_035786.1,16027497,16088557,16051072,16088557,111103441,XM_022436722.1,uncharacterized LOC111103441,37485
NC_035786.1,16027497,16088557,16051067,16088557,111103441,XM_022436725.1,uncharacterized LOC111103441,37490
NC_035786.1,16027497,16088557,16027497,16032705,111103441,XM_022436727.1,uncharacterized LOC111103441,5208
NC_035786.1,16027497,16088557,16027578,16088557,111103441,XM_022436723.1,uncharacterized LOC111103441,60979
NC_035786.1,48625357,48634452,48625357,48634416,111103455,XM_022436741.1,uncharacterized LOC111103455,9059
NC_035786.1,48625357,48634452,48625357,48634452,111103455,XM_022436740.1,uncharacterized LOC111103455,9095
NC_035786.1,54398720,54403715,54398720,54403715,111103457,XM_022436743.1,uncharacterized LOC111103457,4995
NC_035786.1,54323682,54324410,54323682,54324410,111103461,XM_022436746.1,uncharacterized LOC111103461,728
NC_035780.1,2444648,2446603,2444648,2446603,111103463,XM_022436791.1,uncharacterized LOC111103463,1955
NC_035786.1,41477729,41498182,41484945,41498182,111103465,XM_022436758.1,uncharacterized LOC111103465,13237
NC_035786.1,41477729,41498182,41480942,41498182,111103465,XM_022436759.1,uncharacterized LOC111103465,17240
NC_035786.1,41477729,41498182,41480935,41498182,111103465,XM_022436754.1,uncharacterized LOC111103465,17247
NC_035786.1,41477729,41498182,41480932,41498182,111103465,XM_022436753.1,uncharacterized LOC111103465,17250
NC_035786.1,41477729,41498182,41480227,41498182,111103465,XM_022436750.1,uncharacterized LOC111103465,17955
NC_035786.1,41477729,41498182,41477731,41498182,111103465,XM_022436751.1,uncharacterized LOC111103465,20451
NC_035786.1,41477729,41498182,41477730,41498182,111103465,XM_022436755.1,uncharacterized LOC111103465,20452
NC_035786.1,41477729,41498182,41477729,41498182,111103465,XM_022436757.1,uncharacterized LOC111103465,20453
NC_035786.1,40429832,40432440,40429832,40432440,111103467,XM_022436760.1,uncharacterized LOC111103467,2608
NC_035786.1,40393131,40406548,40393131,40406548,111103468,XM_022436763.1,uncharacterized LOC111103468,13417
NC_035786.1,40382571,40388147,40382571,40388147,111103469,XM_022436764.1,uncharacterized LOC111103469,5576
NC_035786.1,40492807,40501306,40492807,40501306,111103470,XM_022436765.1,uncharacterized LOC111103470,8499
NC_035786.1,40421222,40424037,40421222,40424037,111103477,XM_022436771.1,uncharacterized LOC111103477,2815
NC_035786.1,40449605,40467190,40449605,40467190,111103478,XM_022436773.1,uncharacterized LOC111103478,17585
NC_035786.1,43638101,43713312,43638101,43713312,111103479,XM_022436774.1,uncharacterized LOC111103479,75211
NC_035780.1,29493139,29496561,29493139,29496561,111103486,XM_022436801.1,uncharacterized LOC111103486,3422
NC_035786.1,6304306,6305836,6304306,6305836,111103495,XM_022436808.1,uncharacterized LOC111103495,1530
NC_035786.1,23631657,23633839,23631657,23633839,111103503,XM_022436823.1,uncharacterized LOC111103503,2182
NC_035786.1,23689285,23694225,23689285,23694225,111103504,XM_022436824.1,uncharacterized LOC111103504,4940
NC_035786.1,23654241,23656800,23654241,23656800,111103505,XM_022436826.1,uncharacterized LOC111103505,2559
NC_035786.1,23645754,23649054,23645754,23649054,111103506,XM_022436827.1,uncharacterized LOC111103506,3300
NC_035786.1,34673254,34680438,34673254,34680438,111103512,XM_022436837.1,uncharacterized LOC111103512,7184
NC_035780.1,34364997,34366487,34364997,34366487,111103515,XM_022436845.1,uncharacterized LOC111103515,1490
NC_035786.1,8804610,8812341,8807494,8811467,111103517,XM_022436852.1,uncharacterized LOC111103517,3973
NC_035786.1,8804610,8812341,8804610,8811467,111103517,XM_022436848.1,uncharacterized LOC111103517,6857
NC_035786.1,8804610,8812341,8804610,8812341,111103517,XM_022436849.1,uncharacterized LOC111103517,7731
NC_035786.1,8794402,8796001,8794402,8796001,111103521,XM_022436857.1,uncharacterized LOC111103521,1599
NC_035786.1,8788053,8789838,8788053,8789838,111103522,XM_022436859.1,uncharacterized LOC111103522,1785
NC_035786.1,8816745,8818365,8816745,8818365,111103523,XM_022436860.1,uncharacterized LOC111103523,1620
NC_035786.1,8819624,8823520,8819624,8823520,111103524,XM_022436861.1,uncharacterized LOC111103524,3896
NC_035786.1,8805977,8806871,8805977,8806871,111103526,XM_022436863.1,uncharacterized LOC111103526,894
NC_035786.1,22904340,22906987,22904340,22906987,111103527,XM_022436864.1,uncharacterized LOC111103527,2647
NC_035786.1,23078594,23108351,23078594,23108351,111103528,XM_022436866.1,uncharacterized LOC111103528,29757
NC_035786.1,23037504,23040539,23037504,23039912,111103530,XM_022436870.1,uncharacterized LOC111103530,2408
NC_035786.1,23037504,23040539,23037504,23040539,111103530,XM_022436869.1,uncharacterized LOC111103530,3035
NC_035786.1,22964047,22965441,22964047,22965441,111103533,XM_022436873.1,uncharacterized LOC111103533,1394
NC_035786.1,32800027,32802802,32800027,32802802,111103538,XM_022436875.1,uncharacterized LOC111103538,2775
NC_035786.1,36632545,36638315,36632545,36638315,111103540,XM_022436878.1,uncharacterized LOC111103540,5770
NC_035786.1,36676424,36683162,36676424,36683162,111103541,XM_022436879.1,uncharacterized LOC111103541,6738
NC_035786.1,36643828,36649375,36643828,36649375,111103544,XM_022436881.1,uncharacterized LOC111103544,5547
NC_035786.1,15012491,15041031,15012491,15041031,111103555,XM_022436898.1,uncharacterized LOC111103555,28540
NC_035786.1,34455431,34459996,34455431,34459996,111103561,XM_022436912.1,uncharacterized LOC111103561,4565
NC_035786.1,57169808,57187718,57172668,57187718,111103567,XM_022436917.1,uncharacterized LOC111103567,15050
NC_035786.1,57169808,57187718,57169808,57187111,111103567,XM_022436916.1,uncharacterized LOC111103567,17303
NC_035786.1,7904879,7927160,7904879,7927160,111103569,XM_022436920.1,uncharacterized LOC111103569,22281
NC_035780.1,5346926,5349837,5346926,5349837,111103571,XM_022436927.1,uncharacterized LOC111103571,2911
NC_035786.1,7932113,7937181,7934007,7937181,111103575,XM_022436933.1,uncharacterized LOC111103575,3174
NC_035786.1,7932113,7937181,7932113,7937181,111103575,XM_022436934.1,uncharacterized LOC111103575,5068
NC_035780.1,44661430,44666702,44661430,44666655,111103578,XM_022436945.1,uncharacterized LOC111103578,5225
NC_035780.1,44661430,44666702,44661430,44666702,111103578,XM_022436939.1,uncharacterized LOC111103578,5272
NC_035786.1,4612855,4616326,4612855,4616326,111103580,XM_022436936.1,uncharacterized LOC111103580,3471
NC_035786.1,4615466,4618950,4615850,4618946,111103581,XM_022436937.1,uncharacterized LOC111103581,3096
NC_035786.1,4615466,4618950,4615844,4618949,111103581,XM_022436938.1,uncharacterized LOC111103581,3105
NC_035786.1,46149524,46187966,46165403,46187966,111103584,XM_022436941.1,uncharacterized LOC111103584,22563
NC_035786.1,46149524,46187966,46149524,46187966,111103584,XM_022436940.1,uncharacterized LOC111103584,38442
NC_035786.1,46140028,46148002,46140028,46147994,111103585,XM_022436943.1,uncharacterized LOC111103585,7966
NC_035786.1,46140028,46148002,46140028,46148002,111103585,XM_022436942.1,uncharacterized LOC111103585,7974
NC_035786.1,24661297,24733023,24661299,24729822,111103591,XM_022436967.1,uncharacterized LOC111103591,68523
NC_035786.1,24661297,24733023,24661299,24733009,111103591,XM_022436965.1,uncharacterized LOC111103591,71710
NC_035786.1,24661297,24733023,24661297,24733023,111103591,XM_022436966.1,uncharacterized LOC111103591,71726
NC_035780.1,42638329,42641683,42638329,42641683,111103597,XM_022436983.1,uncharacterized LOC111103597,3354
NC_035786.1,185848,190948,185848,190948,111103602,XM_022436986.1,uncharacterized LOC111103602,5100
NC_035786.1,214277,220826,214277,220826,111103603,XM_022436987.1,uncharacterized LOC111103603,6549
NC_035786.1,255274,256712,255274,256712,111103604,XM_022436988.1,uncharacterized LOC111103604,1438
NC_035786.1,47583988,47602071,47591622,47602071,111103605,XM_022436992.1,uncharacterized LOC111103605,10449
NC_035786.1,47583988,47602071,47591537,47602071,111103605,XM_022436994.1,uncharacterized LOC111103605,10534
NC_035786.1,47583988,47602071,47590330,47602071,111103605,XM_022436990.1,uncharacterized LOC111103605,11741
NC_035786.1,47583988,47602071,47585782,47602071,111103605,XM_022436993.1,uncharacterized LOC111103605,16289
NC_035786.1,47583988,47602071,47585772,47602071,111103605,XM_022436991.1,uncharacterized LOC111103605,16299
NC_035786.1,47583988,47602071,47583988,47602071,111103605,XM_022436989.1,uncharacterized LOC111103605,18083
NC_035786.1,47583988,47602071,47593588,47602071,111103605,XM_022436996.1,uncharacterized LOC111103605,8483
NC_035780.1,42643753,42645754,42643753,42645754,111103606,XM_022436995.1,uncharacterized LOC111103606,2001
NC_035780.1,3742213,3743271,3742213,3743271,111103607,XM_022437034.1,uncharacterized LOC111103607,1058
NC_035786.1,454467,455697,454467,455697,111103608,XM_022436998.1,uncharacterized LOC111103608,1230
NC_035786.1,1025693,1027714,1025693,1027714,111103610,XM_022437000.1,uncharacterized LOC111103610,2021
NC_035780.1,42657741,42665196,42657741,42665196,111103613,XM_022437005.1,uncharacterized LOC111103613,7455
NC_035786.1,2023458,2025370,2023458,2025370,111103617,XM_022437006.1,uncharacterized LOC111103617,1912
NC_035786.1,42652655,42660196,42652655,42660196,111103619,XM_022437010.1,uncharacterized LOC111103619,7541
NC_035786.1,2054856,2058761,2054856,2058761,111103621,XM_022437012.1,uncharacterized LOC111103621,3905
NC_035786.1,2074020,2095382,2074020,2095382,111103622,XM_022437013.1,uncharacterized LOC111103622,21362
NC_035786.1,52968143,52974780,52968143,52974780,111103624,XM_022437015.1,uncharacterized LOC111103624,6637
NC_035786.1,2257553,2261468,2257553,2261468,111103626,XM_022437020.1,uncharacterized LOC111103626,3915
NC_035786.1,2587978,2643509,2587978,2643509,111103627,XM_022437021.1,uncharacterized LOC111103627,55531
NC_035786.1,13133923,13169976,13138477,13169976,111103631,XM_022437025.1,uncharacterized LOC111103631,31499
NC_035786.1,13133923,13169976,13138476,13169976,111103631,XM_022437029.1,uncharacterized LOC111103631,31500
NC_035786.1,13133923,13169976,13138475,13169976,111103631,XM_022437028.1,uncharacterized LOC111103631,31501
NC_035786.1,13133923,13169976,13138474,13169976,111103631,XM_022437027.1,uncharacterized LOC111103631,31502
NC_035786.1,13133923,13169976,13133923,13169976,111103631,XM_022437026.1,uncharacterized LOC111103631,36053
NC_035780.1,36550452,36558232,36550452,36558232,111103632,XM_022437030.1,uncharacterized LOC111103632,7780
NC_035786.1,2802740,2803887,2802740,2803887,111103634,XM_022437032.1,uncharacterized LOC111103634,1147
NC_035786.1,19309360,19312769,19309360,19312769,111103636,XM_022437038.1,uncharacterized LOC111103636,3409
NC_035786.1,2813575,2816889,2813575,2816889,111103637,XM_022437039.1,uncharacterized LOC111103637,3314
NC_035780.1,32049480,32054174,32049480,32054174,111103638,XM_022437043.1,uncharacterized LOC111103638,4694
NC_035786.1,3535771,3536784,3535771,3536784,111103640,XM_022437041.1,uncharacterized LOC111103640,1013
NC_035786.1,3777670,3835234,3777670,3835234,111103641,XM_022437042.1,uncharacterized LOC111103641,57564
NC_035786.1,4309805,4311352,4309805,4311352,111103644,XM_022437046.1,uncharacterized LOC111103644,1547
NC_035786.1,17197000,17206649,17197000,17204636,111103649,XM_022437059.1,uncharacterized LOC111103649,7636
NC_035786.1,17197000,17206649,17197000,17206649,111103649,XM_022437058.1,uncharacterized LOC111103649,9649
NC_035786.1,17147259,17158644,17147259,17158644,111103650,XM_022437060.1,uncharacterized LOC111103650,11385
NC_035786.1,17203808,17224651,17223376,17224651,111103651,XM_022437061.1,uncharacterized LOC111103651,1275
NC_035786.1,17203808,17224651,17203808,17224651,111103651,XM_022437062.1,uncharacterized LOC111103651,20843
NC_035786.1,17172648,17177164,17172648,17177164,111103652,XM_022437063.1,uncharacterized LOC111103652,4516
NC_035780.1,16318916,16320746,16318916,16320746,111103653,XM_022437066.1,uncharacterized LOC111103653,1830
NC_035786.1,4854389,4856185,4854389,4856185,111103654,XM_022437064.1,uncharacterized LOC111103654,1796
NC_035786.1,30595932,30602886,30595932,30602886,111103656,XM_022437070.1,uncharacterized LOC111103656,6954
NC_035786.1,4878995,4886776,4878995,4886776,111103657,XM_022437071.1,uncharacterized LOC111103657,7781
NC_035786.1,10315630,10366363,10351519,10366359,111103658,XM_022437073.1,uncharacterized LOC111103658,14840
NC_035786.1,10315630,10366363,10351519,10366363,111103658,XM_022437072.1,uncharacterized LOC111103658,14844
NC_035786.1,10315630,10366363,10336742,10366363,111103658,XM_022437078.1,uncharacterized LOC111103658,29621
NC_035786.1,10315630,10366363,10315630,10349606,111103658,XM_022437075.1,uncharacterized LOC111103658,33976
NC_035786.1,10315630,10366363,10315630,10349764,111103658,XM_022437076.1,uncharacterized LOC111103658,34134
NC_035786.1,10315630,10366363,10315630,10321872,111103658,XM_022437077.1,uncharacterized LOC111103658,6242
NC_035786.1,44806226,44810378,44806226,44810378,111103662,XM_022437081.1,uncharacterized LOC111103662,4152
NC_035786.1,44785478,44789461,44785478,44789461,111103663,XM_022437082.1,uncharacterized LOC111103663,3983
NC_035786.1,44754251,44817536,44758015,44817536,111103664,XM_022437085.1,uncharacterized LOC111103664,59521
NC_035786.1,44754251,44817536,44754251,44817536,111103664,XM_022437086.1,uncharacterized LOC111103664,63285
NC_035786.1,5322364,5327726,5322364,5327726,111103665,XM_022437087.1,uncharacterized LOC111103665,5362
NC_035780.1,17187225,17189508,17187225,17189508,111103666,XM_022437091.1,uncharacterized LOC111103666,2283
NC_035786.1,5395813,5400898,5395813,5400898,111103670,XM_022437092.1,uncharacterized LOC111103670,5085
NC_035786.1,5999104,6001749,5999104,6001749,111103673,XM_022437095.1,uncharacterized LOC111103673,2645
NC_035786.1,6097837,6099289,6097837,6099289,111103674,XM_022437096.1,uncharacterized LOC111103674,1452
NC_035786.1,6127614,6133581,6127614,6133581,111103675,XM_022437097.1,uncharacterized LOC111103675,5967
NC_035786.1,46827520,46845388,46835371,46845388,111103676,XM_022437100.1,uncharacterized LOC111103676,10017
NC_035786.1,46827520,46845388,46833872,46845388,111103676,XM_022437099.1,uncharacterized LOC111103676,11516
NC_035786.1,46827520,46845388,46829511,46845388,111103676,XM_022437101.1,uncharacterized LOC111103676,15877
NC_035786.1,46827520,46845388,46827520,46845388,111103676,XM_022437098.1,uncharacterized LOC111103676,17868
NC_035786.1,46827520,46845388,46837691,46845388,111103676,XM_022437102.1,uncharacterized LOC111103676,7697
NC_035786.1,46827520,46845388,46835636,46845388,111103676,XM_022437104.1,uncharacterized LOC111103676,9752
NC_035786.1,4380401,4395604,4380401,4394455,111103680,XM_022437108.1,uncharacterized LOC111103680,14054
NC_035786.1,4380401,4395604,4380401,4394611,111103680,XM_022437109.1,uncharacterized LOC111103680,14210
NC_035786.1,4380401,4395604,4380401,4395604,111103680,XM_022437110.1,uncharacterized LOC111103680,15203
NC_035786.1,6589326,6627878,6589326,6627878,111103683,XM_022437114.1,uncharacterized LOC111103683,38552
NC_035780.1,54477862,54486517,54481653,54486517,111103684,XM_022437154.1,uncharacterized LOC111103684,4864
NC_035780.1,54477862,54486517,54477862,54486517,111103684,XM_022437272.1,uncharacterized LOC111103684,8655
NC_035786.1,6728228,6732130,6728228,6732130,111103685,XM_022437115.1,uncharacterized LOC111103685,3902
NC_035786.1,6940758,6942394,6940758,6942394,111103686,XM_022437116.1,uncharacterized LOC111103686,1636
NC_035786.1,6964607,6982588,6964607,6982588,111103687,XM_022437117.1,uncharacterized LOC111103687,17981
NC_035780.1,44716073,44719580,44716073,44719580,111103688,XM_022437121.1,uncharacterized LOC111103688,3507
NC_035786.1,6999695,7002018,6999695,7002018,111103689,XM_022437118.1,uncharacterized LOC111103689,2323
NC_035786.1,7060147,7077268,7060147,7077268,111103690,XM_022437119.1,uncharacterized LOC111103690,17121
NC_035786.1,8138155,8143834,8138155,8143834,111103694,XM_022437128.1,uncharacterized LOC111103694,5679
NC_035786.1,8276339,8283037,8276339,8283037,111103695,XM_022437129.1,uncharacterized LOC111103695,6698
NC_035786.1,8564188,8567807,8564188,8567807,111103701,XM_022437143.1,uncharacterized LOC111103701,3619
NC_035786.1,8974979,8976021,8974979,8976021,111103702,XM_022437145.1,uncharacterized LOC111103702,1042
NC_035786.1,9033237,9044794,9033237,9044794,111103704,XM_022437147.1,uncharacterized LOC111103704,11557
NC_035786.1,9264973,9294485,9264973,9294485,111103713,XM_022437157.1,uncharacterized LOC111103713,29512
NC_035786.1,9375907,9377481,9375907,9377481,111103714,XM_022437158.1,uncharacterized LOC111103714,1574
NC_035786.1,9553700,9556150,9553700,9556150,111103716,XM_022437159.1,uncharacterized LOC111103716,2450
NC_035786.1,9869380,9872251,9869380,9872251,111103718,XM_022437161.1,uncharacterized LOC111103718,2871
NC_035780.1,11599100,11609756,11599100,11609756,111103719,XM_022437165.1,uncharacterized LOC111103719,10656
NC_035786.1,10205864,10206756,10205864,10206756,111103720,XM_022437162.1,uncharacterized LOC111103720,892
NC_035786.1,10425827,10429618,10425827,10429618,111103721,XM_022437163.1,uncharacterized LOC111103721,3791
NC_035786.1,35737345,35755351,35737345,35755351,111103724,XM_022437168.1,uncharacterized LOC111103724,18006
NC_035786.1,10571504,10575575,10571504,10575575,111103729,XM_022437171.1,uncharacterized LOC111103729,4071
NC_035786.1,10598716,10600754,10598716,10600754,111103732,XM_022437173.1,uncharacterized LOC111103732,2038
NC_035786.1,11287985,11311876,11287985,11311876,111103733,XM_022437175.1,uncharacterized LOC111103733,23891
NC_035786.1,11607608,11611244,11607608,11611244,111103734,XM_022437176.1,uncharacterized LOC111103734,3636
NC_035786.1,11797294,11833623,11797294,11833623,111103736,XM_022437178.1,uncharacterized LOC111103736,36329
NC_035786.1,11935386,11938754,11935386,11938754,111103737,XM_022437179.1,uncharacterized LOC111103737,3368
NC_035786.1,12286474,12297061,12286474,12297061,111103743,XM_022437184.1,uncharacterized LOC111103743,10587
NC_035786.1,12350293,12351871,12350293,12351871,111103746,XM_022437203.1,uncharacterized LOC111103746,1578
NC_035786.1,12356509,12358285,12356509,12358285,111103747,XM_022437204.1,uncharacterized LOC111103747,1776
NC_035786.1,12431019,12435441,12431019,12435441,111103749,XM_022437205.1,uncharacterized LOC111103749,4422
NC_035786.1,12437433,12439002,12437433,12439002,111103750,XM_022437206.1,uncharacterized LOC111103750,1569
NC_035786.1,12441018,12447239,12441018,12447239,111103751,XM_022437207.1,uncharacterized LOC111103751,6221
NC_035786.1,12996093,12997496,12996093,12997496,111103754,XM_022437211.1,uncharacterized LOC111103754,1403
NC_035786.1,27788220,27809974,27788262,27809974,111103755,XM_022437213.1,uncharacterized LOC111103755,21712
NC_035786.1,27788220,27809974,27788220,27809974,111103755,XM_022437212.1,uncharacterized LOC111103755,21754
NC_035786.1,28031055,28053970,28031055,28050139,111103756,XM_022437216.1,uncharacterized LOC111103756,19084
NC_035786.1,28031055,28053970,28031684,28053970,111103756,XM_022437215.1,uncharacterized LOC111103756,22286
NC_035786.1,28031055,28053970,28031055,28053970,111103756,XM_022437214.1,uncharacterized LOC111103756,22915
NC_035786.1,28060756,28072929,28060756,28072929,111103758,XM_022437218.1,uncharacterized LOC111103758,12173
NC_035786.1,27716944,27757313,27716944,27737032,111103759,XM_022437222.1,uncharacterized LOC111103759,20088
NC_035786.1,27716944,27757313,27716944,27757313,111103759,XM_022437220.1,uncharacterized LOC111103759,40369
NC_035786.1,27765720,27785022,27765720,27783324,111103762,XM_022437224.1,uncharacterized LOC111103762,17604
NC_035786.1,13245547,13246849,13245547,13246849,111103770,XM_022437231.1,uncharacterized LOC111103770,1302
NC_035786.1,13918623,13935251,13918623,13935251,111103774,XM_022437235.1,uncharacterized LOC111103774,16628
NC_035786.1,14107175,14146566,14107175,14146566,111103775,XM_022437236.1,uncharacterized LOC111103775,39391
NC_035780.1,45496210,45499475,45496210,45499475,111103776,XM_022437241.1,uncharacterized LOC111103776,3265
NC_035786.1,14166100,14167218,14166100,14167218,111103777,XM_022437237.1,uncharacterized LOC111103777,1118
NC_035786.1,15010875,15011792,15010875,15011792,111103781,XM_022437245.1,uncharacterized LOC111103781,917
NC_035786.1,36048055,36084897,36048055,36084897,111103782,XM_022437246.1,uncharacterized LOC111103782,36842
NC_035786.1,36097684,36117788,36105233,36117788,111103783,XM_022437251.1,uncharacterized LOC111103783,12555
NC_035786.1,36097684,36117788,36101317,36117788,111103783,XM_022437249.1,uncharacterized LOC111103783,16471
NC_035786.1,36097684,36117788,36101228,36117788,111103783,XM_022437252.1,uncharacterized LOC111103783,16560
NC_035786.1,36097684,36117788,36099568,36117788,111103783,XM_022437248.1,uncharacterized LOC111103783,18220
NC_035786.1,36097684,36117788,36097684,36117788,111103783,XM_022437250.1,uncharacterized LOC111103783,20104
NC_035780.1,33521053,33526735,33521053,33526735,111103784,XM_022437254.1,uncharacterized LOC111103784,5682
NC_035780.1,52876110,52884332,52876110,52884332,111103791,XM_022437267.1,uncharacterized LOC111103791,8222
NC_035786.1,19572195,19574539,19572195,19574539,111103793,XM_022437268.1,uncharacterized LOC111103793,2344
NC_035780.1,53454990,53457811,53454990,53457811,111103797,XM_022437279.1,uncharacterized LOC111103797,2821
NC_035786.1,35013221,35014960,35013221,35014960,111103798,XM_022437277.1,uncharacterized LOC111103798,1739
NC_035786.1,28500449,28507293,28500449,28507293,111103806,XM_022437293.1,uncharacterized LOC111103806,6844
NC_035786.1,33190550,33243685,33190550,33243685,111103807,XM_022437294.1,uncharacterized LOC111103807,53135
NC_035786.1,33193667,33196644,33193667,33196644,111103808,XM_022437295.1,uncharacterized LOC111103808,2977
NC_035786.1,46420569,46457768,46442270,46457768,111103809,XM_022437296.1,uncharacterized LOC111103809,15498
NC_035786.1,46420569,46457768,46436631,46457768,111103809,XM_022437300.1,uncharacterized LOC111103809,21137
NC_035786.1,46420569,46457768,46436057,46457768,111103809,XM_022437301.1,uncharacterized LOC111103809,21711
NC_035786.1,46420569,46457768,46433232,46457768,111103809,XM_022437303.1,uncharacterized LOC111103809,24536
NC_035786.1,46420569,46457768,46420667,46457768,111103809,XM_022437299.1,uncharacterized LOC111103809,37101
NC_035786.1,46420569,46457768,46420569,46457768,111103809,XM_022437297.1,uncharacterized LOC111103809,37199
NC_035786.1,46420569,46457768,46450066,46457768,111103809,XM_022437304.1,uncharacterized LOC111103809,7702
NC_035786.1,5506070,5520563,5507161,5520563,111103811,XM_022437307.1,uncharacterized LOC111103811,13402
NC_035786.1,5506070,5520563,5506070,5520563,111103811,XM_022437306.1,uncharacterized LOC111103811,14493
NC_035786.1,52142454,52143689,52142454,52143689,111103815,XM_022437325.1,uncharacterized LOC111103815,1235
NC_035786.1,47138846,47143483,47138846,47143483,111103818,XM_022437328.1,uncharacterized LOC111103818,4637
NC_035780.1,43824205,43826755,43824205,43826755,111103828,XM_022437405.1,uncharacterized LOC111103828,2550
NC_035786.1,6017941,6025176,6018166,6025176,111103829,XM_022437365.1,uncharacterized LOC111103829,7010
NC_035786.1,6017941,6025176,6017941,6025176,111103829,XM_022437366.1,uncharacterized LOC111103829,7235
NC_035780.1,43436750,43443497,43436750,43443497,111103831,XM_022437371.1,uncharacterized LOC111103831,6747
NC_035786.1,35181395,35186449,35181395,35186449,111103837,XM_022437378.1,uncharacterized LOC111103837,5054
NC_035786.1,35208478,35213483,35209355,35213483,111103838,XM_022437380.1,uncharacterized LOC111103838,4128
NC_035786.1,35208478,35213483,35208478,35213483,111103838,XM_022437379.1,uncharacterized LOC111103838,5005
NC_035786.1,35351944,35354999,35351944,35354999,111103841,XM_022437386.1,uncharacterized LOC111103841,3055
NC_035786.1,35269489,35282783,35269489,35282783,111103843,XM_022437389.1,uncharacterized LOC111103843,13294
NC_035786.1,35254284,35260107,35254284,35260107,111103844,XM_022437390.1,uncharacterized LOC111103844,5823
NC_035786.1,35340570,35344960,35340570,35344960,111103845,XM_022437391.1,uncharacterized LOC111103845,4390
NC_035780.1,11878270,11884755,11882719,11884755,111103846,XM_022437397.1,uncharacterized LOC111103846,2036
NC_035786.1,35394692,35414983,35394692,35414976,111103848,XM_022437402.1,uncharacterized LOC111103848,20284
NC_035786.1,35394692,35414983,35412340,35414983,111103848,XM_022437401.1,uncharacterized LOC111103848,2643
NC_035786.1,35221079,35224527,35221079,35224527,111103849,XM_022437403.1,uncharacterized LOC111103849,3448
NC_035786.1,35408198,35411057,35408198,35411057,111103850,XM_022437404.1,uncharacterized LOC111103850,2859
NC_035786.1,35336237,35339112,35336237,35339112,111103851,XM_022437406.1,uncharacterized LOC111103851,2875
NC_035786.1,35284888,35290501,35284888,35290501,111103852,XM_022437407.1,uncharacterized LOC111103852,5613
NC_035786.1,12385913,12388530,12385913,12388530,111103859,XM_022437416.1,uncharacterized LOC111103859,2617
NC_035786.1,48640051,48649885,48640052,48649885,111103860,XM_022437418.1,uncharacterized LOC111103860,9833
NC_035786.1,48640051,48649885,48640051,48649885,111103860,XM_022437417.1,uncharacterized LOC111103860,9834
NC_035786.1,48661333,48665095,48661333,48665095,111103861,XM_022437419.1,uncharacterized LOC111103861,3762
NC_035786.1,48656648,48659841,48658254,48659841,111103863,XM_022437421.1,uncharacterized LOC111103863,1587
NC_035786.1,48656648,48659841,48656648,48659841,111103863,XM_022437420.1,uncharacterized LOC111103863,3193
NC_035786.1,51814859,51827648,51814859,51827648,111103870,XM_022437433.1,uncharacterized LOC111103870,12789
NC_035786.1,51720902,51813553,51741100,51813553,111103871,XM_022437437.1,uncharacterized LOC111103871,72453
NC_035786.1,51720902,51813553,51720902,51802070,111103871,XM_022437435.1,uncharacterized LOC111103871,81168
NC_035786.1,51720902,51813553,51720902,51813553,111103871,XM_022437434.1,uncharacterized LOC111103871,92651
NC_035786.1,17898109,17931099,17898109,17931099,111103875,XM_022437443.1,uncharacterized LOC111103875,32990
NC_035786.1,17879252,17894101,17879252,17894101,111103876,XM_022437444.1,uncharacterized LOC111103876,14849
NC_035786.1,17956643,18047781,17956643,17976823,111103877,XM_022437452.1,uncharacterized LOC111103877,20180
NC_035786.1,17956643,18047781,17956643,17982026,111103877,XM_022437447.1,uncharacterized LOC111103877,25383
NC_035786.1,17956643,18047781,17956643,18047781,111103877,XM_022437446.1,uncharacterized LOC111103877,91138
NC_035786.1,17866149,17870646,17866149,17870646,111103878,XM_022437454.1,uncharacterized LOC111103878,4497
NC_035786.1,37430393,37450702,37430393,37448924,111103880,XM_022437460.1,uncharacterized LOC111103880,18531
NC_035786.1,37430393,37450702,37430393,37450702,111103880,XM_022437459.1,uncharacterized LOC111103880,20309
NC_035786.1,37430393,37450702,37430393,37435152,111103880,XM_022437458.1,uncharacterized LOC111103880,4759
NC_035786.1,37435377,37438634,37435377,37438634,111103881,XM_022437461.1,uncharacterized LOC111103881,3257
NC_035786.1,5823354,5831079,5823354,5831079,111103882,XM_022437462.1,uncharacterized LOC111103882,7725
NC_035786.1,5818162,5832773,5818162,5832773,111103883,XM_022437464.1,uncharacterized LOC111103883,14611
NC_035786.1,5818162,5832773,5818162,5821149,111103883,XM_022437465.1,uncharacterized LOC111103883,2987
NC_035786.1,42211200,42235615,42211200,42235615,111103884,XM_022437466.1,uncharacterized LOC111103884,24415
NC_035786.1,38655306,38658672,38655306,38658672,111103887,XM_022437469.1,uncharacterized LOC111103887,3366
NC_035786.1,24068599,24075069,24068599,24075069,111103895,XM_022437483.1,uncharacterized LOC111103895,6470
NC_035786.1,24134567,24170053,24134567,24170053,111103898,XM_022437492.1,uncharacterized LOC111103898,35486
NC_035786.1,52014002,52019253,52014005,52017641,111103902,XM_022437509.1,uncharacterized LOC111103902,3636
NC_035786.1,52014002,52019253,52014115,52019253,111103902,XM_022437508.1,uncharacterized LOC111103902,5138
NC_035786.1,52006617,52013000,52006617,52013000,111103903,XM_022437510.1,uncharacterized LOC111103903,6383
NC_035786.1,51131831,51138988,51131831,51138988,111103904,XM_022437513.1,uncharacterized LOC111103904,7157
NC_035786.1,51098137,51103234,51098137,51103234,111103905,XM_022437514.1,uncharacterized LOC111103905,5097
NC_035786.1,51108873,51125310,51108873,51125310,111103906,XM_022437516.1,uncharacterized LOC111103906,16437
NC_035786.1,5527518,5535373,5527518,5535373,111103909,XM_022437530.1,uncharacterized LOC111103909,7855
NC_035786.1,53971239,53990423,53971239,53990423,111103917,XM_022437539.1,uncharacterized LOC111103917,19184
NC_035786.1,53965710,53970004,53965710,53970004,111103918,XM_022437540.1,uncharacterized LOC111103918,4294
NC_035786.1,53992994,54001221,53992994,54001221,111103919,XM_022437541.1,uncharacterized LOC111103919,8227
NC_035786.1,29197838,29207919,29197838,29207912,111103921,XM_022437543.1,uncharacterized LOC111103921,10074
NC_035786.1,29197838,29207919,29197838,29207919,111103921,XM_022437542.1,uncharacterized LOC111103921,10081
NC_035786.1,47230326,47234694,47230326,47234694,111103923,XM_022437546.1,uncharacterized LOC111103923,4368
NC_035786.1,11453386,11472338,11453386,11472026,111103928,XM_022437553.1,uncharacterized LOC111103928,18640
NC_035786.1,11453386,11472338,11453386,11472095,111103928,XM_022437552.1,uncharacterized LOC111103928,18709
NC_035786.1,11453386,11472338,11453386,11472099,111103928,XM_022437551.1,uncharacterized LOC111103928,18713
NC_035786.1,11453386,11472338,11453386,11472338,111103928,XM_022437549.1,uncharacterized LOC111103928,18952
NC_035780.1,54293108,54295397,54293108,54295196,111103929,XM_022437557.1,uncharacterized LOC111103929,2088
NC_035780.1,54293108,54295397,54293108,54295397,111103929,XM_022437567.1,uncharacterized LOC111103929,2289
NC_035786.1,23484452,23488985,23484452,23488985,111103931,XM_022437565.1,uncharacterized LOC111103931,4533
NC_035786.1,8511524,8545236,8511833,8545236,111103932,XM_022437568.1,uncharacterized LOC111103932,33403
NC_035786.1,8511524,8545236,8511524,8545236,111103932,XM_022437566.1,uncharacterized LOC111103932,33712
NC_035786.1,8495219,8510478,8495245,8510478,111103933,XM_022437569.1,uncharacterized LOC111103933,15233
NC_035786.1,8495219,8510478,8495219,8510478,111103933,XM_022437570.1,uncharacterized LOC111103933,15259
NC_035786.1,8468790,8477648,8468790,8477648,111103934,XM_022437571.1,uncharacterized LOC111103934,8858
NC_035786.1,51876875,51881221,51876875,51881221,111103939,XM_022437577.1,uncharacterized LOC111103939,4346
NC_035786.1,53857714,53872714,53857714,53872714,111103941,XM_022437582.1,uncharacterized LOC111103941,15000
NC_035786.1,53875849,53885473,53875849,53885473,111103942,XM_022437583.1,uncharacterized LOC111103942,9624
NC_035780.1,63478163,63487870,63478163,63487870,111103946,XM_022437596.1,uncharacterized LOC111103946,9707
NC_035786.1,22487442,22492402,22487576,22492402,111103947,XM_022437594.1,uncharacterized LOC111103947,4826
NC_035786.1,22487442,22492402,22487442,22492402,111103947,XM_022437593.1,uncharacterized LOC111103947,4960
NC_035786.1,23363451,23367719,23363451,23367719,111103949,XM_022437600.1,uncharacterized LOC111103949,4268
NC_035786.1,23306254,23373541,23306254,23348120,111103950,XM_022437601.1,uncharacterized LOC111103950,41866
NC_035786.1,23306254,23373541,23306254,23352518,111103950,XM_022437603.1,uncharacterized LOC111103950,46264
NC_035786.1,23306254,23373541,23306254,23373541,111103950,XM_022437602.1,uncharacterized LOC111103950,67287
NC_035786.1,44043897,44064665,44043897,44064665,111103957,XM_022437614.1,uncharacterized LOC111103957,20768
NC_035786.1,1904914,1958247,1916226,1958247,111103959,XM_022437618.1,uncharacterized LOC111103959,42021
NC_035786.1,1904914,1958247,1916212,1958247,111103959,XM_022437617.1,uncharacterized LOC111103959,42035
NC_035786.1,1904914,1958247,1911470,1958247,111103959,XM_022437616.1,uncharacterized LOC111103959,46777
NC_035780.1,56751086,56755751,56751086,56755751,111103960,XM_022437620.1,uncharacterized LOC111103960,4665
NC_035786.1,53389464,53419264,53389464,53419264,111103964,XM_022437624.1,uncharacterized LOC111103964,29800
NC_035786.1,56283226,56308267,56294169,56308267,111103965,XM_022437626.1,uncharacterized LOC111103965,14098
NC_035786.1,56283226,56308267,56294135,56308267,111103965,XM_022437628.1,uncharacterized LOC111103965,14132
NC_035786.1,56283226,56308267,56294131,56308267,111103965,XM_022437627.1,uncharacterized LOC111103965,14136
NC_035786.1,56283226,56308267,56283232,56308267,111103965,XM_022437629.1,uncharacterized LOC111103965,25035
NC_035786.1,56283226,56308267,56283226,56308267,111103965,XM_022437630.1,uncharacterized LOC111103965,25041
NC_035786.1,5866639,5924028,5866639,5924028,111103970,XM_022437639.1,uncharacterized LOC111103970,57389
NC_035786.1,5900193,5901663,5900193,5901663,111103971,XM_022437640.1,uncharacterized LOC111103971,1470
NC_035786.1,7716499,7727410,7716499,7727410,111103976,XM_022437644.1,uncharacterized LOC111103976,10911
NC_035786.1,32075518,32093147,32075518,32093147,111103977,XM_022437645.1,uncharacterized LOC111103977,17629
NC_035786.1,10001514,10009558,10002193,10009558,111103979,XM_022437649.1,uncharacterized LOC111103979,7365
NC_035786.1,10001514,10009558,10001514,10009558,111103979,XM_022437648.1,uncharacterized LOC111103979,8044
NC_035786.1,54656296,54681460,54656296,54681460,111103980,XM_022437650.1,uncharacterized LOC111103980,25164
NC_035786.1,30505551,30567144,30505551,30567144,111103991,XM_022437665.1,uncharacterized LOC111103991,61593
NC_035786.1,54981840,55181899,54981840,55181899,111103995,XM_022437675.1,uncharacterized LOC111103995,200059
NC_035786.1,54763444,54943338,54770245,54943322,111103996,XM_022437682.1,uncharacterized LOC111103996,173077
NC_035786.1,54763444,54943338,54763444,54943328,111103996,XM_022437676.1,uncharacterized LOC111103996,179884
NC_035786.1,54763444,54943338,54763444,54943338,111103996,XM_022437677.1,uncharacterized LOC111103996,179894
NC_035786.1,54763444,54943338,54763444,54850491,111103996,XM_022437679.1,uncharacterized LOC111103996,87047
NC_035780.1,19078331,19091147,19078331,19091147,111103997,XM_022437684.1,uncharacterized LOC111103997,12816
NC_035786.1,54851213,54881879,54851608,54881879,111103998,XM_022437685.1,uncharacterized LOC111103998,30271
NC_035786.1,54851213,54881879,54851213,54881879,111103998,XM_022437683.1,uncharacterized LOC111103998,30666
NC_035786.1,54947065,54973372,54947065,54973372,111103999,XM_022437686.1,uncharacterized LOC111103999,26307
NC_035786.1,55184285,55196886,55184285,55196886,111104000,XM_022437687.1,uncharacterized LOC111104000,12601
NC_035786.1,54918204,54920909,54918204,54920909,111104001,XM_022437688.1,uncharacterized LOC111104001,2705
NC_035786.1,55185312,55190005,55185312,55190005,111104002,XM_022437689.1,uncharacterized LOC111104002,4693
NC_035786.1,54891207,54895407,54891207,54895407,111104004,XM_022437691.1,uncharacterized LOC111104004,4200
NC_035786.1,54693973,54697969,54693973,54697969,111104005,XM_022437692.1,uncharacterized LOC111104005,3996
NC_035786.1,54974116,54976583,54974116,54976583,111104006,XM_022437693.1,uncharacterized LOC111104006,2467
NC_035780.1,60828363,60839660,60828363,60839660,111104011,XM_022437725.1,uncharacterized LOC111104011,11297
NC_035780.1,60828363,60839660,60832042,60837681,111104011,XM_022437740.1,uncharacterized LOC111104011,5639
NC_035780.1,60828363,60839660,60832042,60839660,111104011,XM_022437708.1,uncharacterized LOC111104011,7618
NC_035780.1,60828363,60839660,60832002,60839660,111104011,XM_022437733.1,uncharacterized LOC111104011,7658
NC_035780.1,60828363,60839660,60831741,60839660,111104011,XM_022437716.1,uncharacterized LOC111104011,7919
NC_035780.1,60828363,60839660,60828369,60837681,111104011,XM_022437747.1,uncharacterized LOC111104011,9312
NC_035786.1,52831900,52846399,52831900,52846399,111104013,XM_022437706.1,uncharacterized LOC111104013,14499
NC_035786.1,52854376,52864141,52854376,52864141,111104014,XM_022437707.1,uncharacterized LOC111104014,9765
NC_035786.1,52842480,52844880,52843415,52844880,111104015,XM_022437709.1,uncharacterized LOC111104015,1465
NC_035786.1,52842480,52844880,52842480,52844880,111104015,XM_022437710.1,uncharacterized LOC111104015,2400
NC_035786.1,52809696,52830380,52809696,52830380,111104016,XM_022437711.1,uncharacterized LOC111104016,20684
NC_035786.1,55244251,55402427,55244251,55402426,111104023,XM_022437722.1,uncharacterized LOC111104023,158175
NC_035786.1,55244251,55402427,55244251,55402427,111104023,XM_022437721.1,uncharacterized LOC111104023,158176
NC_035786.1,40876522,40920166,40876522,40920166,111104024,XM_022437723.1,uncharacterized LOC111104024,43644
NC_035786.1,40936833,40943331,40936833,40943331,111104025,XM_022437724.1,uncharacterized LOC111104025,6498
NC_035786.1,40861031,40868091,40861031,40868091,111104026,XM_022437726.1,uncharacterized LOC111104026,7060
NC_035786.1,26606946,26610114,26606946,26610114,111104030,XM_022437731.1,uncharacterized LOC111104030,3168
NC_035786.1,26602591,26605749,26602591,26605749,111104031,XM_022437734.1,uncharacterized LOC111104031,3158
NC_035786.1,38692858,38694828,38692858,38694828,111104032,XM_022437735.1,uncharacterized LOC111104032,1970
NC_035786.1,21252883,21265477,21252883,21265477,111104033,XM_022437736.1,uncharacterized LOC111104033,12594
NC_035786.1,21207213,21252560,21207213,21252560,111104034,XM_022437737.1,uncharacterized LOC111104034,45347
NC_035786.1,21244362,21245378,21244362,21245378,111104035,XM_022437738.1,uncharacterized LOC111104035,1016
NC_035786.1,50959858,50962932,50959858,50962932,111104039,XM_022437742.1,uncharacterized LOC111104039,3074
NC_035786.1,28406243,28471521,28406243,28471517,111104044,XM_022437749.1,uncharacterized LOC111104044,65274
NC_035786.1,28406243,28471521,28406243,28471521,111104044,XM_022437748.1,uncharacterized LOC111104044,65278
NC_035786.1,54171471,54188854,54171471,54188854,111104046,XM_022437751.1,uncharacterized LOC111104046,17383
NC_035786.1,55404733,55431463,55404733,55426556,111104048,XM_022437755.1,uncharacterized LOC111104048,21823
NC_035786.1,55404733,55431463,55407222,55431463,111104048,XM_022437754.1,uncharacterized LOC111104048,24241
NC_035786.1,55404733,55431463,55404733,55431463,111104048,XM_022437753.1,uncharacterized LOC111104048,26730
NC_035786.1,21739917,21751266,21739917,21751266,111104050,XM_022437756.1,uncharacterized LOC111104050,11349
NC_035786.1,21732331,21739826,21732331,21739826,111104051,XM_022437758.1,uncharacterized LOC111104051,7495
NC_035780.1,7875702,7894869,7875702,7887254,111104056,XM_022437781.1,uncharacterized LOC111104056,11552
NC_035780.1,7875702,7894869,7875702,7894869,111104056,XM_022437772.1,uncharacterized LOC111104056,19167
NC_035786.1,14678110,14680088,14678110,14680088,111104057,XM_022437770.1,uncharacterized LOC111104057,1978
NC_035786.1,1361663,1391107,1361663,1391107,111104062,XM_022437779.1,uncharacterized LOC111104062,29444
NC_035786.1,1089101,1095559,1089101,1095539,111104066,XM_022437798.1,uncharacterized LOC111104066,6438
NC_035786.1,1089101,1095559,1089101,1095559,111104066,XM_022437797.1,uncharacterized LOC111104066,6458
NC_035786.1,1154285,1159033,1154285,1159032,111104067,XM_022437799.1,uncharacterized LOC111104067,4747
NC_035786.1,1154285,1159033,1154285,1159033,111104067,XM_022437801.1,uncharacterized LOC111104067,4748
NC_035786.1,1131325,1134893,1131325,1134893,111104069,XM_022437803.1,uncharacterized LOC111104069,3568
NC_035780.1,26651062,26653186,26651062,26653186,111104079,XM_022437815.1,uncharacterized LOC111104079,2124
NC_035786.1,13512367,13514482,13512367,13514482,111104081,XM_022437813.1,uncharacterized LOC111104081,2115
NC_035786.1,52875651,52883967,52875651,52883967,111104082,XM_022437816.1,uncharacterized LOC111104082,8316
NC_035786.1,39256845,39263890,39256845,39263890,111104094,XM_022437838.1,uncharacterized LOC111104094,7045
NC_035786.1,47081951,47118181,47103017,47118181,111104098,XM_022437845.1,uncharacterized LOC111104098,15164
NC_035786.1,47081951,47118181,47098224,47118181,111104098,XM_022437849.1,uncharacterized LOC111104098,19957
NC_035786.1,47081951,47118181,47094741,47118181,111104098,XM_022437847.1,uncharacterized LOC111104098,23440
NC_035786.1,47081951,47118181,47082117,47118181,111104098,XM_022437848.1,uncharacterized LOC111104098,36064
NC_035786.1,47081951,47118181,47081951,47118181,111104098,XM_022437846.1,uncharacterized LOC111104098,36230
NC_035786.1,22585597,22616790,22596121,22608154,111104108,XM_022437862.1,uncharacterized LOC111104108,12033
NC_035786.1,22585597,22616790,22585597,22608154,111104108,XM_022437861.1,uncharacterized LOC111104108,22557
NC_035786.1,22585597,22616790,22585597,22616790,111104108,XM_022437864.1,uncharacterized LOC111104108,31193
NC_035786.1,45299730,45394274,45299730,45378252,111104116,XM_022437885.1,uncharacterized LOC111104116,78522
NC_035786.1,45299730,45394274,45299730,45380312,111104116,XM_022437886.1,uncharacterized LOC111104116,80582
NC_035786.1,45299730,45394274,45299730,45390485,111104116,XM_022437883.1,uncharacterized LOC111104116,90755
NC_035786.1,45299730,45394274,45299730,45392407,111104116,XM_022437887.1,uncharacterized LOC111104116,92677
NC_035786.1,45299730,45394274,45299730,45392408,111104116,XM_022437889.1,uncharacterized LOC111104116,92678
NC_035786.1,45299730,45394274,45299730,45394274,111104116,XM_022437884.1,uncharacterized LOC111104116,94544
NC_035786.1,16912195,16916173,16912195,16916173,111104120,XM_022437894.1,uncharacterized LOC111104120,3978
NC_035786.1,16891462,16918583,16891462,16918583,111104121,XM_022437895.1,uncharacterized LOC111104121,27121
NC_035786.1,5786884,5792929,5787787,5792929,111104124,XM_022437906.1,uncharacterized LOC111104124,5142
NC_035786.1,5786884,5792929,5787641,5792929,111104124,XM_022437904.1,uncharacterized LOC111104124,5288
NC_035786.1,5786884,5792929,5787636,5792926,111104124,XM_022437899.1,uncharacterized LOC111104124,5290
NC_035786.1,5786884,5792929,5787636,5792928,111104124,XM_022437900.1,uncharacterized LOC111104124,5292
NC_035786.1,5786884,5792929,5787636,5792929,111104124,XM_022437901.1,uncharacterized LOC111104124,5293
NC_035786.1,5786884,5792929,5786912,5792929,111104124,XM_022437905.1,uncharacterized LOC111104124,6017
NC_035786.1,5786884,5792929,5786884,5792929,111104124,XM_022437903.1,uncharacterized LOC111104124,6045
NC_035786.1,20674171,20689382,20675529,20689382,111104129,XM_022437916.1,uncharacterized LOC111104129,13853
NC_035786.1,20674171,20689382,20674171,20689382,111104129,XM_022437915.1,uncharacterized LOC111104129,15211
NC_035786.1,20674171,20689382,20680494,20689382,111104129,XM_022437913.1,uncharacterized LOC111104129,8888
NC_035786.1,7571388,7575328,7571388,7575328,111104130,XM_022437918.1,uncharacterized LOC111104130,3940
NC_035786.1,42956796,42961198,42956796,42961198,111104144,XM_022437940.1,uncharacterized LOC111104144,4402
NC_035786.1,40316776,40355699,40316776,40331626,111104146,XM_022437943.1,uncharacterized LOC111104146,14850
NC_035786.1,40316776,40355699,40316776,40333101,111104146,XM_022437942.1,uncharacterized LOC111104146,16325
NC_035786.1,40316776,40355699,40316776,40355699,111104146,XM_022437944.1,uncharacterized LOC111104146,38923
NC_035786.1,5370753,5374220,5370753,5374220,111104150,XM_022437949.1,uncharacterized LOC111104150,3467
NC_035786.1,5378836,5382249,5378836,5382249,111104151,XM_022437950.1,uncharacterized LOC111104151,3413
NC_035786.1,21647778,21686697,21661159,21686697,111104161,XM_022437966.1,uncharacterized LOC111104161,25538
NC_035786.1,21647778,21686697,21647778,21686697,111104161,XM_022437965.1,uncharacterized LOC111104161,38919
NC_035780.1,36965618,36988021,36965618,36988021,111104172,XM_022437982.1,uncharacterized LOC111104172,22403
NC_035786.1,28714867,28731324,28714867,28731324,111104177,XM_022437985.1,uncharacterized LOC111104177,16457
NC_035786.1,26869372,26878433,26869372,26878433,111104192,XM_022438018.1,uncharacterized LOC111104192,9061
NC_035786.1,26616945,26618003,26616945,26618003,111104202,XM_022438036.1,uncharacterized LOC111104202,1058
NC_035786.1,27118465,27119548,27118465,27119548,111104203,XM_022438037.1,uncharacterized LOC111104203,1083
NC_035786.1,27158261,27159388,27158261,27159388,111104204,XM_022438038.1,uncharacterized LOC111104204,1127
NC_035786.1,26677446,26682797,26677510,26682796,111104208,XM_022438045.1,uncharacterized LOC111104208,5286
NC_035786.1,26677446,26682797,26677510,26682797,111104208,XM_022438043.1,uncharacterized LOC111104208,5287
NC_035786.1,26677446,26682797,26677446,26682797,111104208,XM_022438044.1,uncharacterized LOC111104208,5351
NC_035786.1,26690347,26697774,26695073,26697774,111104211,XM_022438049.1,uncharacterized LOC111104211,2701
NC_035786.1,26690347,26697774,26693814,26697774,111104211,XM_022438050.1,uncharacterized LOC111104211,3960
NC_035786.1,26690347,26697774,26690347,26697774,111104211,XM_022438048.1,uncharacterized LOC111104211,7427
NC_035786.1,27142203,27145404,27142203,27145404,111104213,XM_022438052.1,uncharacterized LOC111104213,3201
NC_035786.1,26712108,26715319,26712108,26715319,111104214,XM_022438053.1,uncharacterized LOC111104214,3211
NC_035786.1,27172044,27176023,27172044,27176023,111104215,XM_022438054.1,uncharacterized LOC111104215,3979
NC_035786.1,26642622,26643660,26642622,26643660,111104216,XM_022438055.1,uncharacterized LOC111104216,1038
NC_035786.1,32264320,32278018,32264320,32278018,111104224,XM_022438062.1,uncharacterized LOC111104224,13698
NC_035780.1,63359928,63364103,63359928,63364103,111104225,XM_022438066.1,uncharacterized LOC111104225,4175
NC_035786.1,32375367,32393313,32375367,32393313,111104226,XM_022438063.1,uncharacterized LOC111104226,17946
NC_035786.1,32244993,32249870,32244993,32249870,111104227,XM_022438065.1,uncharacterized LOC111104227,4877
NC_035780.1,23166042,23168172,23166042,23168172,111104232,XM_022438078.1,uncharacterized LOC111104232,2130
NC_035786.1,15889318,15891079,15889318,15891079,111104241,XM_022438083.1,uncharacterized LOC111104241,1761
NC_035786.1,46100092,46117367,46100092,46117367,111104246,XM_022438090.1,uncharacterized LOC111104246,17275
NC_035780.1,7623007,7628394,7623007,7628394,111104267,XM_022438119.1,uncharacterized LOC111104267,5387
NC_035780.1,39775549,39788274,39775549,39788274,111104271,XM_022438132.1,uncharacterized LOC111104271,12725
NC_035786.1,29950800,29954272,29950800,29954272,111104272,XM_022438130.1,uncharacterized LOC111104272,3472
NC_035786.1,40514576,40525646,40514576,40525646,111104274,XM_022438131.1,uncharacterized LOC111104274,11070
NC_035786.1,36940930,36943841,36940930,36943841,111104278,XM_022438137.1,uncharacterized LOC111104278,2911
NC_035780.1,5356777,5361548,5356777,5361545,111104281,XM_022438153.1,uncharacterized LOC111104281,4768
NC_035780.1,5356777,5361548,5356777,5361548,111104281,XM_022438143.1,uncharacterized LOC111104281,4771
NC_035786.1,42624045,42630190,42624045,42630190,111104286,XM_022438148.1,uncharacterized LOC111104286,6145
NC_035786.1,42602824,42623146,42602824,42616874,111104287,XM_022438152.1,uncharacterized LOC111104287,14050
NC_035786.1,42602824,42623146,42602824,42617134,111104287,XM_022438150.1,uncharacterized LOC111104287,14310
NC_035786.1,42602824,42623146,42602824,42623146,111104287,XM_022438149.1,uncharacterized LOC111104287,20322
NC_035786.1,42602824,42623146,42602824,42610909,111104287,XM_022438151.1,uncharacterized LOC111104287,8085
NC_035786.1,42602824,42623146,42602824,42610992,111104287,XM_022438154.1,uncharacterized LOC111104287,8168
NC_035786.1,32609216,32610428,32609216,32610428,111104290,XM_022438156.1,uncharacterized LOC111104290,1212
NC_035786.1,47724154,47727260,47724154,47727260,111104292,XM_022438158.1,uncharacterized LOC111104292,3106
NC_035786.1,52432401,52434413,52432401,52434413,111104296,XM_022438162.1,uncharacterized LOC111104296,2012
NC_035786.1,53172096,53173123,53172096,53173123,111104307,XM_022438176.1,uncharacterized LOC111104307,1027
NC_035786.1,39804993,39807913,39804993,39807913,111104308,XM_022438177.1,uncharacterized LOC111104308,2920
NC_035786.1,50231481,50235261,50231481,50235261,111104309,XM_022438178.1,uncharacterized LOC111104309,3780
NC_035786.1,5762032,5772160,5762032,5772159,111104311,XM_022438179.1,uncharacterized LOC111104311,10127
NC_035786.1,5762032,5772160,5766673,5772160,111104311,XM_022438181.1,uncharacterized LOC111104311,5487
NC_035786.1,5762032,5772160,5766656,5772160,111104311,XM_022438180.1,uncharacterized LOC111104311,5504
NC_035786.1,49410999,49415273,49410999,49415273,111104317,XM_022438197.1,uncharacterized LOC111104317,4274
NC_035786.1,49410197,49412621,49410197,49412621,111104318,XM_022438198.1,uncharacterized LOC111104318,2424
NC_035786.1,12535943,12542376,12535943,12542376,111104321,XM_022438201.1,uncharacterized LOC111104321,6433
NC_035786.1,12616836,12623504,12616836,12623504,111104322,XM_022438203.1,uncharacterized LOC111104322,6668
NC_035786.1,12560996,12566009,12560996,12566009,111104323,XM_022438206.1,uncharacterized LOC111104323,5013
NC_035786.1,32440233,32443368,32440233,32443368,111104331,XM_022438224.1,uncharacterized LOC111104331,3135
NC_035786.1,36127568,36134815,36127568,36134815,111104332,XM_022438225.1,uncharacterized LOC111104332,7247
NC_035786.1,37406593,37413723,37406593,37413723,111104334,XM_022438226.1,uncharacterized LOC111104334,7130
NC_035786.1,20057627,20061005,20057627,20061005,111104336,XM_022438227.1,uncharacterized LOC111104336,3378
NC_035786.1,20065168,20066940,20065168,20066940,111104337,XM_022438228.1,uncharacterized LOC111104337,1772
NC_035786.1,44209203,44251466,44209592,44251466,111104340,XM_022438232.1,uncharacterized LOC111104340,41874
NC_035786.1,44209203,44251466,44209203,44251466,111104340,XM_022438233.1,uncharacterized LOC111104340,42263
NC_035786.1,44203623,44208636,44203623,44208636,111104341,XM_022438234.1,uncharacterized LOC111104341,5013
NC_035786.1,53522744,53529995,53522744,53529995,111104343,XM_022438238.1,uncharacterized LOC111104343,7251
NC_035786.1,55888365,55892010,55888365,55892010,111104347,XM_022438244.1,uncharacterized LOC111104347,3645
NC_035786.1,36167619,36178996,36167619,36178996,111104348,XM_022438246.1,uncharacterized LOC111104348,11377
NC_035786.1,12839003,12872499,12860738,12872499,111104349,XM_022438249.1,uncharacterized LOC111104349,11761
NC_035786.1,12839003,12872499,12839033,12872499,111104349,XM_022438248.1,uncharacterized LOC111104349,33466
NC_035786.1,12839003,12872499,12839003,12872499,111104349,XM_022438247.1,uncharacterized LOC111104349,33496
NC_035786.1,12839003,12872499,12840926,12844553,111104349,XM_022438250.1,uncharacterized LOC111104349,3627
NC_035786.1,13506665,13510078,13506665,13510078,111104352,XM_022438252.1,uncharacterized LOC111104352,3413
NC_035786.1,46967151,46970244,46967151,46970244,111104353,XM_022438254.1,uncharacterized LOC111104353,3093
NC_035786.1,6108819,6112804,6108819,6112804,111104355,XM_022438258.1,uncharacterized LOC111104355,3985
NC_035786.1,18641730,18685112,18641730,18678891,111104356,XM_022438260.1,uncharacterized LOC111104356,37161
NC_035786.1,18641730,18685112,18641730,18685112,111104356,XM_022438259.1,uncharacterized LOC111104356,43382
NC_035780.1,13745870,13750167,13745870,13750167,111104357,XM_022438265.1,uncharacterized LOC111104357,4297
NC_035786.1,39235457,39240149,39235457,39240149,111104358,XM_022438261.1,uncharacterized LOC111104358,4692
NC_035786.1,4371594,4377569,4371594,4377569,111104360,XM_022438264.1,uncharacterized LOC111104360,5975
NC_035786.1,55211367,55243531,55211367,55243531,111104370,XM_022438278.1,uncharacterized LOC111104370,32164
NC_035786.1,40822246,40832405,40822246,40832405,111104371,XM_022438279.1,uncharacterized LOC111104371,10159
NC_035786.1,45946860,45949311,45946860,45949311,111104375,XM_022438281.1,uncharacterized LOC111104375,2451
NC_035780.1,48261627,48268230,48261627,48268230,111104384,XM_022438335.1,uncharacterized LOC111104384,6603
NC_035786.1,3980926,3990546,3980926,3987591,111104387,XM_022438303.1,uncharacterized LOC111104387,6665
NC_035786.1,3980926,3990546,3980926,3990546,111104387,XM_022438302.1,uncharacterized LOC111104387,9620
NC_035786.1,39435072,39446081,39435072,39446081,111104392,XM_022438307.1,uncharacterized LOC111104392,11009
NC_035786.1,39435072,39446081,39435072,39439622,111104392,XM_022438310.1,uncharacterized LOC111104392,4550
NC_035786.1,39435072,39446081,39435072,39443634,111104392,XM_022438311.1,uncharacterized LOC111104392,8562
NC_035786.1,54115389,54119020,54115389,54119020,111104393,XM_022438312.1,uncharacterized LOC111104393,3631
NC_035786.1,37265060,37275985,37265147,37275985,111104399,XM_022438320.1,uncharacterized LOC111104399,10838
NC_035786.1,37265060,37275985,37265060,37275985,111104399,XM_022438321.1,uncharacterized LOC111104399,10925
NC_035786.1,50836404,50839933,50836404,50839933,111104400,XM_022438323.1,uncharacterized LOC111104400,3529
NC_035786.1,19387533,19429090,19387533,19429090,111104402,XM_022438324.1,uncharacterized LOC111104402,41557
NC_035786.1,21506330,21510562,21506330,21510562,111104404,XM_022438327.1,uncharacterized LOC111104404,4232
NC_035786.1,23931612,23934873,23931612,23934873,111104405,XM_022438329.1,uncharacterized LOC111104405,3261
NC_035786.1,9194943,9208399,9194960,9208399,111104406,XM_022438330.1,uncharacterized LOC111104406,13439
NC_035786.1,21693588,21703182,21693588,21703182,111104408,XM_022438332.1,uncharacterized LOC111104408,9594
NC_035786.1,52868498,52874447,52868498,52874447,111104415,XM_022438342.1,uncharacterized LOC111104415,5949
NC_035786.1,36526488,36530658,36526488,36530658,111104418,XM_022438350.1,uncharacterized LOC111104418,4170
NC_035786.1,51303632,51304811,51303632,51304811,111104420,XM_022438353.1,uncharacterized LOC111104420,1179
NC_035786.1,33453975,33461153,33457344,33461153,111104424,XM_022438362.1,uncharacterized LOC111104424,3809
NC_035786.1,33453975,33461153,33456594,33461153,111104424,XM_022438361.1,uncharacterized LOC111104424,4559
NC_035786.1,33453975,33461153,33453975,33461153,111104424,XM_022438359.1,uncharacterized LOC111104424,7178
NC_035786.1,37307068,37325839,37307068,37325839,111104426,XM_022438365.1,uncharacterized LOC111104426,18771
NC_035786.1,21284585,21290699,21284585,21290699,111104427,XM_022438366.1,uncharacterized LOC111104427,6114
NC_035786.1,15252609,15254797,15252609,15254780,111104428,XM_022438367.1,uncharacterized LOC111104428,2171
NC_035786.1,15252609,15254797,15252609,15254797,111104428,XM_022438368.1,uncharacterized LOC111104428,2188
NC_035786.1,56267707,56270184,56267707,56270184,111104429,XM_022438370.1,uncharacterized LOC111104429,2477
NC_035786.1,48526964,48532734,48527271,48532734,111104431,XM_022438374.1,uncharacterized LOC111104431,5463
NC_035786.1,48526964,48532734,48527269,48532734,111104431,XM_022438375.1,uncharacterized LOC111104431,5465
NC_035786.1,48526964,48532734,48526964,48532734,111104431,XM_022438376.1,uncharacterized LOC111104431,5770
NC_035786.1,53165222,53170384,53165222,53170384,111104436,XM_022438395.1,uncharacterized LOC111104436,5162
NC_035786.1,21721181,21727221,21721181,21727221,111104438,XM_022438400.1,uncharacterized LOC111104438,6040
NC_035786.1,34644759,34647789,34644759,34647789,111104440,XM_022438402.1,uncharacterized LOC111104440,3030
NC_035786.1,20551418,20554258,20551418,20554258,111104441,XM_022438403.1,uncharacterized LOC111104441,2840
NC_035786.1,2034233,2037756,2034233,2037756,111104446,XM_022438408.1,uncharacterized LOC111104446,3523
NC_035786.1,45229621,45230481,45229635,45230481,111104448,XM_022438412.1,uncharacterized LOC111104448,846
NC_035786.1,45229621,45230481,45229621,45230481,111104448,XM_022438411.1,uncharacterized LOC111104448,860
NC_035786.1,20914755,20938251,20914755,20938251,111104457,XM_022438426.1,uncharacterized LOC111104457,23496
NC_035786.1,7790787,7809749,7790787,7809454,111104458,XM_022438429.1,uncharacterized LOC111104458,18667
NC_035786.1,7790787,7809749,7790787,7809749,111104458,XM_022438428.1,uncharacterized LOC111104458,18962
NC_035786.1,7787429,7789320,7787429,7789320,111104459,XM_022438430.1,uncharacterized LOC111104459,1891
NC_035786.1,1968291,1971759,1968291,1971759,111104463,XM_022438435.1,uncharacterized LOC111104463,3468
NC_035786.1,1965610,1968738,1965928,1968738,111104464,XM_022438437.1,uncharacterized LOC111104464,2810
NC_035786.1,1965610,1968738,1965615,1968738,111104464,XM_022438439.1,uncharacterized LOC111104464,3123
NC_035786.1,1965610,1968738,1965614,1968738,111104464,XM_022438436.1,uncharacterized LOC111104464,3124
NC_035786.1,43939822,43941860,43939822,43941860,111104465,XM_022438440.1,uncharacterized LOC111104465,2038
NC_035786.1,32121407,32121996,32121407,32121996,111104468,XM_022438445.1,uncharacterized LOC111104468,589
NC_035786.1,45965370,45966506,45965370,45966506,111104472,XM_022438448.1,uncharacterized LOC111104472,1136
NC_035786.1,9722271,9728246,9722296,9728246,111104474,XM_022438452.1,uncharacterized LOC111104474,5950
NC_035786.1,9722271,9728246,9722295,9728246,111104474,XM_022438450.1,uncharacterized LOC111104474,5951
NC_035786.1,9722271,9728246,9722271,9728246,111104474,XM_022438451.1,uncharacterized LOC111104474,5975
NC_035786.1,19593436,19595246,19593436,19595246,111104475,XM_022438453.1,uncharacterized LOC111104475,1810
NC_035786.1,11386860,11388940,11386860,11388940,111104476,XM_022438454.1,uncharacterized LOC111104476,2080
NC_035786.1,11388936,11392827,11388936,11392827,111104477,XM_022438455.1,uncharacterized LOC111104477,3891
NC_035786.1,9674291,9680478,9674291,9680478,111104478,XM_022438456.1,uncharacterized LOC111104478,6187
NC_035786.1,13496434,13499169,13496434,13499169,111104482,XM_022438459.1,uncharacterized LOC111104482,2735
NC_035786.1,29493128,29501957,29493234,29501957,111104485,XM_022438467.1,uncharacterized LOC111104485,8723
NC_035786.1,29493128,29501957,29493128,29501957,111104485,XM_022438466.1,uncharacterized LOC111104485,8829
NC_035786.1,39408134,39416605,39408134,39416605,111104486,XM_022438468.1,uncharacterized LOC111104486,8471
NC_035786.1,56132053,56142230,56132053,56142230,111104488,XM_022438471.1,uncharacterized LOC111104488,10177
NC_035786.1,56132053,56142230,56132053,56141818,111104488,XM_022438473.1,uncharacterized LOC111104488,9765
NC_035786.1,56149767,56162313,56149768,56161330,111104490,XM_022438477.1,uncharacterized LOC111104490,11562
NC_035786.1,56149767,56162313,56149768,56162047,111104490,XM_022438476.1,uncharacterized LOC111104490,12279
NC_035786.1,56149767,56162313,56149768,56162312,111104490,XM_022438474.1,uncharacterized LOC111104490,12544
NC_035786.1,56149767,56162313,56149767,56162313,111104490,XM_022438478.1,uncharacterized LOC111104490,12546
NC_035786.1,763008,767501,763008,767501,111104497,XM_022438487.1,uncharacterized LOC111104497,4493
NC_035786.1,47239109,47246038,47239109,47246038,111104499,XM_022438488.1,uncharacterized LOC111104499,6929
NC_035786.1,28761169,28768736,28761169,28768736,111104505,XM_022438495.1,uncharacterized LOC111104505,7567
NC_035786.1,5603912,5624536,5603912,5624536,111104507,XM_022438497.1,uncharacterized LOC111104507,20624
NC_035786.1,16412130,16416896,16412451,16416896,111104510,XM_022438503.1,uncharacterized LOC111104510,4445
NC_035786.1,16412130,16416896,16412450,16416896,111104510,XM_022438502.1,uncharacterized LOC111104510,4446
NC_035786.1,16412130,16416896,16412130,16416896,111104510,XM_022438504.1,uncharacterized LOC111104510,4766
NC_035786.1,16403682,16408367,16403769,16408367,111104511,XM_022438505.1,uncharacterized LOC111104511,4598
NC_035780.1,52530022,52534817,52530022,52534817,111104513,XM_022438509.1,uncharacterized LOC111104513,4795
NC_035786.1,3245219,3257006,3245219,3257006,111104520,XM_022438521.1,uncharacterized LOC111104520,11787
NC_035786.1,3245219,3257006,3245219,3249345,111104520,XM_022438522.1,uncharacterized LOC111104520,4126
NC_035786.1,43403119,43409462,43403119,43409462,111104525,XM_022438526.1,uncharacterized LOC111104525,6343
NC_035786.1,5775259,5782990,5776658,5782990,111104526,XM_022438531.1,uncharacterized LOC111104526,6332
NC_035786.1,5775259,5782990,5776568,5782990,111104526,XM_022438528.1,uncharacterized LOC111104526,6422
NC_035786.1,5775259,5782990,5775259,5782990,111104526,XM_022438527.1,uncharacterized LOC111104526,7731
NC_035786.1,11332439,11338077,11335739,11338077,111104529,XM_022438533.1,uncharacterized LOC111104529,2338
NC_035786.1,11332439,11338077,11332444,11338077,111104529,XM_022438534.1,uncharacterized LOC111104529,5633
NC_035786.1,11332439,11338077,11332439,11338077,111104529,XM_022438535.1,uncharacterized LOC111104529,5638
NC_035786.1,46549597,46553888,46549597,46553888,111104535,XM_022438542.1,uncharacterized LOC111104535,4291
NC_035786.1,46562400,46566492,46562400,46566492,111104536,XM_022438543.1,uncharacterized LOC111104536,4092
NC_035786.1,55433360,55437723,55433360,55437723,111104538,XM_022438544.1,uncharacterized LOC111104538,4363
NC_035786.1,12764947,12768002,12764947,12768000,111104539,XM_022438545.1,uncharacterized LOC111104539,3053
NC_035786.1,12764947,12768002,12764947,12768002,111104539,XM_022438546.1,uncharacterized LOC111104539,3055
NC_035786.1,12742755,12775526,12742755,12760289,111104540,XM_022438555.1,uncharacterized LOC111104540,17534
NC_035786.1,12742755,12775526,12742755,12763370,111104540,XM_022438549.1,uncharacterized LOC111104540,20615
NC_035786.1,12742755,12775526,12742755,12765272,111104540,XM_022438548.1,uncharacterized LOC111104540,22517
NC_035786.1,12742755,12775526,12742755,12775521,111104540,XM_022438550.1,uncharacterized LOC111104540,32766
NC_035786.1,12742755,12775526,12742755,12775523,111104540,XM_022438552.1,uncharacterized LOC111104540,32768
NC_035786.1,12742755,12775526,12742755,12775526,111104540,XM_022438551.1,uncharacterized LOC111104540,32771
NC_035786.1,9354436,9358968,9355356,9358968,111104544,XM_022438559.1,uncharacterized LOC111104544,3612
NC_035786.1,9354436,9358968,9354436,9358968,111104544,XM_022438558.1,uncharacterized LOC111104544,4532
NC_035786.1,9350730,9363920,9350730,9363920,111104548,XM_022438565.1,uncharacterized LOC111104548,13190
NC_035786.1,46747309,46751259,46747309,46751259,111104553,XM_022438569.1,uncharacterized LOC111104553,3950
NC_035786.1,46776609,46780107,46776609,46780107,111104554,XM_022438570.1,uncharacterized LOC111104554,3498
NC_035786.1,44352343,44438701,44352343,44402292,111104555,XM_022438572.1,uncharacterized LOC111104555,49949
NC_035786.1,44352343,44438701,44352343,44438701,111104555,XM_022438571.1,uncharacterized LOC111104555,86358
NC_035786.1,17232784,17234921,17232908,17234921,111104557,XM_022438573.1,uncharacterized LOC111104557,2013
NC_035786.1,17232784,17234921,17232784,17234921,111104557,XM_022438574.1,uncharacterized LOC111104557,2137
NC_035786.1,8612431,8615367,8612431,8615367,111104561,XM_022438583.1,uncharacterized LOC111104561,2936
NC_035786.1,40530847,40535007,40530847,40535007,111104566,XM_022438586.1,uncharacterized LOC111104566,4160
NC_035786.1,44561734,44562637,44561744,44562637,111104568,XM_022438589.1,uncharacterized LOC111104568,893
NC_035786.1,44561734,44562637,44561734,44562637,111104568,XM_022438588.1,uncharacterized LOC111104568,903
NC_035786.1,39468750,39477343,39468750,39477343,111104569,XM_022438590.1,uncharacterized LOC111104569,8593
NC_035786.1,16932264,16935693,16932264,16935693,111104571,XM_022438592.1,uncharacterized LOC111104571,3429
NC_035780.1,5442762,5461992,5442762,5461992,111104573,XM_022438599.1,uncharacterized LOC111104573,19230
NC_035786.1,40602426,40613006,40602426,40613006,111104582,XM_022438603.1,uncharacterized LOC111104582,10580
NC_035786.1,38686060,38687066,38686060,38687066,111104586,XM_022438605.1,uncharacterized LOC111104586,1006
NC_035786.1,13802766,13804373,13802766,13804373,111104588,XM_022438607.1,uncharacterized LOC111104588,1607
NC_035786.1,45916662,45917695,45916662,45917695,111104593,XM_022438614.1,uncharacterized LOC111104593,1033
NC_035780.1,35381264,35383202,35381264,35383202,111104595,XM_022438618.1,uncharacterized LOC111104595,1938
NC_035786.1,46479344,46484787,46479344,46484787,111104596,XM_022438616.1,uncharacterized LOC111104596,5443
NC_035786.1,30701548,30717892,30701548,30714537,111104598,XM_022438621.1,uncharacterized LOC111104598,12989
NC_035786.1,30701548,30717892,30701548,30717853,111104598,XM_022438619.1,uncharacterized LOC111104598,16305
NC_035786.1,30701548,30717892,30701548,30717892,111104598,XM_022438622.1,uncharacterized LOC111104598,16344
NC_035786.1,30701548,30717892,30701548,30705979,111104598,XM_022438623.1,uncharacterized LOC111104598,4431
NC_035786.1,30659915,30665356,30659915,30665356,111104599,XM_022438624.1,uncharacterized LOC111104599,5441
NC_035786.1,30677342,30687223,30677342,30687223,111104600,XM_022438625.1,uncharacterized LOC111104600,9881
NC_035780.1,57061961,57075144,57061965,57075142,111104602,XM_022438629.1,uncharacterized LOC111104602,13177
NC_035780.1,57061961,57075144,57061961,57075144,111104602,XM_022438636.1,uncharacterized LOC111104602,13183
NC_035786.1,37203451,37209737,37203451,37209737,111104604,XM_022438630.1,uncharacterized LOC111104604,6286
NC_035786.1,19446481,19454279,19446481,19454279,111104611,XM_022438637.1,uncharacterized LOC111104611,7798
NC_035786.1,11431166,11447820,11431166,11447820,111104612,XM_022438638.1,uncharacterized LOC111104612,16654
NC_035786.1,50788220,50789064,50788220,50789064,111104616,XM_022438641.1,uncharacterized LOC111104616,844
NC_035786.1,16508376,16515078,16508376,16515078,111104620,XM_022438643.1,uncharacterized LOC111104620,6702
NC_035786.1,47438476,47443278,47438476,47443255,111104621,XM_022438645.1,uncharacterized LOC111104621,4779
NC_035786.1,47438476,47443278,47438476,47443278,111104621,XM_022438644.1,uncharacterized LOC111104621,4802
NC_035786.1,21959819,21977338,21959819,21977338,111104622,XM_022438649.1,uncharacterized LOC111104622,17519
NC_035786.1,45985364,45986703,45985364,45986703,111104623,XM_022438651.1,uncharacterized LOC111104623,1339
NC_035786.1,19335057,19337921,19335057,19337921,111104624,XM_022438652.1,uncharacterized LOC111104624,2864
NC_035780.1,14083742,14089660,14086042,14089660,111104626,XM_022438669.1,uncharacterized LOC111104626,3618
NC_035780.1,14083742,14089660,14083742,14089660,111104626,XM_022438659.1,uncharacterized LOC111104626,5918
NC_035786.1,29443015,29464236,29448785,29464236,111104627,XM_022438658.1,uncharacterized LOC111104627,15451
NC_035786.1,29443015,29464236,29443015,29464236,111104627,XM_022438657.1,uncharacterized LOC111104627,21221
NC_035786.1,20565055,20570339,20565055,20570339,111104628,XM_022438661.1,uncharacterized LOC111104628,5284
NC_035780.1,10867263,10902884,10867263,10902884,111104630,XM_022438685.1,uncharacterized LOC111104630,35621
NC_035786.1,7479475,7483879,7479475,7482596,111104631,XM_022438694.1,uncharacterized LOC111104631,3121
NC_035786.1,7479475,7483879,7479475,7483879,111104631,XM_022438693.1,uncharacterized LOC111104631,4404
NC_035786.1,53459852,53469284,53459852,53469284,111104638,XM_022438703.1,uncharacterized LOC111104638,9432
NC_035786.1,53453809,53454894,53453809,53454894,111104639,XM_022438704.1,uncharacterized LOC111104639,1085
NC_035786.1,53500302,53501303,53500302,53501303,111104640,XM_022438705.1,uncharacterized LOC111104640,1001
NC_035786.1,21881759,21887532,21881759,21886870,111104648,XM_022438711.1,uncharacterized LOC111104648,5111
NC_035786.1,21881759,21887532,21881759,21887206,111104648,XM_022438710.1,uncharacterized LOC111104648,5447
NC_035786.1,21881759,21887532,21881759,21887528,111104648,XM_022438709.1,uncharacterized LOC111104648,5769
NC_035786.1,42894347,42906975,42894505,42906975,111104650,XM_022438713.1,uncharacterized LOC111104650,12470
NC_035786.1,42894347,42906975,42894347,42906975,111104650,XM_022438714.1,uncharacterized LOC111104650,12628
NC_035786.1,42894347,42906975,42902636,42906975,111104650,XM_022438715.1,uncharacterized LOC111104650,4339
NC_035786.1,42881746,42886237,42881746,42886237,111104652,XM_022438716.1,uncharacterized LOC111104652,4491
NC_035786.1,47306365,47308868,47306365,47308868,111104653,XM_022438717.1,uncharacterized LOC111104653,2503
NC_035786.1,42123691,42125283,42123691,42125283,111104656,XM_022438722.1,uncharacterized LOC111104656,1592
NC_035780.1,29343832,29348011,29343832,29348011,111104659,XM_022438728.1,uncharacterized LOC111104659,4179
NC_035786.1,48269936,48303522,48283659,48303522,111104660,XM_022438725.1,uncharacterized LOC111104660,19863
NC_035786.1,48269936,48303522,48269936,48303522,111104660,XM_022438726.1,uncharacterized LOC111104660,33586
NC_035786.1,57744603,57748946,57744876,57748946,111104661,XM_022438729.1,uncharacterized LOC111104661,4070
NC_035786.1,57744603,57748946,57744617,57748946,111104661,XM_022438731.1,uncharacterized LOC111104661,4329
NC_035786.1,57744603,57748946,57744611,57748946,111104661,XM_022438727.1,uncharacterized LOC111104661,4335
NC_035786.1,57744603,57748946,57744603,57748946,111104661,XM_022438730.1,uncharacterized LOC111104661,4343
NC_035780.1,26820399,26822765,26820399,26822750,111104662,XM_022439818.1,uncharacterized LOC111104662,2351
NC_035780.1,26820399,26822765,26820399,26822765,111104662,XM_022439104.1,uncharacterized LOC111104662,2366
NC_035786.1,46972973,47007750,46976149,47007750,111104663,XM_022438733.1,uncharacterized LOC111104663,31601
NC_035786.1,46972973,47007750,46974961,47007750,111104663,XM_022438734.1,uncharacterized LOC111104663,32789
NC_035786.1,46972973,47007750,46972973,47007750,111104663,XM_022438732.1,uncharacterized LOC111104663,34777
NC_035786.1,37293845,37302543,37293845,37302543,111104665,XM_022438735.1,uncharacterized LOC111104665,8698
NC_035786.1,49879658,49883131,49879659,49883131,111104666,XM_022438737.1,uncharacterized LOC111104666,3472
NC_035786.1,49879658,49883131,49879658,49883131,111104666,XM_022438736.1,uncharacterized LOC111104666,3473
NC_035786.1,11169393,11180699,11169718,11179857,111104674,XM_022438744.1,uncharacterized LOC111104674,10139
NC_035786.1,11169393,11180699,11169718,11180699,111104674,XM_022438742.1,uncharacterized LOC111104674,10981
NC_035786.1,11169393,11180699,11169393,11180400,111104674,XM_022438743.1,uncharacterized LOC111104674,11007
NC_035786.1,11169393,11180699,11175127,11180406,111104674,XM_022438746.1,uncharacterized LOC111104674,5279
NC_035786.1,11169393,11180699,11169718,11177950,111104674,XM_022438745.1,uncharacterized LOC111104674,8232
NC_035780.1,4600555,4637023,4600555,4637023,111104675,XM_022438750.1,uncharacterized LOC111104675,36468
NC_035786.1,54544736,54546123,54544736,54546123,111104677,XM_022438748.1,uncharacterized LOC111104677,1387
NC_035786.1,5218709,5222196,5218709,5222196,111104678,XM_022438749.1,uncharacterized LOC111104678,3487
NC_035786.1,45954623,45955608,45954623,45955608,111104680,XM_022438751.1,uncharacterized LOC111104680,985
NC_035786.1,9810341,9814089,9810341,9814089,111104682,XM_022438753.1,uncharacterized LOC111104682,3748
NC_035786.1,9684012,9706260,9684048,9706260,111104683,XM_022438755.1,uncharacterized LOC111104683,22212
NC_035786.1,9684012,9706260,9684012,9706260,111104683,XM_022438754.1,uncharacterized LOC111104683,22248
NC_035780.1,4632147,4635001,4632147,4635001,111104685,XM_022438762.1,uncharacterized LOC111104685,2854
NC_035786.1,17107065,17110793,17107463,17110793,111104686,XM_022438761.1,uncharacterized LOC111104686,3330
NC_035786.1,49718250,49721259,49718250,49721259,111104692,XM_022438774.1,uncharacterized LOC111104692,3009
NC_035786.1,28388452,28403187,28388452,28403187,111104694,XM_022438776.1,uncharacterized LOC111104694,14735
NC_035780.1,35660063,35697879,35660063,35697878,111104697,XM_022438791.1,uncharacterized LOC111104697,37815
NC_035780.1,35660063,35697879,35660063,35697879,111104697,XM_022438799.1,uncharacterized LOC111104697,37816
NC_035786.1,45920278,45921600,45920278,45921600,111104701,XM_022438784.1,uncharacterized LOC111104701,1322
NC_035786.1,3864047,3869468,3864049,3869468,111104704,XM_022438787.1,uncharacterized LOC111104704,5419
NC_035786.1,3864047,3869468,3864047,3869468,111104704,XM_022438788.1,uncharacterized LOC111104704,5421
NC_035786.1,36764048,36767238,36764048,36767238,111104705,XM_022438789.1,uncharacterized LOC111104705,3190
NC_035786.1,5836966,5840034,5836966,5840034,111104708,XM_022438793.1,uncharacterized LOC111104708,3068
NC_035786.1,45481613,45484025,45481613,45484025,111104709,XM_022438795.1,uncharacterized LOC111104709,2412
NC_035786.1,7133746,7140722,7133746,7140722,111104710,XM_022438798.1,uncharacterized LOC111104710,6976
NC_035786.1,17398657,17497566,17398657,17473518,111104711,XM_022438805.1,uncharacterized LOC111104711,74861
NC_035786.1,17398657,17497566,17398657,17497565,111104711,XM_022438803.1,uncharacterized LOC111104711,98908
NC_035786.1,17398657,17497566,17398657,17497566,111104711,XM_022438804.1,uncharacterized LOC111104711,98909
NC_035786.1,5017029,5019432,5017029,5019432,111104717,XM_022438809.1,uncharacterized LOC111104717,2403
NC_035786.1,41235839,41253649,41235839,41253649,111104719,XM_022438813.1,uncharacterized LOC111104719,17810
NC_035786.1,41240487,41287919,41240487,41287919,111104720,XM_022438814.1,uncharacterized LOC111104720,47432
NC_035786.1,20945254,20965288,20945254,20961584,111104721,XM_022438820.1,uncharacterized LOC111104721,16330
NC_035786.1,20945254,20965288,20945670,20965288,111104721,XM_022438818.1,uncharacterized LOC111104721,19618
NC_035786.1,20945254,20965288,20945669,20965288,111104721,XM_022438816.1,uncharacterized LOC111104721,19619
NC_035786.1,20945254,20965288,20945257,20965288,111104721,XM_022438817.1,uncharacterized LOC111104721,20031
NC_035786.1,20945254,20965288,20945256,20965288,111104721,XM_022438815.1,uncharacterized LOC111104721,20032
NC_035786.1,10605153,10629385,10605153,10629385,111104722,XM_022438821.1,uncharacterized LOC111104722,24232
NC_035786.1,32895426,32898318,32895426,32898318,111104724,XM_022438824.1,uncharacterized LOC111104724,2892
NC_035786.1,36312197,36415385,36396026,36415385,111104729,XM_022438832.1,uncharacterized LOC111104729,19359
NC_035786.1,21556892,21562174,21556892,21562174,111104731,XM_022438835.1,uncharacterized LOC111104731,5282
NC_035786.1,21524588,21540047,21524588,21540047,111104732,XM_022438836.1,uncharacterized LOC111104732,15459
NC_035786.1,9941779,9947634,9941779,9947634,111104735,XM_022438837.1,uncharacterized LOC111104735,5855
NC_035786.1,9895644,9900221,9895644,9900221,111104736,XM_022438838.1,uncharacterized LOC111104736,4577
NC_035786.1,9908487,9923752,9910803,9923752,111104738,XM_022438840.1,uncharacterized LOC111104738,12949
NC_035786.1,9908487,9923752,9908487,9923752,111104738,XM_022438839.1,uncharacterized LOC111104738,15265
NC_035786.1,9929644,9935294,9929644,9933293,111104739,XM_022438842.1,uncharacterized LOC111104739,3649
NC_035786.1,9929644,9935294,9929644,9935294,111104739,XM_022438843.1,uncharacterized LOC111104739,5650
NC_035780.1,32125095,32127684,32125095,32127684,111104740,XM_022438879.1,uncharacterized LOC111104740,2589
NC_035786.1,5390339,5392828,5390339,5392828,111104741,XM_022438844.1,uncharacterized LOC111104741,2489
NC_035786.1,36535838,36545708,36535873,36545708,111104744,XM_022438848.1,uncharacterized LOC111104744,9835
NC_035786.1,36535838,36545708,36535838,36545708,111104744,XM_022438847.1,uncharacterized LOC111104744,9870
NC_035786.1,13535074,13536650,13535074,13536650,111104745,XM_022438849.1,uncharacterized LOC111104745,1576
NC_035786.1,24281491,24300208,24281491,24300208,111104746,XM_022438851.1,uncharacterized LOC111104746,18717
NC_035786.1,46030542,46039671,46030542,46039668,111104747,XM_022438852.1,uncharacterized LOC111104747,9126
NC_035786.1,46030542,46039671,46030542,46039671,111104747,XM_022438853.1,uncharacterized LOC111104747,9129
NC_035786.1,18346550,18352838,18346550,18352838,111104748,XM_022438854.1,uncharacterized LOC111104748,6288
NC_035786.1,57812990,57814596,57812990,57814596,111104749,XM_022438855.1,uncharacterized LOC111104749,1606
NC_035786.1,50282837,50283649,50282837,50283649,111104751,XM_022438856.1,uncharacterized LOC111104751,812
NC_035786.1,42996101,43019607,42997437,43019607,111104752,XM_022438861.1,uncharacterized LOC111104752,22170
NC_035786.1,42996101,43019607,42997435,43002460,111104752,XM_022438859.1,uncharacterized LOC111104752,5025
NC_035786.1,42996101,43019607,42996101,43002408,111104752,XM_022438857.1,uncharacterized LOC111104752,6307
NC_035786.1,43013407,43029554,43013407,43029554,111104753,XM_022438862.1,uncharacterized LOC111104753,16147
NC_035786.1,43005888,43010097,43005888,43010097,111104754,XM_022438864.1,uncharacterized LOC111104754,4209
NC_035786.1,35978240,35988876,35978240,35988876,111104755,XM_022438865.1,uncharacterized LOC111104755,10636
NC_035786.1,23942123,23944578,23942123,23944572,111104757,XM_022438867.1,uncharacterized LOC111104757,2449
NC_035786.1,23942123,23944578,23942123,23944578,111104757,XM_022438866.1,uncharacterized LOC111104757,2455
NC_035786.1,40053788,40060377,40053794,40056162,111104764,XM_022438877.1,uncharacterized LOC111104764,2368
NC_035786.1,38577795,38578981,38577795,38578981,111104768,XM_022438883.1,uncharacterized LOC111104768,1186
NC_035786.1,33050856,33054269,33050856,33054032,111104769,XM_022438884.1,uncharacterized LOC111104769,3176
NC_035786.1,33050856,33054269,33050856,33054179,111104769,XM_022438886.1,uncharacterized LOC111104769,3323
NC_035786.1,33050856,33054269,33050856,33054263,111104769,XM_022438885.1,uncharacterized LOC111104769,3407
NC_035786.1,33050856,33054269,33050856,33054269,111104769,XM_022438887.1,uncharacterized LOC111104769,3413
NC_035786.1,12460526,12465138,12460657,12465138,111104773,XM_022438889.1,uncharacterized LOC111104773,4481
NC_035786.1,12460526,12465138,12460526,12465138,111104773,XM_022438893.1,uncharacterized LOC111104773,4612
NC_035786.1,21754407,21773220,21754407,21773220,111104774,XM_022438894.1,uncharacterized LOC111104774,18813
NC_035786.1,47733242,47766164,47735975,47766164,111104775,XM_022438896.1,uncharacterized LOC111104775,30189
NC_035786.1,47733242,47766164,47735224,47766164,111104775,XM_022438897.1,uncharacterized LOC111104775,30940
NC_035786.1,47733242,47766164,47733242,47766164,111104775,XM_022438895.1,uncharacterized LOC111104775,32922
NC_035786.1,16425396,16429150,16427676,16429150,111104776,XM_022438898.1,uncharacterized LOC111104776,1474
NC_035786.1,16425396,16429150,16425396,16429150,111104776,XM_022438900.1,uncharacterized LOC111104776,3754
NC_035780.1,9923742,9927788,9925304,9927753,111104777,XM_022438913.1,uncharacterized LOC111104777,2449
NC_035780.1,9923742,9927788,9925304,9927788,111104777,XM_022438904.1,uncharacterized LOC111104777,2484
NC_035780.1,9923742,9927788,9923742,9927788,111104777,XM_022438922.1,uncharacterized LOC111104777,4046
NC_035786.1,47644569,47681166,47644569,47681166,111104779,XM_022438902.1,uncharacterized LOC111104779,36597
NC_035786.1,47547469,47550535,47547469,47550535,111104790,XM_022438926.1,uncharacterized LOC111104790,3066
NC_035786.1,9227605,9235296,9227605,9235296,111104791,XM_022438927.1,uncharacterized LOC111104791,7691
NC_035780.1,46364931,46388135,46364931,46388135,111104793,XM_022438942.1,uncharacterized LOC111104793,23204
NC_035786.1,13246580,13250474,13246580,13248033,111104794,XM_022438932.1,uncharacterized LOC111104794,1453
NC_035786.1,13246580,13250474,13246580,13250474,111104794,XM_022438931.1,uncharacterized LOC111104794,3894
NC_035786.1,46784686,46787775,46784686,46787775,111104796,XM_022438933.1,uncharacterized LOC111104796,3089
NC_035786.1,26339915,26341276,26339915,26341276,111104804,XM_022438945.1,uncharacterized LOC111104804,1361
NC_035780.1,42075992,42090749,42075992,42090736,111104809,XM_022438950.1,uncharacterized LOC111104809,14744
NC_035780.1,42075992,42090749,42075993,42090749,111104809,XM_022438957.1,uncharacterized LOC111104809,14756
NC_035786.1,14505971,14590057,14505971,14590057,111104812,XM_022438948.1,uncharacterized LOC111104812,84086
NC_035786.1,32618372,32620111,32618372,32620111,111104819,XM_022438958.1,uncharacterized LOC111104819,1739
NC_035786.1,48748571,48765547,48748571,48765547,111104823,XM_022438965.1,uncharacterized LOC111104823,16976
NC_035786.1,48721323,48738775,48726614,48737641,111104825,XM_022438969.1,uncharacterized LOC111104825,11027
NC_035786.1,48721323,48738775,48727408,48738775,111104825,XM_022438968.1,uncharacterized LOC111104825,11367
NC_035786.1,48721323,48738775,48726614,48738775,111104825,XM_022438966.1,uncharacterized LOC111104825,12161
NC_035786.1,48721323,48738775,48721323,48738775,111104825,XM_022438967.1,uncharacterized LOC111104825,17452
NC_035786.1,48681856,48697625,48681856,48697625,111104826,XM_022438971.1,uncharacterized LOC111104826,15769
NC_035786.1,34856057,34858734,34856097,34858734,111104831,XM_022438981.1,uncharacterized LOC111104831,2637
NC_035786.1,34856057,34858734,34856057,34858734,111104831,XM_022438980.1,uncharacterized LOC111104831,2677
NC_035786.1,10909454,10914530,10909454,10914530,111104836,XM_022438987.1,uncharacterized LOC111104836,5076
NC_035786.1,30221646,30231747,30221646,30231747,111104838,XM_022438989.1,uncharacterized LOC111104838,10101
NC_035786.1,30221646,30231747,30221646,30231418,111104838,XM_022438990.1,uncharacterized LOC111104838,9772
NC_035786.1,20374954,20377069,20374954,20377069,111104843,XM_022439004.1,uncharacterized LOC111104843,2115
NC_035786.1,46344935,46353619,46344935,46353619,111104847,XM_022439009.1,uncharacterized LOC111104847,8684
NC_035786.1,49139693,49160785,49139693,49160785,111104858,XM_022439019.1,uncharacterized LOC111104858,21092
NC_035786.1,6508945,6517046,6508964,6517046,111104859,XM_022439022.1,uncharacterized LOC111104859,8082
NC_035786.1,6508945,6517046,6508945,6517046,111104859,XM_022439021.1,uncharacterized LOC111104859,8101
NC_035786.1,3854328,3857106,3854328,3857106,111104860,XM_022439023.1,uncharacterized LOC111104860,2778
NC_035786.1,43197425,43201610,43197425,43201610,111104864,XM_022439026.1,uncharacterized LOC111104864,4185
NC_035786.1,43166833,43178697,43166833,43178697,111104865,XM_022439028.1,uncharacterized LOC111104865,11864
NC_035786.1,3468783,3473648,3468783,3473648,111104867,XM_022439030.1,uncharacterized LOC111104867,4865
NC_035786.1,50141298,50150130,50141298,50146382,111104872,XM_022439036.1,uncharacterized LOC111104872,5084
NC_035786.1,50141298,50150130,50141298,50150130,111104872,XM_022439035.1,uncharacterized LOC111104872,8832
NC_035786.1,24762124,24765931,24762124,24765931,111104875,XM_022439041.1,uncharacterized LOC111104875,3807
NC_035786.1,15583809,15592687,15583809,15592687,111104878,XM_022439045.1,uncharacterized LOC111104878,8878
NC_035786.1,16210046,16214245,16210046,16214245,111104879,XM_022439046.1,uncharacterized LOC111104879,4199
NC_035786.1,16243871,16251445,16243871,16251445,111104880,XM_022439047.1,uncharacterized LOC111104880,7574
NC_035786.1,16279862,16290010,16279862,16290010,111104881,XM_022439048.1,uncharacterized LOC111104881,10148
NC_035786.1,16661109,16661573,16661109,16661573,111104884,XM_022439052.1,uncharacterized LOC111104884,464
NC_035786.1,16939081,16939851,16939081,16939851,111104888,XM_022439056.1,uncharacterized LOC111104888,770
NC_035786.1,17007841,17009060,17007841,17009060,111104889,XM_022439058.1,uncharacterized LOC111104889,1219
NC_035786.1,17100304,17102142,17100304,17102142,111104890,XM_022439059.1,uncharacterized LOC111104890,1838
NC_035786.1,17605145,17606062,17605145,17606062,111104893,XM_022439062.1,uncharacterized LOC111104893,917
NC_035786.1,17861897,17865743,17861897,17865743,111104894,XM_022439063.1,uncharacterized LOC111104894,3846
NC_035786.1,17936123,17956542,17936123,17956542,111104895,XM_022439065.1,uncharacterized LOC111104895,20419
NC_035786.1,18173158,18181989,18173158,18181989,111104896,XM_022439066.1,uncharacterized LOC111104896,8831
NC_035786.1,18276556,18282084,18276556,18282084,111104898,XM_022439068.1,uncharacterized LOC111104898,5528
NC_035786.1,18886718,18888685,18886718,18888685,111104904,XM_022439074.1,uncharacterized LOC111104904,1967
NC_035786.1,19055099,19057396,19055099,19057396,111104905,XM_022439075.1,uncharacterized LOC111104905,2297
NC_035786.1,19131231,19134549,19131231,19134549,111104907,XM_022439077.1,uncharacterized LOC111104907,3318
NC_035786.1,19596263,19600703,19596263,19600703,111104908,XM_022439079.1,uncharacterized LOC111104908,4440
NC_035786.1,19701440,19709649,19701440,19709649,111104909,XM_022439080.1,uncharacterized LOC111104909,8209
NC_035786.1,19744469,19745899,19744469,19745899,111104910,XM_022439081.1,uncharacterized LOC111104910,1430
NC_035786.1,20537002,20538123,20537002,20538123,111104919,XM_022439090.1,uncharacterized LOC111104919,1121
NC_035786.1,20558320,20559441,20558320,20559441,111104920,XM_022439092.1,uncharacterized LOC111104920,1121
NC_035786.1,20560974,20562095,20560974,20562095,111104921,XM_022439093.1,uncharacterized LOC111104921,1121
NC_035786.1,20565548,20566567,20565548,20566567,111104922,XM_022439094.1,uncharacterized LOC111104922,1019
NC_035786.1,21120755,21125848,21120755,21125848,111104925,XM_022439098.1,uncharacterized LOC111104925,5093
NC_035786.1,21126000,21127683,21126000,21127683,111104926,XM_022439099.1,uncharacterized LOC111104926,1683
NC_035786.1,21136532,21141724,21136532,21141724,111104927,XM_022439100.1,uncharacterized LOC111104927,5192
NC_035786.1,21591587,21596893,21591587,21596893,111104929,XM_022439102.1,uncharacterized LOC111104929,5306
NC_035786.1,21636787,21641000,21636787,21641000,111104930,XM_022439103.1,uncharacterized LOC111104930,4213
NC_035786.1,21712230,21719366,21712230,21719366,111104931,XM_022439107.1,uncharacterized LOC111104931,7136
NC_035786.1,22122451,22122972,22122451,22122972,111104933,XM_022439109.1,uncharacterized LOC111104933,521
NC_035786.1,22199329,22203475,22199329,22203475,111104934,XM_022439110.1,uncharacterized LOC111104934,4146
NC_035786.1,22203926,22205136,22203926,22205136,111104935,XM_022439111.1,uncharacterized LOC111104935,1210
NC_035786.1,22823105,22825038,22823105,22825038,111104937,XM_022439113.1,uncharacterized LOC111104937,1933
NC_035786.1,23577983,23582143,23577983,23582143,111104940,XM_022439117.1,uncharacterized LOC111104940,4160
NC_035786.1,23649010,23653980,23649010,23653980,111104941,XM_022439118.1,uncharacterized LOC111104941,4970
NC_035786.1,24189086,24203816,24189086,24203816,111104944,XM_022439121.1,uncharacterized LOC111104944,14730
NC_035786.1,24275422,24280131,24275422,24280131,111104946,XM_022439123.1,uncharacterized LOC111104946,4709
NC_035786.1,24333223,24337123,24333223,24337123,111104947,XM_022439125.1,uncharacterized LOC111104947,3900
NC_035786.1,24375459,24377692,24375459,24377692,111104948,XM_022439126.1,uncharacterized LOC111104948,2233
NC_035786.1,24401833,24403359,24401833,24403359,111104949,XM_022439127.1,uncharacterized LOC111104949,1526
NC_035786.1,24420598,24422641,24420598,24422641,111104950,XM_022439128.1,uncharacterized LOC111104950,2043
NC_035786.1,24518045,24520428,24518045,24520428,111104952,XM_022439129.1,uncharacterized LOC111104952,2383
NC_035786.1,24782060,24791562,24782060,24791562,111104953,XM_022439130.1,uncharacterized LOC111104953,9502
NC_035786.1,26210204,26215098,26210204,26215098,111104962,XM_022439140.1,uncharacterized LOC111104962,4894
NC_035786.1,26334690,26337263,26334690,26337263,111104966,XM_022439145.1,uncharacterized LOC111104966,2573
NC_035786.1,26652849,26653902,26652849,26653902,111104971,XM_022439148.1,uncharacterized LOC111104971,1053
NC_035786.1,26773135,26797754,26773135,26797754,111104972,XM_022439149.1,uncharacterized LOC111104972,24619
NC_035786.1,27154278,27154709,27154278,27154709,111104976,XM_022439153.1,uncharacterized LOC111104976,431
NC_035786.1,27577559,27585890,27577559,27585890,111104978,XM_022439155.1,uncharacterized LOC111104978,8331
NC_035786.1,27818835,27831156,27818835,27831156,111104979,XM_022439156.1,uncharacterized LOC111104979,12321
NC_035786.1,27918719,27938730,27918719,27938730,111104981,XM_022439158.1,uncharacterized LOC111104981,20011
NC_035786.1,28117298,28130554,28117298,28130554,111104986,XM_022439161.1,uncharacterized LOC111104986,13256
NC_035786.1,29339071,29341262,29339071,29341262,111104990,XM_022439167.1,uncharacterized LOC111104990,2191
NC_035786.1,29352250,29360346,29352250,29360346,111104991,XM_022439168.1,uncharacterized LOC111104991,8096
NC_035786.1,29487502,29489923,29487502,29489923,111104992,XM_022439169.1,uncharacterized LOC111104992,2421
NC_035786.1,29878561,29884616,29878561,29884616,111104995,XM_022439173.1,uncharacterized LOC111104995,6055
NC_035786.1,30013630,30059864,30013630,30059864,111104996,XM_022439174.1,uncharacterized LOC111104996,46234
NC_035786.1,30927250,30937790,30927250,30937790,111105001,XM_022439178.1,uncharacterized LOC111105001,10540
NC_035786.1,31290845,31293610,31290845,31293610,111105006,XM_022439183.1,uncharacterized LOC111105006,2765
NC_035786.1,31362424,31362961,31362424,31362961,111105009,XM_022439186.1,uncharacterized LOC111105009,537
NC_035786.1,31861545,31863947,31861545,31863947,111105013,XM_022439191.1,uncharacterized LOC111105013,2402
NC_035786.1,31893996,31896953,31893996,31896953,111105016,XM_022439194.1,uncharacterized LOC111105016,2957
NC_035786.1,32551941,32559145,32551941,32559145,111105019,XM_022439196.1,uncharacterized LOC111105019,7204
NC_035786.1,32905357,32906670,32905357,32906670,111105020,XM_022439197.1,uncharacterized LOC111105020,1313
NC_035786.1,32928990,32930603,32928990,32930603,111105022,XM_022439199.1,uncharacterized LOC111105022,1613
NC_035786.1,32934162,32935593,32934162,32935593,111105023,XM_022439200.1,uncharacterized LOC111105023,1431
NC_035786.1,33125767,33129306,33125767,33129306,111105027,XM_022439203.1,uncharacterized LOC111105027,3539
NC_035786.1,33149589,33185190,33149589,33185190,111105028,XM_022439204.1,uncharacterized LOC111105028,35601
NC_035786.1,33887704,33907525,33887704,33907525,111105030,XM_022439207.1,uncharacterized LOC111105030,19821
NC_035786.1,34212172,34213885,34212172,34213885,111105032,XM_022439208.1,uncharacterized LOC111105032,1713
NC_035786.1,34429315,34435628,34429315,34435628,111105033,XM_022439209.1,uncharacterized LOC111105033,6313
NC_035780.1,6337712,6355573,6337712,6355459,111105035,XM_022439216.1,uncharacterized LOC111105035,17747
NC_035780.1,6337712,6355573,6337713,6355573,111105035,XM_022439222.1,uncharacterized LOC111105035,17860
NC_035780.1,6337712,6355573,6337712,6355573,111105035,XM_022439210.1,uncharacterized LOC111105035,17861
NC_035786.1,34604223,34609740,34604223,34609740,111105038,XM_022439211.1,uncharacterized LOC111105038,5517
NC_035786.1,37798522,37820008,37798522,37820008,111105051,XM_022439225.1,uncharacterized LOC111105051,21486
NC_035780.1,64874471,64877099,64874471,64877099,111105052,XM_022439258.1,uncharacterized LOC111105052,2628
NC_035786.1,38289716,38292107,38289716,38292107,111105053,XM_022439226.1,uncharacterized LOC111105053,2391
NC_035786.1,38416288,38426123,38416288,38426123,111105054,XM_022439227.1,uncharacterized LOC111105054,9835
NC_035786.1,39872286,39875852,39872286,39875852,111105063,XM_022439236.1,uncharacterized LOC111105063,3566
NC_035786.1,40432578,40433274,40432578,40433274,111105067,XM_022439239.1,uncharacterized LOC111105067,696
NC_035786.1,40434728,40437318,40434728,40437318,111105068,XM_022439240.1,uncharacterized LOC111105068,2590
NC_035786.1,40944464,40947239,40944464,40947239,111105070,XM_022439243.1,uncharacterized LOC111105070,2775
NC_035786.1,41181239,41223921,41181239,41223921,111105071,XM_022439244.1,uncharacterized LOC111105071,42682
NC_035786.1,41811242,41813374,41811242,41813374,111105074,XM_022439247.1,uncharacterized LOC111105074,2132
NC_035786.1,42007625,42008861,42007625,42008861,111105075,XM_022439248.1,uncharacterized LOC111105075,1236
NC_035786.1,42127835,42131808,42127835,42131808,111105077,XM_022439251.1,uncharacterized LOC111105077,3973
NC_035786.1,42825872,42829661,42825872,42829661,111105079,XM_022439253.1,uncharacterized LOC111105079,3789
NC_035786.1,42925464,42928783,42925464,42928783,111105080,XM_022439254.1,uncharacterized LOC111105080,3319
NC_035786.1,43102964,43106285,43102964,43106285,111105083,XM_022439256.1,uncharacterized LOC111105083,3321
NC_035786.1,43300071,43306852,43300071,43306852,111105087,XM_022439260.1,uncharacterized LOC111105087,6781
NC_035786.1,43782389,43786714,43782389,43786714,111105089,XM_022439262.1,uncharacterized LOC111105089,4325
NC_035786.1,43808825,43814021,43808825,43814021,111105090,XM_022439263.1,uncharacterized LOC111105090,5196
NC_035786.1,44171760,44174999,44171760,44174999,111105092,XM_022439265.1,uncharacterized LOC111105092,3239
NC_035786.1,44369309,44370813,44369309,44370813,111105095,XM_022439267.1,uncharacterized LOC111105095,1504
NC_035786.1,44859689,44864899,44859689,44864899,111105099,XM_022439272.1,uncharacterized LOC111105099,5210
NC_035786.1,44872600,44873136,44872600,44873136,111105100,XM_022439273.1,uncharacterized LOC111105100,536
NC_035786.1,44964150,44965367,44964150,44965367,111105102,XM_022439275.1,uncharacterized LOC111105102,1217
NC_035780.1,50278916,50281134,50278916,50281134,111105103,XM_022439279.1,uncharacterized LOC111105103,2218
NC_035786.1,45069340,45075768,45069340,45075768,111105104,XM_022439276.1,uncharacterized LOC111105104,6428
NC_035786.1,45122810,45123538,45122810,45123538,111105105,XM_022439277.1,uncharacterized LOC111105105,728
NC_035786.1,45249127,45254630,45249127,45254630,111105108,XM_022439281.1,uncharacterized LOC111105108,5503
NC_035786.1,45468964,45469947,45468964,45469947,111105109,XM_022439282.1,uncharacterized LOC111105109,983
NC_035786.1,45530430,45531185,45530430,45531185,111105111,XM_022439284.1,uncharacterized LOC111105111,755
NC_035786.1,46000136,46000456,46000136,46000456,111105113,XM_022439285.1,uncharacterized LOC111105113,320
NC_035786.1,46775927,46776543,46775927,46776543,111105117,XM_022439290.1,uncharacterized LOC111105117,616
NC_035786.1,47395887,47397807,47395887,47397807,111105118,XM_022439291.1,uncharacterized LOC111105118,1920
NC_035786.1,47398901,47399442,47398901,47399442,111105119,XM_022439292.1,uncharacterized LOC111105119,541
NC_035786.1,47855567,47857141,47855567,47857141,111105123,XM_022439295.1,uncharacterized LOC111105123,1574
NC_035786.1,47990430,47993804,47990430,47993804,111105124,XM_022439296.1,uncharacterized LOC111105124,3374
NC_035786.1,48045645,48046265,48045645,48046265,111105125,XM_022439297.1,uncharacterized LOC111105125,620
NC_035786.1,48149491,48151716,48149491,48151716,111105126,XM_022439299.1,uncharacterized LOC111105126,2225
NC_035786.1,48188871,48190092,48188871,48190092,111105127,XM_022439300.1,uncharacterized LOC111105127,1221
NC_035786.1,48218681,48220362,48218681,48220362,111105128,XM_022439301.1,uncharacterized LOC111105128,1681
NC_035786.1,48704893,48705980,48704893,48705980,111105129,XM_022439302.1,uncharacterized LOC111105129,1087
NC_035786.1,49043926,49046437,49043926,49046437,111105132,XM_022439305.1,uncharacterized LOC111105132,2511
NC_035786.1,49082767,49086720,49082767,49086720,111105138,XM_022439311.1,uncharacterized LOC111105138,3953
NC_035786.1,49218372,49233775,49218372,49233775,111105139,XM_022439312.1,uncharacterized LOC111105139,15403
NC_035786.1,49300919,49303031,49300919,49303031,111105140,XM_022439313.1,uncharacterized LOC111105140,2112
NC_035786.1,49448409,49450658,49448409,49450658,111105141,XM_022439314.1,uncharacterized LOC111105141,2249
NC_035786.1,49482895,49496537,49482895,49496537,111105142,XM_022439315.1,uncharacterized LOC111105142,13642
NC_035786.1,50206371,50209256,50206371,50209256,111105149,XM_022439322.1,uncharacterized LOC111105149,2885
NC_035786.1,50390706,50418482,50390706,50418482,111105150,XM_022439323.1,uncharacterized LOC111105150,27776
NC_035786.1,50542474,50549652,50542474,50549652,111105152,XM_022439325.1,uncharacterized LOC111105152,7178
NC_035786.1,50660401,50685027,50660401,50685027,111105153,XM_022439326.1,uncharacterized LOC111105153,24626
NC_035786.1,50951668,50952726,50951668,50952726,111105154,XM_022439327.1,uncharacterized LOC111105154,1058
NC_035786.1,51139234,51150713,51139234,51150713,111105158,XM_022439329.1,uncharacterized LOC111105158,11479
NC_035786.1,52617253,52617579,52617253,52617579,111105163,XM_022439334.1,uncharacterized LOC111105163,326
NC_035780.1,57235311,57237477,57235311,57237477,111105165,XM_022439338.1,uncharacterized LOC111105165,2166
NC_035786.1,53540792,53543440,53540792,53543440,111105169,XM_022439340.1,uncharacterized LOC111105169,2648
NC_035786.1,53764398,53769766,53764398,53769766,111105171,XM_022439342.1,uncharacterized LOC111105171,5368
NC_035780.1,30190748,30199073,30190748,30199073,111105172,XM_022439345.1,uncharacterized LOC111105172,8325
NC_035786.1,53959703,53965811,53959703,53965811,111105174,XM_022439343.1,uncharacterized LOC111105174,6108
NC_035786.1,54001110,54028002,54001110,54028002,111105175,XM_022439344.1,uncharacterized LOC111105175,26892
NC_035786.1,54200406,54201296,54200406,54201296,111105178,XM_022439348.1,uncharacterized LOC111105178,890
NC_035786.1,54240206,54240655,54240206,54240655,111105180,XM_022439350.1,uncharacterized LOC111105180,449
NC_035786.1,54372669,54386607,54372669,54386607,111105184,XM_022439353.1,uncharacterized LOC111105184,13938
NC_035786.1,54448866,54449894,54448866,54449894,111105185,XM_022439354.1,uncharacterized LOC111105185,1028
NC_035786.1,54454533,54455111,54454533,54455111,111105186,XM_022439355.1,uncharacterized LOC111105186,578
NC_035786.1,54499218,54502487,54499218,54502487,111105187,XM_022439357.1,uncharacterized LOC111105187,3269
NC_035786.1,54545815,54547114,54545815,54547114,111105191,XM_022439361.1,uncharacterized LOC111105191,1299
NC_035786.1,54683754,54763549,54683754,54763549,111105192,XM_022439362.1,uncharacterized LOC111105192,79795
NC_035786.1,54976837,54981146,54976837,54981146,111105194,XM_022439363.1,uncharacterized LOC111105194,4309
NC_035786.1,56349298,56362839,56349298,56362839,111105198,XM_022439367.1,uncharacterized LOC111105198,13541
NC_035786.1,56402471,56403015,56402471,56403015,111105200,XM_022439369.1,uncharacterized LOC111105200,544
NC_035786.1,56901155,56901826,56901155,56901826,111105203,XM_022439371.1,uncharacterized LOC111105203,671
NC_035786.1,57257877,57346926,57257877,57346926,111105204,XM_022439372.1,uncharacterized LOC111105204,89049
NC_035786.1,57523072,57533295,57523072,57533295,111105207,XM_022439376.1,uncharacterized LOC111105207,10223
NC_035786.1,57549758,57550144,57549758,57550144,111105208,XM_022439377.1,uncharacterized LOC111105208,386
NC_035786.1,57550527,57550904,57550527,57550904,111105209,XM_022439378.1,uncharacterized LOC111105209,377
NC_035786.1,57555644,57556750,57555644,57556750,111105210,XM_022439379.1,uncharacterized LOC111105210,1106
NC_035786.1,57645055,57663094,57645055,57663094,111105213,XM_022439381.1,uncharacterized LOC111105213,18039
NC_035786.1,51937215,51940806,51937215,51940806,111105214,XM_022439382.1,uncharacterized LOC111105214,3591
NC_035786.1,26354844,26363663,26354844,26363663,111105216,XM_022439384.1,uncharacterized LOC111105216,8819
NC_035780.1,27727922,27731281,27727922,27731281,111105219,XM_022439423.1,uncharacterized LOC111105219,3359
NC_035786.1,53716721,53725732,53716721,53725732,111105220,XM_022439386.1,uncharacterized LOC111105220,9011
NC_035786.1,53809778,53813372,53809778,53813372,111105221,XM_022439387.1,uncharacterized LOC111105221,3594
NC_035780.1,54157448,54179173,54157448,54179173,111105223,XM_022439392.1,uncharacterized LOC111105223,21725
NC_035786.1,53820064,53823893,53820064,53823893,111105224,XM_022439389.1,uncharacterized LOC111105224,3829
NC_035786.1,50865210,50874801,50865743,50868438,111105230,XM_022439393.1,uncharacterized LOC111105230,2695
NC_035786.1,50865210,50874801,50865210,50868438,111105230,XM_022439394.1,uncharacterized LOC111105230,3228
NC_035786.1,50865210,50874801,50865743,50872274,111105230,XM_022439396.1,uncharacterized LOC111105230,6531
NC_035786.1,50865210,50874801,50867793,50874801,111105230,XM_022439395.1,uncharacterized LOC111105230,7008
NC_035780.1,42712938,42715682,42712938,42715682,111105234,XM_022439401.1,uncharacterized LOC111105234,2744
NC_035786.1,23528928,23533976,23528928,23532773,111105235,XM_022439400.1,uncharacterized LOC111105235,3845
NC_035786.1,23525209,23528883,23525209,23528883,111105236,XM_022439402.1,uncharacterized LOC111105236,3674
NC_035786.1,9831930,9834859,9831930,9834859,111105238,XM_022439406.1,uncharacterized LOC111105238,2929
NC_035786.1,9819988,9822836,9820154,9822836,111105239,XM_022439408.1,uncharacterized LOC111105239,2682
NC_035786.1,9819988,9822836,9819988,9822836,111105239,XM_022439409.1,uncharacterized LOC111105239,2848
NC_035786.1,15115611,15118949,15115611,15118949,111105241,XM_022439411.1,uncharacterized LOC111105241,3338
NC_035786.1,15113346,15121755,15113346,15121755,111105242,XM_022439412.1,uncharacterized LOC111105242,8409
NC_035786.1,27213094,27218525,27213139,27218525,111105243,XM_022439415.1,uncharacterized LOC111105243,5386
NC_035786.1,27213094,27218525,27213094,27218525,111105243,XM_022439413.1,uncharacterized LOC111105243,5431
NC_035786.1,49289957,49294296,49289957,49294296,111105263,XM_022439445.1,uncharacterized LOC111105263,4339
NC_035786.1,49296767,49300867,49296767,49300867,111105264,XM_022439446.1,uncharacterized LOC111105264,4100
NC_035786.1,6233842,6279356,6233842,6278324,111105268,XM_022439450.1,uncharacterized LOC111105268,44482
NC_035786.1,6233842,6279356,6233842,6279356,111105268,XM_022439451.1,uncharacterized LOC111105268,45514
NC_035780.1,24666786,24668833,24666786,24668833,111105269,XM_022439455.1,uncharacterized LOC111105269,2047
NC_035786.1,20583182,20585237,20583182,20585237,111105270,XM_022439452.1,uncharacterized LOC111105270,2055
NC_035786.1,9879158,9885702,9880725,9885702,111105272,XM_022439454.1,uncharacterized LOC111105272,4977
NC_035786.1,20738655,20762670,20738713,20762670,111105273,XM_022439462.1,uncharacterized LOC111105273,23957
NC_035786.1,20738655,20762670,20738690,20762670,111105273,XM_022439456.1,uncharacterized LOC111105273,23980
NC_035786.1,20738655,20762670,20738655,20762670,111105273,XM_022439458.1,uncharacterized LOC111105273,24015
NC_035780.1,24733842,24735830,24733842,24735830,111105275,XM_022439469.1,uncharacterized LOC111105275,1988
NC_035780.1,53166768,53171671,53166768,53171671,111105281,XM_022439482.1,uncharacterized LOC111105281,4903
NC_035786.1,33481845,33482762,33481845,33482762,111105283,XM_022439481.1,uncharacterized LOC111105283,917
NC_035786.1,30426661,30434890,30426661,30428797,111105285,XM_022439484.1,uncharacterized LOC111105285,2136
NC_035786.1,18890266,18892783,18890266,18892783,111105289,XM_022439487.1,uncharacterized LOC111105289,2517
NC_035786.1,23246310,23265794,23246310,23265758,111105290,XM_022439488.1,uncharacterized LOC111105290,19448
NC_035786.1,23246310,23265794,23246310,23265794,111105290,XM_022439489.1,uncharacterized LOC111105290,19484
NC_035786.1,28174927,28179939,28174927,28179939,111105294,XM_022439492.1,uncharacterized LOC111105294,5012
NC_035786.1,22052905,22082599,22052905,22072097,111105295,XM_022439493.1,uncharacterized LOC111105295,19192
NC_035786.1,22052905,22082599,22052905,22082599,111105295,XM_022439494.1,uncharacterized LOC111105295,29694
NC_035786.1,22086883,22109292,22086883,22109286,111105296,XM_022439496.1,uncharacterized LOC111105296,22403
NC_035786.1,22086883,22109292,22086883,22109292,111105296,XM_022439497.1,uncharacterized LOC111105296,22409
NC_035786.1,22033161,22040081,22033161,22040081,111105297,XM_022439498.1,uncharacterized LOC111105297,6920
NC_035786.1,8161714,8237284,8178207,8237284,111105304,XM_022439519.1,uncharacterized LOC111105304,59077
NC_035786.1,8161714,8237284,8161714,8237284,111105304,XM_022439506.1,uncharacterized LOC111105304,75570
NC_035786.1,45977853,45978906,45977853,45978906,111105307,XM_022439521.1,uncharacterized LOC111105307,1053
NC_035786.1,34655603,34658362,34655603,34658362,111105308,XM_022439522.1,uncharacterized LOC111105308,2759
NC_035786.1,29726252,29738439,29726252,29738439,111105310,XM_022439524.1,uncharacterized LOC111105310,12187
NC_035786.1,33874017,33883310,33874644,33883310,111105312,XM_022439527.1,uncharacterized LOC111105312,8666
NC_035786.1,33874017,33883310,33874017,33883310,111105312,XM_022439526.1,uncharacterized LOC111105312,9293
NC_035786.1,34988002,34991922,34988002,34991922,111105317,XM_022439537.1,uncharacterized LOC111105317,3920
NC_035780.1,17142166,17144685,17142166,17144685,111105322,XM_022439548.1,uncharacterized LOC111105322,2519
NC_035786.1,38274896,38285349,38274896,38285349,111105331,XM_022439563.1,uncharacterized LOC111105331,10453
NC_035780.1,63842106,63843032,63842106,63843032,111105334,XM_022439575.1,uncharacterized LOC111105334,926
NC_035786.1,38067724,38071404,38067724,38071404,111105342,XM_022439582.1,uncharacterized LOC111105342,3680
NC_035780.1,64556108,64560517,64556108,64560517,111105343,XM_022439586.1,uncharacterized LOC111105343,4409
NC_035786.1,38017980,38020433,38017980,38020433,111105345,XM_022439584.1,uncharacterized LOC111105345,2453
NC_035786.1,38500652,38502856,38500652,38502856,111105346,XM_022439585.1,uncharacterized LOC111105346,2204
NC_035786.1,38026690,38028094,38026690,38028094,111105348,XM_022439588.1,uncharacterized LOC111105348,1404
NC_035786.1,38508077,38510858,38508077,38510858,111105349,XM_022439589.1,uncharacterized LOC111105349,2781
NC_035786.1,38028178,38032212,38028178,38032212,111105350,XM_022439590.1,uncharacterized LOC111105350,4034
NC_035786.1,38024542,38025297,38024542,38025297,111105351,XM_022439591.1,uncharacterized LOC111105351,755
NC_035786.1,38513521,38517710,38513521,38517710,111105352,XM_022439592.1,uncharacterized LOC111105352,4189
NC_035786.1,38034863,38039064,38034863,38039064,111105353,XM_022439593.1,uncharacterized LOC111105353,4201
NC_035780.1,54972978,54976446,54972978,54976446,111105354,XM_022439598.1,uncharacterized LOC111105354,3468
NC_035786.1,38506808,38508080,38507066,38508080,111105355,XM_022439595.1,uncharacterized LOC111105355,1014
NC_035786.1,38506808,38508080,38506808,38508080,111105355,XM_022439594.1,uncharacterized LOC111105355,1272
NC_035786.1,37988293,38004631,37995808,38004631,111105356,XM_022439596.1,uncharacterized LOC111105356,8823
NC_035786.1,37988293,38004631,37988293,37997284,111105356,XM_022439599.1,uncharacterized LOC111105356,8991
NC_035780.1,54970228,54973233,54970228,54973220,111105363,XM_022439616.1,uncharacterized LOC111105363,2992
NC_035780.1,54970228,54973233,54970231,54973233,111105363,XM_022439605.1,uncharacterized LOC111105363,3002
NC_035786.1,35434865,35438829,35434865,35438829,111105364,XM_022439601.1,uncharacterized LOC111105364,3964
NC_035780.1,30558384,30580430,30560428,30580430,111105368,XM_022439742.1,uncharacterized LOC111105368,20002
NC_035780.1,30558384,30580430,30558384,30580430,111105368,XM_022439666.1,uncharacterized LOC111105368,22046
NC_035780.1,6322730,6334798,6322730,6334798,111105370,XM_022439634.1,uncharacterized LOC111105370,12068
NC_035786.1,9642026,9648728,9642026,9648728,111105371,XM_022439631.1,uncharacterized LOC111105371,6702
NC_035786.1,21908514,21912809,21908514,21912809,111105375,XM_022439635.1,uncharacterized LOC111105375,4295
NC_035786.1,36713071,36738892,36723845,36738892,111105376,XM_022439637.1,uncharacterized LOC111105376,15047
NC_035786.1,36713071,36738892,36722413,36738892,111105376,XM_022439636.1,uncharacterized LOC111105376,16479
NC_035786.1,36713071,36738892,36713071,36738892,111105376,XM_022439638.1,uncharacterized LOC111105376,25821
NC_035786.1,5407787,5410129,5407787,5410129,111105381,XM_022439649.1,uncharacterized LOC111105381,2342
NC_035786.1,17778133,17796082,17778133,17796082,111105382,XM_022439651.1,uncharacterized LOC111105382,17949
NC_035786.1,17778133,17796082,17786391,17796082,111105382,XM_022439658.1,uncharacterized LOC111105382,9691
NC_035786.1,17778133,17796082,17786272,17796082,111105382,XM_022439653.1,uncharacterized LOC111105382,9810
NC_035786.1,17778133,17796082,17786224,17796082,111105382,XM_022439657.1,uncharacterized LOC111105382,9858
NC_035786.1,417974,420343,417974,420343,111105386,XM_022439662.1,uncharacterized LOC111105386,2369
NC_035786.1,3860787,3862415,3860787,3862415,111105387,XM_022439663.1,uncharacterized LOC111105387,1628
NC_035786.1,9109794,9121484,9109794,9121484,111105390,XM_022439665.1,uncharacterized LOC111105390,11690
NC_035786.1,9099564,9109170,9099564,9109170,111105391,XM_022439668.1,uncharacterized LOC111105391,9606
NC_035786.1,44323251,44327228,44323251,44327228,111105393,XM_022439669.1,uncharacterized LOC111105393,3977
NC_035786.1,25328754,25330466,25328754,25330466,111105395,XM_022439672.1,uncharacterized LOC111105395,1712
NC_035780.1,5953052,5962871,5958989,5962871,111105397,XM_022439678.1,uncharacterized LOC111105397,3882
NC_035780.1,5953052,5962871,5953052,5962871,111105397,XM_022439686.1,uncharacterized LOC111105397,9819
NC_035786.1,30146785,30148740,30146785,30148740,111105398,XM_022439675.1,uncharacterized LOC111105398,1955
NC_035786.1,51224481,51231708,51224481,51231708,111105399,XM_022439676.1,uncharacterized LOC111105399,7227
NC_035786.1,9730427,9737411,9730427,9737411,111105400,XM_022439677.1,uncharacterized LOC111105400,6984
NC_035786.1,743327,748814,743775,748814,111105405,XM_022439684.1,uncharacterized LOC111105405,5039
NC_035786.1,743327,748814,743327,748814,111105405,XM_022439685.1,uncharacterized LOC111105405,5487
NC_035786.1,16649057,16653687,16649057,16653687,111105408,XM_022439692.1,uncharacterized LOC111105408,4630
NC_035786.1,4282369,4308975,4282369,4308975,111105409,XM_022439693.1,uncharacterized LOC111105409,26606
NC_035780.1,8443750,8445014,8443750,8445014,111105410,XM_022439698.1,uncharacterized LOC111105410,1264
NC_035786.1,32403328,32406281,32403328,32406281,111105413,XM_022439700.1,uncharacterized LOC111105413,2953
NC_035786.1,11929968,11933384,11929968,11933384,111105415,XM_022439702.1,uncharacterized LOC111105415,3416
NC_035786.1,19539475,19544702,19539475,19544702,111105416,XM_022439703.1,uncharacterized LOC111105416,5227
NC_035780.1,21802648,21816074,21802648,21816056,111105418,XM_022439716.1,uncharacterized LOC111105418,13408
NC_035780.1,21802648,21816074,21802648,21816074,111105418,XM_022439721.1,uncharacterized LOC111105418,13426
NC_035786.1,52165116,52166783,52165116,52166378,111105420,XM_022439705.1,uncharacterized LOC111105420,1262
NC_035786.1,52165116,52166783,52165116,52166783,111105420,XM_022439704.1,uncharacterized LOC111105420,1667
NC_035786.1,26529987,26533560,26529987,26533560,111105421,XM_022439706.1,uncharacterized LOC111105421,3573
NC_035786.1,7035170,7036811,7035170,7036811,111105424,XM_022439717.1,uncharacterized LOC111105424,1641
NC_035786.1,6986933,6989746,6986933,6989746,111105425,XM_022439718.1,uncharacterized LOC111105425,2813
NC_035786.1,40680510,40705700,40680510,40691431,111105431,XM_022439725.1,uncharacterized LOC111105431,10921
NC_035786.1,40680510,40705700,40680510,40705700,111105431,XM_022439724.1,uncharacterized LOC111105431,25190
NC_035786.1,14921868,14946528,14921868,14946528,111105432,XM_022439727.1,uncharacterized LOC111105432,24660
NC_035786.1,14921868,14946528,14941628,14946528,111105432,XM_022439726.1,uncharacterized LOC111105432,4900
NC_035780.1,35907724,35913022,35907724,35912677,111105435,XM_022439735.1,uncharacterized LOC111105435,4953
NC_035780.1,35907724,35913022,35907724,35913022,111105435,XM_022439743.1,uncharacterized LOC111105435,5298
NC_035786.1,35105377,35112308,35105377,35112308,111105440,XM_022439739.1,uncharacterized LOC111105440,6931
NC_035786.1,31838143,31853087,31838143,31853087,111105441,XM_022439740.1,uncharacterized LOC111105441,14944
NC_035786.1,31923054,31925750,31923054,31925750,111105444,XM_022439745.1,uncharacterized LOC111105444,2696
NC_035786.1,27248355,27257118,27248355,27257118,111105452,XM_022439752.1,uncharacterized LOC111105452,8763
NC_035786.1,9607433,9611649,9607433,9611649,111105455,XM_022439761.1,uncharacterized LOC111105455,4216
NC_035786.1,3952081,3955070,3952081,3955070,111105458,XM_022439764.1,uncharacterized LOC111105458,2989
NC_035786.1,9543562,9550445,9543562,9550445,111105461,XM_022439767.1,uncharacterized LOC111105461,6883
NC_035786.1,29473642,29480131,29473642,29480131,111105463,XM_022439775.1,uncharacterized LOC111105463,6489
NC_035780.1,60744749,60761619,60744749,60761619,111105466,XM_022439783.1,uncharacterized LOC111105466,16870
NC_035786.1,15353304,15360616,15353304,15360616,111105467,XM_022439780.1,uncharacterized LOC111105467,7312
NC_035786.1,21940127,21955239,21940132,21955239,111105470,XM_022439784.1,uncharacterized LOC111105470,15107
NC_035786.1,21940127,21955239,21940127,21955239,111105470,XM_022439785.1,uncharacterized LOC111105470,15112
NC_035786.1,21946917,21953464,21946956,21953464,111105471,XM_022439786.1,uncharacterized LOC111105471,6508
NC_035786.1,21946917,21953464,21946917,21953464,111105471,XM_022439787.1,uncharacterized LOC111105471,6547
NC_035786.1,16583115,16638256,16583115,16638256,111105473,XM_022439788.1,uncharacterized LOC111105473,55141
NC_035780.1,60763685,60770843,60764326,60770843,111105479,XM_022439796.1,uncharacterized LOC111105479,6517
NC_035786.1,16436733,16496226,16445900,16496226,111105480,XM_022439792.1,uncharacterized LOC111105480,50326
NC_035786.1,16436733,16496226,16441042,16492425,111105480,XM_022439800.1,uncharacterized LOC111105480,51383
NC_035786.1,16436733,16496226,16441042,16492426,111105480,XM_022439799.1,uncharacterized LOC111105480,51384
NC_035786.1,16436733,16496226,16441120,16496226,111105480,XM_022439793.1,uncharacterized LOC111105480,55106
NC_035786.1,16436733,16496226,16441111,16496226,111105480,XM_022439794.1,uncharacterized LOC111105480,55115
NC_035786.1,16436733,16496226,16441042,16496226,111105480,XM_022439798.1,uncharacterized LOC111105480,55184
NC_035786.1,16436733,16496226,16437894,16496226,111105480,XM_022439795.1,uncharacterized LOC111105480,58332
NC_035786.1,16436733,16496226,16436733,16496226,111105480,XM_022439797.1,uncharacterized LOC111105480,59493
NC_035786.1,9415616,9417386,9415616,9417386,111105481,XM_022439801.1,uncharacterized LOC111105481,1770
NC_035786.1,32559776,32562993,32559776,32562993,111105482,XM_022439803.1,uncharacterized LOC111105482,3217
NC_035786.1,403051,405348,403051,405348,111105483,XM_022439804.1,uncharacterized LOC111105483,2297
NC_035786.1,49425906,49428119,49425906,49428119,111105486,XM_022439808.1,uncharacterized LOC111105486,2213
NC_035786.1,53893753,53914226,53893753,53914226,111105490,XM_022439811.1,uncharacterized LOC111105490,20473
NC_035786.1,40037008,40041216,40037008,40041216,111105491,XM_022439812.1,uncharacterized LOC111105491,4208
NC_035786.1,35440744,35443952,35440744,35443952,111105493,XM_022439815.1,uncharacterized LOC111105493,3208
NC_035786.1,22437044,22453376,22437044,22453376,111105496,XM_022439823.1,uncharacterized LOC111105496,16332
NC_035786.1,32980851,32995479,32980851,32995479,111105500,XM_022439829.1,uncharacterized LOC111105500,14628
NC_035786.1,45290725,45293401,45290725,45293401,111105504,XM_022439836.1,uncharacterized LOC111105504,2676
NC_035786.1,45288151,45290397,45288151,45290397,111105505,XM_022439837.1,uncharacterized LOC111105505,2246
NC_035786.1,19927929,19936350,19927929,19936350,111105507,XM_022439839.1,uncharacterized LOC111105507,8421
NC_035786.1,9799900,9803543,9799900,9803543,111105508,XM_022439840.1,uncharacterized LOC111105508,3643
NC_035780.1,52609508,52624317,52609508,52624317,111105512,XM_022439860.1,uncharacterized LOC111105512,14809
NC_035786.1,17290582,17293064,17290582,17293064,111105514,XM_022439857.1,uncharacterized LOC111105514,2482
NC_035786.1,17287486,17290553,17287486,17290553,111105515,XM_022439858.1,uncharacterized LOC111105515,3067
NC_035786.1,21606227,21609333,21606227,21609333,111105524,XM_022439870.1,uncharacterized LOC111105524,3106
NC_035786.1,42844608,42868915,42844608,42868915,111105525,XM_022439871.1,uncharacterized LOC111105525,24307
NC_035786.1,12415669,12420841,12415669,12420841,111105530,XM_022439877.1,uncharacterized LOC111105530,5172
NC_035786.1,49743781,49748534,49743781,49748534,111105539,XM_022439882.1,uncharacterized LOC111105539,4753
NC_035786.1,25395388,25399118,25396031,25399118,111105545,XM_022439890.1,uncharacterized LOC111105545,3087
NC_035786.1,25395388,25399118,25395388,25399118,111105545,XM_022439888.1,uncharacterized LOC111105545,3730
NC_035786.1,3187700,3189690,3187700,3189690,111105548,XM_022439898.1,uncharacterized LOC111105548,1990
NC_035786.1,8412036,8438704,8414016,8438702,111105549,XM_022439903.1,uncharacterized LOC111105549,24686
NC_035786.1,8412036,8438704,8412036,8437648,111105549,XM_022439902.1,uncharacterized LOC111105549,25612
NC_035786.1,8412036,8438704,8412036,8438703,111105549,XM_022439900.1,uncharacterized LOC111105549,26667
NC_035786.1,8412036,8438704,8412036,8438704,111105549,XM_022439901.1,uncharacterized LOC111105549,26668
NC_035786.1,52211184,52311498,52211184,52311498,111105551,XM_022439904.1,uncharacterized LOC111105551,100314
NC_035786.1,21179657,21200675,21187106,21199720,111105552,XM_022439908.1,uncharacterized LOC111105552,12614
NC_035786.1,21179657,21200675,21187104,21199720,111105552,XM_022439907.1,uncharacterized LOC111105552,12616
NC_035786.1,21179657,21200675,21180051,21199720,111105552,XM_022439906.1,uncharacterized LOC111105552,19669
NC_035786.1,21179657,21200675,21179657,21199720,111105552,XM_022439905.1,uncharacterized LOC111105552,20063
NC_035786.1,21179657,21200675,21179657,21200675,111105552,XM_022439909.1,uncharacterized LOC111105552,21018
NC_035786.1,20893394,20895166,20893394,20895166,111105554,XM_022439911.1,uncharacterized LOC111105554,1772
NC_035786.1,11244948,11246307,11244948,11246307,111105556,XM_022439914.1,uncharacterized LOC111105556,1359
NC_035786.1,27222146,27228186,27222146,27228186,111105557,XM_022439915.1,uncharacterized LOC111105557,6040
NC_035780.1,27720867,27723618,27720867,27723618,111105558,XM_022439918.1,uncharacterized LOC111105558,2751
NC_035786.1,53510887,53514834,53510887,53514834,111105559,XM_022439916.1,uncharacterized LOC111105559,3947
NC_035786.1,53359827,53373661,53359827,53373661,111105564,XM_022439919.1,uncharacterized LOC111105564,13834
NC_035786.1,57737415,57741892,57737415,57741892,111105565,XM_022439920.1,uncharacterized LOC111105565,4477
NC_035786.1,50468145,50476085,50468145,50476085,111105566,XM_022439921.1,uncharacterized LOC111105566,7940
NC_035786.1,49282414,49287955,49282414,49287955,111105568,XM_022439923.1,uncharacterized LOC111105568,5541
NC_035786.1,36163715,36165638,36163715,36165638,111105571,XM_022439926.1,uncharacterized LOC111105571,1923
NC_035786.1,3282769,3284947,3282769,3284947,111105574,XM_022439930.1,uncharacterized LOC111105574,2178
NC_035786.1,32096056,32108700,32096056,32108700,111105575,XM_022439932.1,uncharacterized LOC111105575,12644
NC_035786.1,32096056,32108700,32100014,32108700,111105575,XM_022439931.1,uncharacterized LOC111105575,8686
NC_035786.1,16697794,16703735,16697794,16703735,111105576,XM_022439934.1,uncharacterized LOC111105576,5941
NC_035786.1,27423497,27429714,27423497,27429714,111105581,XM_022439942.1,uncharacterized LOC111105581,6217
NC_035786.1,40834392,40836312,40834392,40836312,111105584,XM_022439943.1,uncharacterized LOC111105584,1920
NC_035786.1,29213579,29216773,29213579,29216773,111105585,XM_022439944.1,uncharacterized LOC111105585,3194
NC_035786.1,29228698,29231771,29228698,29231771,111105586,XM_022439945.1,uncharacterized LOC111105586,3073
NC_035780.1,61014393,61024038,61014393,61023453,111105587,XM_022439949.1,uncharacterized LOC111105587,9060
NC_035780.1,61014393,61024038,61014393,61024038,111105587,XM_022439957.1,uncharacterized LOC111105587,9645
NC_035786.1,10211103,10212104,10211103,10212104,111105592,XM_022439952.1,uncharacterized LOC111105592,1001
NC_035786.1,16346054,16355166,16346054,16353792,111105593,XM_022439953.1,uncharacterized LOC111105593,7738
NC_035786.1,16346054,16355166,16346054,16355166,111105593,XM_022439954.1,uncharacterized LOC111105593,9112
NC_035786.1,52594392,52612905,52594392,52612905,111105594,XM_022439955.1,uncharacterized LOC111105594,18513
NC_035786.1,30418756,30421401,30418756,30421401,111105599,XM_022439965.1,uncharacterized LOC111105599,2645
NC_035786.1,4823758,4826052,4823758,4826052,111105601,XM_022439966.1,uncharacterized LOC111105601,2294
NC_035786.1,29708410,29713200,29708410,29713200,111105604,XM_022439969.1,uncharacterized LOC111105604,4790
NC_035786.1,4685417,4688377,4685417,4688377,111105605,XM_022439970.1,uncharacterized LOC111105605,2960
NC_035786.1,54121413,54129623,54121413,54129623,111105606,XM_022439971.1,uncharacterized LOC111105606,8210
NC_035786.1,11739035,11740399,11739035,11740399,111105608,XM_022439972.1,uncharacterized LOC111105608,1364
NC_035786.1,42809473,42823938,42809473,42819596,111105609,XM_022439973.1,uncharacterized LOC111105609,10123
NC_035786.1,42809473,42823938,42809473,42823467,111105609,XM_022439975.1,uncharacterized LOC111105609,13994
NC_035786.1,42809473,42823938,42809473,42823938,111105609,XM_022439974.1,uncharacterized LOC111105609,14465
NC_035786.1,4552632,4578168,4552632,4578168,111105611,XM_022439976.1,uncharacterized LOC111105611,25536
NC_035786.1,19103141,19105272,19103141,19105272,111105614,XM_022439980.1,uncharacterized LOC111105614,2131
NC_035786.1,45284322,45285135,45284322,45285135,111105618,XM_022439985.1,uncharacterized LOC111105618,813
NC_035786.1,3882677,3923025,3882677,3923025,111105620,XM_022439989.1,uncharacterized LOC111105620,40348
NC_035786.1,21922639,21934242,21922639,21934242,111105621,XM_022439990.1,uncharacterized LOC111105621,11603
NC_035786.1,7524606,7526785,7524606,7526785,111105622,XM_022439992.1,uncharacterized LOC111105622,2179
NC_035786.1,8033703,8038422,8033703,8038422,111105625,XM_022439996.1,uncharacterized LOC111105625,4719
NC_035786.1,34597088,34599814,34597088,34599814,111105627,XM_022439997.1,uncharacterized LOC111105627,2726
NC_035786.1,23888024,23892435,23888024,23892435,111105628,XM_022439999.1,uncharacterized LOC111105628,4411
NC_035786.1,42113405,42118836,42113475,42118836,111105629,XM_022440001.1,uncharacterized LOC111105629,5361
NC_035786.1,42113405,42118836,42113405,42118836,111105629,XM_022440000.1,uncharacterized LOC111105629,5431
NC_035786.1,9520745,9537384,9520745,9537384,111105631,XM_022440002.1,uncharacterized LOC111105631,16639
NC_035780.1,45356658,45360230,45356658,45360230,111105632,XM_022440021.1,uncharacterized LOC111105632,3572
NC_035786.1,11323526,11332316,11323526,11331726,111105635,XM_022440014.1,uncharacterized LOC111105635,8200
NC_035786.1,11323526,11332316,11323526,11332152,111105635,XM_022440012.1,uncharacterized LOC111105635,8626
NC_035786.1,11323526,11332316,11323526,11332316,111105635,XM_022440011.1,uncharacterized LOC111105635,8790
NC_035787.1,4799089,4805307,4799089,4805307,111105675,XM_022440024.1,uncharacterized LOC111105675,6218
NC_035787.1,22326786,22335768,22326786,22335768,111105676,XM_022440025.1,uncharacterized LOC111105676,8982
NC_035787.1,22115119,22116691,22115119,22116691,111105678,XM_022440027.1,uncharacterized LOC111105678,1572
NC_035787.1,16097115,16098529,16097115,16098529,111105680,XM_022440030.1,uncharacterized LOC111105680,1414
NC_035787.1,45439308,45469574,45439308,45462140,111105682,XM_022440033.1,uncharacterized LOC111105682,22832
NC_035787.1,45439308,45469574,45439308,45469574,111105682,XM_022440032.1,uncharacterized LOC111105682,30266
NC_035787.1,45524048,45560061,45524048,45560061,111105683,XM_022440034.1,uncharacterized LOC111105683,36013
NC_035787.1,45677769,45725265,45694822,45725265,111105684,XM_022440039.1,uncharacterized LOC111105684,30443
NC_035787.1,45677769,45725265,45692177,45725265,111105684,XM_022440036.1,uncharacterized LOC111105684,33088
NC_035787.1,45677769,45725265,45684939,45725265,111105684,XM_022440037.1,uncharacterized LOC111105684,40326
NC_035787.1,45677769,45725265,45681657,45725265,111105684,XM_022440038.1,uncharacterized LOC111105684,43608
NC_035787.1,45677769,45725265,45677770,45725264,111105684,XM_022440040.1,uncharacterized LOC111105684,47494
NC_035787.1,45677769,45725265,45677769,45725264,111105684,XM_022440035.1,uncharacterized LOC111105684,47495
NC_035787.1,45770842,45778777,45770842,45778777,111105687,XM_022440045.1,uncharacterized LOC111105687,7935
NC_035787.1,45788664,45791081,45788664,45791081,111105689,XM_022440049.1,uncharacterized LOC111105689,2417
NC_035780.1,163809,183798,163809,183798,111105691,XM_022440054.1,uncharacterized LOC111105691,19989
NC_035787.1,45634661,45637391,45634661,45637391,111105693,XM_022440052.1,uncharacterized LOC111105693,2730
NC_035787.1,45778860,45796458,45778860,45796458,111105698,XM_022440058.1,uncharacterized LOC111105698,17598
NC_035787.1,19787195,19789407,19787195,19789407,111105699,XM_022440059.1,uncharacterized LOC111105699,2212
NC_035787.1,19795863,19798870,19795863,19798870,111105700,XM_022440060.1,uncharacterized LOC111105700,3007
NC_035787.1,19900427,19904021,19900427,19904021,111105703,XM_022440062.1,uncharacterized LOC111105703,3594
NC_035787.1,19811882,19815438,19811882,19815438,111105704,XM_022440063.1,uncharacterized LOC111105704,3556
NC_035787.1,19885118,19886877,19885118,19886877,111105707,XM_022440065.1,uncharacterized LOC111105707,1759
NC_035787.1,32291821,32323633,32291821,32323633,111105715,XM_022440073.1,uncharacterized LOC111105715,31812
NC_035787.1,72578295,72581499,72578295,72581499,111105719,XM_022440096.1,uncharacterized LOC111105719,3204
NC_035787.1,8037420,8039473,8037420,8039473,111105729,XM_022440103.1,uncharacterized LOC111105729,2053
NC_035787.1,1473567,1476415,1473567,1476415,111105731,XM_022440104.1,uncharacterized LOC111105731,2848
NC_035787.1,6293989,6317232,6293989,6317232,111105739,XM_022440110.1,uncharacterized LOC111105739,23243
NC_035787.1,34389425,34392924,34389425,34392924,111105742,XM_022440116.1,uncharacterized LOC111105742,3499
NC_035787.1,47661332,47673319,47661332,47673319,111105743,XM_022440117.1,uncharacterized LOC111105743,11987
NC_035787.1,60227646,60231522,60227646,60230591,111105745,XM_022440120.1,uncharacterized LOC111105745,2945
NC_035787.1,60227646,60231522,60227646,60231522,111105745,XM_022440121.1,uncharacterized LOC111105745,3876
NC_035787.1,17103330,17107844,17103330,17106884,111105746,XM_022440122.1,uncharacterized LOC111105746,3554
NC_035787.1,17103330,17107844,17103330,17107844,111105746,XM_022440123.1,uncharacterized LOC111105746,4514
NC_035780.1,47598362,47611755,47598362,47611755,111105747,XM_022440127.1,uncharacterized LOC111105747,13393
NC_035787.1,65609293,65614104,65609293,65614104,111105751,XM_022440129.1,uncharacterized LOC111105751,4811
NC_035787.1,14592747,14594865,14592747,14594830,111105752,XM_022440132.1,uncharacterized LOC111105752,2083
NC_035787.1,14592747,14594865,14592747,14594865,111105752,XM_022440130.1,uncharacterized LOC111105752,2118
NC_035780.1,56599004,56610969,56599006,56610968,111105755,XM_022440153.1,uncharacterized LOC111105755,11962
NC_035780.1,56599004,56610969,56599004,56610969,111105755,XM_022440147.1,uncharacterized LOC111105755,11965
NC_035780.1,56599004,56610969,56599124,56602993,111105755,XM_022440139.1,uncharacterized LOC111105755,3869
NC_035787.1,401688,404838,401688,404838,111105756,XM_022440138.1,uncharacterized LOC111105756,3150
NC_035787.1,56019808,56036925,56019808,56036925,111105758,XM_022440140.1,uncharacterized LOC111105758,17117
NC_035787.1,51941229,51943350,51941229,51943350,111105761,XM_022440142.1,uncharacterized LOC111105761,2121
NC_035787.1,8132531,8134003,8132531,8134003,111105765,XM_022440150.1,uncharacterized LOC111105765,1472
NC_035780.1,56594511,56596430,56594926,56596430,111105775,XM_022440165.1,uncharacterized LOC111105775,1504
NC_035787.1,10214961,10218198,10214961,10217364,111105778,XM_022440166.1,uncharacterized LOC111105778,2403
NC_035787.1,10214961,10218198,10214961,10218197,111105778,XM_022440164.1,uncharacterized LOC111105778,3236
NC_035787.1,10214961,10218198,10214961,10218198,111105778,XM_022440163.1,uncharacterized LOC111105778,3237
NC_035787.1,65342499,65346871,65343486,65346869,111105788,XM_022440175.1,uncharacterized LOC111105788,3383
NC_035787.1,65342499,65346871,65343485,65346871,111105788,XM_022440176.1,uncharacterized LOC111105788,3386
NC_035787.1,65342499,65346871,65342499,65346869,111105788,XM_022440174.1,uncharacterized LOC111105788,4370
NC_035787.1,11112022,11113106,11112022,11113106,111105792,XM_022440179.1,uncharacterized LOC111105792,1084
NC_035787.1,3364601,3384419,3364601,3384419,111105793,XM_022440180.1,uncharacterized LOC111105793,19818
NC_035780.1,48293000,48301601,48293232,48301601,111105795,XM_022440191.1,uncharacterized LOC111105795,8369
NC_035780.1,48293000,48301601,48293000,48301549,111105795,XM_022440185.1,uncharacterized LOC111105795,8549
NC_035780.1,48293000,48301601,48293000,48301601,111105795,XM_022440200.1,uncharacterized LOC111105795,8601
NC_035787.1,69712396,69715800,69712396,69715800,111105797,XM_022440183.1,uncharacterized LOC111105797,3404
NC_035787.1,48033369,48034620,48033369,48034620,111105798,XM_022440184.1,uncharacterized LOC111105798,1251
NC_035787.1,48034633,48035527,48034679,48035527,111105799,XM_022440186.1,uncharacterized LOC111105799,848
NC_035787.1,36685396,36688949,36685396,36688949,111105800,XM_022440187.1,uncharacterized LOC111105800,3553
NC_035787.1,22363989,22374350,22363989,22374350,111105801,XM_022440188.1,uncharacterized LOC111105801,10361
NC_035787.1,72633667,72638722,72633667,72638722,111105803,XM_022440193.1,uncharacterized LOC111105803,5055
NC_035787.1,24874107,24917065,24874107,24909425,111105805,XM_022440198.1,uncharacterized LOC111105805,35318
NC_035787.1,24874107,24917065,24874107,24917064,111105805,XM_022440196.1,uncharacterized LOC111105805,42957
NC_035787.1,24874107,24917065,24874107,24917065,111105805,XM_022440197.1,uncharacterized LOC111105805,42958
NC_035787.1,12377019,12380151,12377019,12380151,111105809,XM_022440208.1,uncharacterized LOC111105809,3132
NC_035787.1,36772945,36784024,36772947,36784022,111105810,XM_022440210.1,uncharacterized LOC111105810,11075
NC_035787.1,36772945,36784024,36772945,36784024,111105810,XM_022440209.1,uncharacterized LOC111105810,11079
NC_035787.1,36772945,36784024,36773106,36781615,111105810,XM_022440211.1,uncharacterized LOC111105810,8509
NC_035787.1,36015696,36026199,36015696,36026199,111105812,XM_022440213.1,uncharacterized LOC111105812,10503
NC_035787.1,36015696,36026199,36017348,36026199,111105812,XM_022440212.1,uncharacterized LOC111105812,8851
NC_035787.1,10078788,10082446,10078788,10082446,111105815,XM_022440217.1,uncharacterized LOC111105815,3658
NC_035787.1,35758030,35761115,35758030,35761115,111105817,XM_022440220.1,uncharacterized LOC111105817,3085
NC_035787.1,11303520,11307912,11303520,11307912,111105819,XM_022440223.1,uncharacterized LOC111105819,4392
NC_035787.1,25935077,25945219,25935078,25945205,111105825,XM_022440228.1,uncharacterized LOC111105825,10127
NC_035787.1,25935077,25945219,25935077,25945205,111105825,XM_022440229.1,uncharacterized LOC111105825,10128
NC_035787.1,25935077,25945219,25935078,25945219,111105825,XM_022440231.1,uncharacterized LOC111105825,10141
NC_035787.1,25935077,25945219,25939303,25945207,111105825,XM_022440230.1,uncharacterized LOC111105825,5904
NC_035787.1,70850432,70859405,70850432,70859405,111105827,XM_022440233.1,uncharacterized LOC111105827,8973
NC_035780.1,48300330,48314804,48300330,48314804,111105829,XM_022440253.1,uncharacterized LOC111105829,14474
NC_035787.1,48122558,48127174,48122558,48127174,111105832,XM_022440258.1,uncharacterized LOC111105832,4616
NC_035787.1,1020874,1031356,1020874,1031356,111105833,XM_022440259.1,uncharacterized LOC111105833,10482
NC_035780.1,9932790,9941108,9939257,9941108,111105835,XM_022440274.1,uncharacterized LOC111105835,1851
NC_035780.1,9932790,9941108,9937479,9941108,111105835,XM_022440283.1,uncharacterized LOC111105835,3629
NC_035780.1,9932790,9941108,9932832,9941108,111105835,XM_022440292.1,uncharacterized LOC111105835,8276
NC_035780.1,9932790,9941108,9932790,9941108,111105835,XM_022440264.1,uncharacterized LOC111105835,8318
NC_035787.1,50430090,50443493,50430144,50443493,111105840,XM_022440275.1,uncharacterized LOC111105840,13349
NC_035787.1,50430090,50443493,50430093,50443493,111105840,XM_022440272.1,uncharacterized LOC111105840,13400
NC_035787.1,50430090,50443493,50430090,50443493,111105840,XM_022440278.1,uncharacterized LOC111105840,13403
NC_035787.1,50430090,50443493,50436878,50443493,111105840,XM_022440273.1,uncharacterized LOC111105840,6615
NC_035787.1,50430090,50443493,50436293,50443493,111105840,XM_022440277.1,uncharacterized LOC111105840,7200
NC_035787.1,50430090,50443493,50436290,50443493,111105840,XM_022440269.1,uncharacterized LOC111105840,7203
NC_035787.1,50430090,50443493,50436288,50443493,111105840,XM_022440268.1,uncharacterized LOC111105840,7205
NC_035787.1,50430090,50443493,50436287,50443493,111105840,XM_022440271.1,uncharacterized LOC111105840,7206
NC_035787.1,50430090,50443493,50435931,50443493,111105840,XM_022440270.1,uncharacterized LOC111105840,7562
NC_035787.1,50430090,50443493,50434694,50443493,111105840,XM_022440279.1,uncharacterized LOC111105840,8799
NC_035787.1,45019458,45032841,45019458,45032841,111105844,XM_022440288.1,uncharacterized LOC111105844,13383
NC_035787.1,19216041,19218551,19216041,19218551,111105845,XM_022440289.1,uncharacterized LOC111105845,2510
NC_035787.1,19191696,19195295,19191696,19195295,111105846,XM_022440290.1,uncharacterized LOC111105846,3599
NC_035787.1,11177789,11182535,11177789,11182535,111105848,XM_022440298.1,uncharacterized LOC111105848,4746
NC_035787.1,4038248,4043757,4038248,4043757,111105849,XM_022440299.1,uncharacterized LOC111105849,5509
NC_035780.1,45523607,45525369,45523607,45525369,111105851,XM_022440305.1,uncharacterized LOC111105851,1762
NC_035787.1,27927653,27938812,27927655,27938812,111105852,XM_022440303.1,uncharacterized LOC111105852,11157
NC_035787.1,27927653,27938812,27927654,27938812,111105852,XM_022440301.1,uncharacterized LOC111105852,11158
NC_035787.1,27927653,27938812,27927653,27938812,111105852,XM_022440302.1,uncharacterized LOC111105852,11159
NC_035787.1,18907891,18911148,18907891,18911148,111105854,XM_022440307.1,uncharacterized LOC111105854,3257
NC_035787.1,366294,371785,366294,371783,111105856,XM_022440310.1,uncharacterized LOC111105856,5489
NC_035787.1,366294,371785,366294,371785,111105856,XM_022440309.1,uncharacterized LOC111105856,5491
NC_035787.1,53043054,53050918,53043054,53050918,111105857,XM_022440311.1,uncharacterized LOC111105857,7864
NC_035787.1,58686109,58698943,58686110,58698943,111105862,XM_022440315.1,uncharacterized LOC111105862,12833
NC_035787.1,58686109,58698943,58686109,58698943,111105862,XM_022440314.1,uncharacterized LOC111105862,12834
NC_035787.1,425156,426811,425156,426811,111105867,XM_022440323.1,uncharacterized LOC111105867,1655
NC_035787.1,12266624,12292333,12266624,12292333,111105870,XM_022440325.1,uncharacterized LOC111105870,25709
NC_035787.1,68741541,68760350,68741541,68760350,111105872,XM_022440326.1,uncharacterized LOC111105872,18809
NC_035787.1,9726488,9731049,9726488,9731049,111105874,XM_022440329.1,uncharacterized LOC111105874,4561
NC_035787.1,65594119,65597785,65594119,65597785,111105875,XM_022440330.1,uncharacterized LOC111105875,3666
NC_035787.1,12432218,12435222,12432218,12435222,111105876,XM_022440332.1,uncharacterized LOC111105876,3004
NC_035787.1,29792883,29795217,29792883,29795217,111105878,XM_022440334.1,uncharacterized LOC111105878,2334
NC_035787.1,37048953,37050877,37048953,37050877,111105888,XM_022440344.1,uncharacterized LOC111105888,1924
NC_035787.1,36744645,36747060,36744645,36747060,111105893,XM_022440350.1,uncharacterized LOC111105893,2415
NC_035780.1,16813271,16824356,16813271,16824356,111105895,XM_022440352.1,uncharacterized LOC111105895,11085
NC_035787.1,65861460,65893627,65861504,65893627,111105900,XM_022440358.1,uncharacterized LOC111105900,32123
NC_035787.1,65861460,65893627,65861460,65893627,111105900,XM_022440357.1,uncharacterized LOC111105900,32167
NC_035780.1,3709487,3731355,3709487,3731355,111105905,XM_022440381.1,uncharacterized LOC111105905,21868
NC_035787.1,13124751,13131627,13124751,13131627,111105907,XM_022440382.1,uncharacterized LOC111105907,6876
NC_035787.1,66077286,66089909,66079818,66089908,111105910,XM_022440389.1,uncharacterized LOC111105910,10090
NC_035787.1,66077286,66089909,66077286,66089909,111105910,XM_022440388.1,uncharacterized LOC111105910,12623
NC_035787.1,66654043,66657777,66655078,66657777,111105916,XM_022440398.1,uncharacterized LOC111105916,2699
NC_035787.1,66654043,66657777,66655077,66657777,111105916,XM_022440397.1,uncharacterized LOC111105916,2700
NC_035787.1,66654043,66657777,66654043,66657777,111105916,XM_022440396.1,uncharacterized LOC111105916,3734
NC_035787.1,66661619,66664404,66661619,66664404,111105917,XM_022440399.1,uncharacterized LOC111105917,2785
NC_035787.1,66459963,66500662,66459963,66489390,111105920,XM_022440403.1,uncharacterized LOC111105920,29427
NC_035787.1,66459963,66500662,66459963,66490997,111105920,XM_022440401.1,uncharacterized LOC111105920,31034
NC_035787.1,66459963,66500662,66459963,66493938,111105920,XM_022440402.1,uncharacterized LOC111105920,33975
NC_035787.1,66459963,66500662,66459963,66497798,111105920,XM_022440404.1,uncharacterized LOC111105920,37835
NC_035787.1,66459963,66500662,66459963,66500662,111105920,XM_022440406.1,uncharacterized LOC111105920,40699
NC_035787.1,66362062,66449448,66362062,66389425,111105921,XM_022440413.1,uncharacterized LOC111105921,27363
NC_035787.1,66362062,66449448,66362062,66397139,111105921,XM_022440414.1,uncharacterized LOC111105921,35077
NC_035787.1,66362062,66449448,66362062,66397141,111105921,XM_022440412.1,uncharacterized LOC111105921,35079
NC_035787.1,66362062,66449448,66369484,66449448,111105921,XM_022440410.1,uncharacterized LOC111105921,79964
NC_035787.1,66362062,66449448,66369475,66449448,111105921,XM_022440408.1,uncharacterized LOC111105921,79973
NC_035787.1,66324210,66342149,66324210,66342149,111105927,XM_022440426.1,uncharacterized LOC111105927,17939
NC_035787.1,65946610,65955003,65946610,65955003,111105929,XM_022440428.1,uncharacterized LOC111105929,8393
NC_035787.1,66344782,66361202,66344782,66361202,111105938,XM_022440442.1,uncharacterized LOC111105938,16420
NC_035787.1,67065122,67070392,67065122,67070378,111105940,XM_022440445.1,uncharacterized LOC111105940,5256
NC_035787.1,67065122,67070392,67065122,67070392,111105940,XM_022440444.1,uncharacterized LOC111105940,5270
NC_035787.1,65955202,65960112,65955202,65960112,111105941,XM_022440446.1,uncharacterized LOC111105941,4910
NC_035787.1,66131169,66137438,66131169,66137438,111105942,XM_022440447.1,uncharacterized LOC111105942,6269
NC_035787.1,67268426,67284599,67268426,67284599,111105945,XM_022440449.1,uncharacterized LOC111105945,16173
NC_035787.1,66923715,66929321,66923715,66929321,111105946,XM_022440450.1,uncharacterized LOC111105946,5606
NC_035787.1,67117092,67118829,67117414,67118829,111105949,XM_022440458.1,uncharacterized LOC111105949,1415
NC_035787.1,67117092,67118829,67117092,67118829,111105949,XM_022440459.1,uncharacterized LOC111105949,1737
NC_035787.1,66950035,66957042,66950035,66957042,111105950,XM_022440461.1,uncharacterized LOC111105950,7007
NC_035787.1,67046573,67054038,67046573,67054038,111105952,XM_022440462.1,uncharacterized LOC111105952,7465
NC_035787.1,67019268,67026330,67019268,67026330,111105953,XM_022440463.1,uncharacterized LOC111105953,7062
NC_035787.1,66304869,66316418,66304869,66316418,111105955,XM_022440465.1,uncharacterized LOC111105955,11549
NC_035787.1,66261206,66263625,66261206,66263625,111105956,XM_022440466.1,uncharacterized LOC111105956,2419
NC_035787.1,66986225,66989600,66986225,66989600,111105964,XM_022440473.1,uncharacterized LOC111105964,3375
NC_035787.1,66349701,66350744,66349701,66350744,111105965,XM_022440475.1,uncharacterized LOC111105965,1043
NC_035787.1,66939667,66942043,66939667,66942043,111105968,XM_022440478.1,uncharacterized LOC111105968,2376
NC_035787.1,66100048,66105495,66100048,66105495,111105974,XM_022440487.1,uncharacterized LOC111105974,5447
NC_035787.1,66915393,66916865,66915393,66916865,111105976,XM_022440490.1,uncharacterized LOC111105976,1472
NC_035787.1,66908474,66910379,66908474,66910328,111105979,XM_022440495.1,uncharacterized LOC111105979,1854
NC_035780.1,16339589,16360801,16339589,16360801,111105980,XM_022440499.1,uncharacterized LOC111105980,21212
NC_035787.1,66862854,66868202,66862860,66865563,111105983,XM_022440501.1,uncharacterized LOC111105983,2703
NC_035787.1,65964027,65965538,65964203,65965538,111105984,XM_022440503.1,uncharacterized LOC111105984,1335
NC_035787.1,65964027,65965538,65964027,65965538,111105984,XM_022440502.1,uncharacterized LOC111105984,1511
NC_035787.1,39495548,39497827,39495548,39497827,111105985,XM_022440504.1,uncharacterized LOC111105985,2279
NC_035787.1,9718576,9721717,9718576,9721717,111106000,XM_022440508.1,uncharacterized LOC111106000,3141
NC_035787.1,70835232,70839300,70835232,70839300,111106003,XM_022440511.1,uncharacterized LOC111106003,4068
NC_035787.1,65711496,65716336,65711499,65716335,111106007,XM_022440516.1,uncharacterized LOC111106007,4836
NC_035787.1,65711496,65716336,65711496,65716336,111106007,XM_022440517.1,uncharacterized LOC111106007,4840
NC_035787.1,65688993,65693167,65688993,65692689,111106008,XM_022440518.1,uncharacterized LOC111106008,3696
NC_035780.1,16714412,16725183,16714412,16725183,111106011,XM_022440522.1,uncharacterized LOC111106011,10771
NC_035787.1,36617362,36622049,36617362,36622049,111106013,XM_022440520.1,uncharacterized LOC111106013,4687
NC_035787.1,52887888,52890859,52887888,52890859,111106014,XM_022440521.1,uncharacterized LOC111106014,2971
NC_035787.1,53058485,53060357,53058485,53060357,111106017,XM_022440526.1,uncharacterized LOC111106017,1872
NC_035787.1,73655651,73671078,73655651,73671078,111106019,XM_022440527.1,uncharacterized LOC111106019,15427
NC_035787.1,14197501,14199905,14197501,14199905,111106028,XM_022440541.1,uncharacterized LOC111106028,2404
NC_035787.1,13927663,13930734,13927663,13930734,111106029,XM_022440542.1,uncharacterized LOC111106029,3071
NC_035787.1,14077321,14091020,14077322,14090957,111106030,XM_022440543.1,uncharacterized LOC111106030,13635
NC_035787.1,14077321,14091020,14077321,14091020,111106030,XM_022440545.1,uncharacterized LOC111106030,13699
NC_035787.1,13848289,13850812,13848289,13850812,111106032,XM_022440547.1,uncharacterized LOC111106032,2523
NC_035787.1,13966453,13974792,13968822,13974792,111106033,XM_022440549.1,uncharacterized LOC111106033,5970
NC_035787.1,13966453,13974792,13966453,13974792,111106033,XM_022440548.1,uncharacterized LOC111106033,8339
NC_035787.1,13810479,13815295,13810479,13815295,111106034,XM_022440550.1,uncharacterized LOC111106034,4816
NC_035787.1,13977354,13982082,13977354,13982082,111106035,XM_022440551.1,uncharacterized LOC111106035,4728
NC_035787.1,13862978,13869633,13862978,13869633,111106036,XM_022440552.1,uncharacterized LOC111106036,6655
NC_035780.1,17086679,17088070,17086679,17088070,111106037,XM_022440557.1,uncharacterized LOC111106037,1391
NC_035787.1,13959202,13961640,13959314,13961640,111106038,XM_022440554.1,uncharacterized LOC111106038,2326
NC_035787.1,13959202,13961640,13959202,13961640,111106038,XM_022440553.1,uncharacterized LOC111106038,2438
NC_035787.1,13877074,13883556,13877074,13883556,111106039,XM_022440555.1,uncharacterized LOC111106039,6482
NC_035780.1,26808762,26811018,26808762,26811018,111106040,XM_022440947.1,uncharacterized LOC111106040,2256
NC_035787.1,24497247,24532634,24497247,24532634,111106041,XM_022440558.1,uncharacterized LOC111106041,35387
NC_035787.1,9320898,9325155,9320898,9322380,111106047,XM_022440568.1,uncharacterized LOC111106047,1482
NC_035787.1,9320898,9325155,9320898,9322407,111106047,XM_022440567.1,uncharacterized LOC111106047,1509
NC_035787.1,9320898,9325155,9320898,9325155,111106047,XM_022440569.1,uncharacterized LOC111106047,4257
NC_035787.1,53125276,53126124,53125276,53126124,111106052,XM_022440575.1,uncharacterized LOC111106052,848
NC_035780.1,17440988,17441446,17440988,17441446,111106054,XM_022440580.1,uncharacterized LOC111106054,458
NC_035787.1,5715169,5718693,5715169,5718693,111106055,XM_022440577.1,uncharacterized LOC111106055,3524
NC_035787.1,65601037,65603079,65601037,65603079,111106056,XM_022440578.1,uncharacterized LOC111106056,2042
NC_035787.1,74334257,74352422,74334257,74352422,111106062,XM_022440585.1,uncharacterized LOC111106062,18165
NC_035787.1,53867595,53871721,53867595,53871721,111106063,XM_022440586.1,uncharacterized LOC111106063,4126
NC_035780.1,17640265,17648803,17640265,17648803,111106064,XM_022440590.1,uncharacterized LOC111106064,8538
NC_035787.1,48436630,48438694,48436630,48438694,111106065,XM_022440587.1,uncharacterized LOC111106065,2064
NC_035787.1,64171373,64177338,64171373,64177338,111106067,XM_022440589.1,uncharacterized LOC111106067,5965
NC_035787.1,71437119,71439121,71437119,71439121,111106069,XM_022440592.1,uncharacterized LOC111106069,2002
NC_035787.1,72510773,72514887,72510773,72514887,111106072,XM_022440594.1,uncharacterized LOC111106072,4114
NC_035787.1,69497992,69501118,69497992,69501118,111106080,XM_022440608.1,uncharacterized LOC111106080,3126
NC_035787.1,69484337,69486429,69484337,69486429,111106084,XM_022440611.1,uncharacterized LOC111106084,2092
NC_035787.1,55057394,55061059,55057394,55061059,111106090,XM_022440616.1,uncharacterized LOC111106090,3665
NC_035787.1,55048747,55052670,55048747,55052670,111106091,XM_022440617.1,uncharacterized LOC111106091,3923
NC_035780.1,17776205,17777908,17776205,17777908,111106094,XM_022440622.1,uncharacterized LOC111106094,1703
NC_035787.1,28069228,28079948,28069235,28079948,111106095,XM_022440620.1,uncharacterized LOC111106095,10713
NC_035787.1,28069228,28079948,28069228,28079948,111106095,XM_022440619.1,uncharacterized LOC111106095,10720
NC_035787.1,45124864,45126382,45124864,45126382,111106098,XM_022440627.1,uncharacterized LOC111106098,1518
NC_035780.1,17936488,17943045,17936488,17943045,111106102,XM_022440634.1,uncharacterized LOC111106102,6557
NC_035787.1,25015123,25020413,25015123,25020413,111106103,XM_022440632.1,uncharacterized LOC111106103,5290
NC_035787.1,9337030,9340224,9337030,9339725,111106104,XM_022440635.1,uncharacterized LOC111106104,2695
NC_035787.1,9337030,9340224,9337032,9340224,111106104,XM_022440633.1,uncharacterized LOC111106104,3192
NC_035787.1,9326332,9328941,9326332,9328941,111106105,XM_022440636.1,uncharacterized LOC111106105,2609
NC_035787.1,56068314,56069271,56068314,56069271,111106106,XM_022440637.1,uncharacterized LOC111106106,957
NC_035787.1,12762536,12767131,12762536,12767131,111106108,XM_022440640.1,uncharacterized LOC111106108,4595
NC_035787.1,28904607,28908372,28904607,28908372,111106110,XM_022440642.1,uncharacterized LOC111106110,3765
NC_035780.1,17942759,17944196,17942759,17944196,111106111,XM_022440645.1,uncharacterized LOC111106111,1437
NC_035787.1,6540446,6549877,6540446,6549846,111106112,XM_022440643.1,uncharacterized LOC111106112,9400
NC_035787.1,7298936,7299767,7298936,7299767,111106113,XM_022440644.1,uncharacterized LOC111106113,831
NC_035787.1,60119917,60123432,60119917,60123432,111106114,XM_022440646.1,uncharacterized LOC111106114,3515
NC_035787.1,60134672,60137405,60134672,60137405,111106115,XM_022440647.1,uncharacterized LOC111106115,2733
NC_035787.1,45118049,45119567,45118049,45119567,111106116,XM_022440648.1,uncharacterized LOC111106116,1518
NC_035780.1,18086110,18093452,18086110,18093452,111106120,XM_022440659.1,uncharacterized LOC111106120,7342
NC_035787.1,39013561,39018885,39013561,39018885,111106121,XM_022440666.1,uncharacterized LOC111106121,5324
NC_035787.1,64680293,64682500,64680293,64682500,111106122,XM_022440667.1,uncharacterized LOC111106122,2207
NC_035787.1,73520615,73525056,73520615,73525056,111106123,XM_022440668.1,uncharacterized LOC111106123,4441
NC_035780.1,18112315,18114358,18112315,18114358,111106124,XM_022440670.1,uncharacterized LOC111106124,2043
NC_035787.1,56759047,56761113,56759047,56761113,111106129,XM_022440674.1,uncharacterized LOC111106129,2066
NC_035787.1,65664557,65666900,65664557,65666900,111106131,XM_022440676.1,uncharacterized LOC111106131,2343
NC_035787.1,74803010,74809103,74803010,74805168,111106139,XM_022440687.1,uncharacterized LOC111106139,2158
NC_035787.1,74803010,74809103,74803010,74805798,111106139,XM_022440685.1,uncharacterized LOC111106139,2788
NC_035787.1,74803010,74809103,74803010,74806332,111106139,XM_022440686.1,uncharacterized LOC111106139,3322
NC_035787.1,74803010,74809103,74803010,74809073,111106139,XM_022440684.1,uncharacterized LOC111106139,6063
NC_035787.1,74803010,74809103,74803010,74809103,111106139,XM_022440688.1,uncharacterized LOC111106139,6093
NC_035787.1,58922701,58926715,58922701,58926715,111106140,XM_022440689.1,uncharacterized LOC111106140,4014
NC_035780.1,18398667,18400850,18398667,18400850,111106141,XM_022440693.1,uncharacterized LOC111106141,2183
NC_035787.1,39478634,39480922,39478634,39480922,111106143,XM_022440692.1,uncharacterized LOC111106143,2288
NC_035787.1,64152917,64164999,64152937,64164999,111106144,XM_022440695.1,uncharacterized LOC111106144,12062
NC_035787.1,64152917,64164999,64152917,64164999,111106144,XM_022440694.1,uncharacterized LOC111106144,12082
NC_035787.1,67595020,67597375,67595020,67597375,111106149,XM_022440697.1,uncharacterized LOC111106149,2355
NC_035787.1,67595954,67604342,67597566,67604342,111106150,XM_022440698.1,uncharacterized LOC111106150,6776
NC_035787.1,67595954,67604342,67595954,67604342,111106150,XM_022440699.1,uncharacterized LOC111106150,8388
NC_035787.1,22147261,22149598,22147261,22149598,111106155,XM_022440707.1,uncharacterized LOC111106155,2337
NC_035787.1,50284357,50288068,50284357,50288068,111106160,XM_022440713.1,uncharacterized LOC111106160,3711
NC_035787.1,17241617,17243729,17241617,17243729,111106167,XM_022440721.1,uncharacterized LOC111106167,2112
NC_035787.1,1232774,1240877,1232774,1240877,111106168,XM_022440722.1,uncharacterized LOC111106168,8103
NC_035780.1,18740437,18745477,18740437,18745477,111106169,XM_022440726.1,uncharacterized LOC111106169,5040
NC_035787.1,1220210,1232688,1220210,1232679,111106170,XM_022440723.1,uncharacterized LOC111106170,12469
NC_035787.1,1220210,1232688,1220210,1232688,111106170,XM_022440724.1,uncharacterized LOC111106170,12478
NC_035787.1,1203666,1213659,1203666,1213659,111106171,XM_022440725.1,uncharacterized LOC111106171,9993
NC_035787.1,1213714,1215680,1213714,1215680,111106172,XM_022440727.1,uncharacterized LOC111106172,1966
NC_035780.1,19212965,19230482,19212965,19230482,111106177,XM_022440736.1,uncharacterized LOC111106177,17517
NC_035787.1,38373315,38376848,38373315,38376848,111106178,XM_022440735.1,uncharacterized LOC111106178,3533
NC_035787.1,56066487,56067260,56066487,56067260,111106180,XM_022440737.1,uncharacterized LOC111106180,773
NC_035787.1,18742999,18745084,18742999,18745084,111106183,XM_022440740.1,uncharacterized LOC111106183,2085
NC_035787.1,30428822,30438088,30428834,30438088,111106185,XM_022440742.1,uncharacterized LOC111106185,9254
NC_035787.1,30428822,30438088,30428822,30438088,111106185,XM_022440744.1,uncharacterized LOC111106185,9266
NC_035780.1,19231921,19234047,19231921,19234047,111106186,XM_022440747.1,uncharacterized LOC111106186,2126
NC_035787.1,59068722,59070799,59068722,59070799,111106187,XM_022440745.1,uncharacterized LOC111106187,2077
NC_035787.1,42528683,42557744,42528683,42557744,111106191,XM_022440754.1,uncharacterized LOC111106191,29061
NC_035787.1,42547750,42551493,42547750,42551493,111106192,XM_022440755.1,uncharacterized LOC111106192,3743
NC_035787.1,27467532,27468585,27467532,27468585,111106195,XM_022440757.1,uncharacterized LOC111106195,1053
NC_035787.1,892590,893465,892590,893465,111106196,XM_022440758.1,uncharacterized LOC111106196,875
NC_035787.1,13400294,13403228,13400294,13403228,111106197,XM_022440759.1,uncharacterized LOC111106197,2934
NC_035787.1,4252558,4253607,4252558,4253607,111106198,XM_022440761.1,uncharacterized LOC111106198,1049
NC_035787.1,26089862,26102790,26089876,26102777,111106199,XM_022440766.1,uncharacterized LOC111106199,12901
NC_035787.1,26089862,26102790,26089875,26102778,111106199,XM_022440768.1,uncharacterized LOC111106199,12903
NC_035787.1,26089862,26102790,26089869,26102781,111106199,XM_022440762.1,uncharacterized LOC111106199,12912
NC_035787.1,26089862,26102790,26089867,26102782,111106199,XM_022440765.1,uncharacterized LOC111106199,12915
NC_035787.1,26089862,26102790,26089862,26102790,111106199,XM_022440763.1,uncharacterized LOC111106199,12928
NC_035787.1,26089862,26102790,26095326,26102779,111106199,XM_022440767.1,uncharacterized LOC111106199,7453
NC_035787.1,26089862,26102790,26095252,26102784,111106199,XM_022440764.1,uncharacterized LOC111106199,7532
NC_035787.1,27277853,27282985,27277853,27282985,111106202,XM_022440770.1,uncharacterized LOC111106202,5132
NC_035787.1,27283719,27287387,27284437,27287387,111106203,XM_022440772.1,uncharacterized LOC111106203,2950
NC_035787.1,27283719,27287387,27283719,27287387,111106203,XM_022440771.1,uncharacterized LOC111106203,3668
NC_035787.1,39362834,39366327,39362834,39366327,111106204,XM_022440773.1,uncharacterized LOC111106204,3493
NC_035787.1,4909913,4941992,4909915,4941992,111106205,XM_022440774.1,uncharacterized LOC111106205,32077
NC_035787.1,47215999,47219263,47215999,47219263,111106207,XM_022440776.1,uncharacterized LOC111106207,3264
NC_035780.1,19510715,19516444,19510715,19516444,111106210,XM_022440784.1,uncharacterized LOC111106210,5729
NC_035787.1,27679653,27699016,27683310,27699007,111106212,XM_022440781.1,uncharacterized LOC111106212,15697
NC_035787.1,27679653,27699016,27683306,27699016,111106212,XM_022440788.1,uncharacterized LOC111106212,15710
NC_035787.1,27679653,27699016,27682296,27699007,111106212,XM_022440787.1,uncharacterized LOC111106212,16711
NC_035787.1,27679653,27699016,27681279,27699007,111106212,XM_022440785.1,uncharacterized LOC111106212,17728
NC_035787.1,27679653,27699016,27679653,27699007,111106212,XM_022440783.1,uncharacterized LOC111106212,19354
NC_035787.1,27679653,27699016,27694341,27699007,111106212,XM_022440782.1,uncharacterized LOC111106212,4666
NC_035787.1,27679653,27699016,27690539,27699007,111106212,XM_022440786.1,uncharacterized LOC111106212,8468
NC_035787.1,21161110,21187894,21176183,21187894,111106214,XM_022440793.1,uncharacterized LOC111106214,11711
NC_035787.1,21161110,21187894,21176179,21187894,111106214,XM_022440789.1,uncharacterized LOC111106214,11715
NC_035787.1,21161110,21187894,21176177,21187894,111106214,XM_022440794.1,uncharacterized LOC111106214,11717
NC_035787.1,21161110,21187894,21176176,21187894,111106214,XM_022440795.1,uncharacterized LOC111106214,11718
NC_035787.1,21161110,21187894,21176174,21187894,111106214,XM_022440792.1,uncharacterized LOC111106214,11720
NC_035787.1,21161110,21187894,21161116,21187894,111106214,XM_022440791.1,uncharacterized LOC111106214,26778
NC_035787.1,21161110,21187894,21161110,21187894,111106214,XM_022440790.1,uncharacterized LOC111106214,26784
NC_035787.1,25033365,25045900,25033365,25045900,111106216,XM_022440796.1,uncharacterized LOC111106216,12535
NC_035787.1,25033365,25045900,25043310,25045900,111106216,XM_022440797.1,uncharacterized LOC111106216,2590
NC_035787.1,22434043,22435505,22434043,22435505,111106220,XM_022440804.1,uncharacterized LOC111106220,1462
NC_035787.1,55031148,55036729,55031148,55036729,111106224,XM_022440808.1,uncharacterized LOC111106224,5581
NC_035787.1,64973361,64980696,64973361,64980249,111106225,XM_022440811.1,uncharacterized LOC111106225,6888
NC_035787.1,64973361,64980696,64973361,64980696,111106225,XM_022440809.1,uncharacterized LOC111106225,7335
NC_035787.1,34328943,34334213,34328943,34334213,111106227,XM_022440813.1,uncharacterized LOC111106227,5270
NC_035787.1,2620258,2627277,2620258,2627277,111106229,XM_022440817.1,uncharacterized LOC111106229,7019
NC_035787.1,36029600,36040302,36029600,36040302,111106230,XM_022440818.1,uncharacterized LOC111106230,10702
NC_035780.1,19681703,19685413,19681703,19685413,111106231,XM_022440822.1,uncharacterized LOC111106231,3710
NC_035787.1,9219810,9222112,9219810,9222112,111106232,XM_022440819.1,uncharacterized LOC111106232,2302
NC_035787.1,60087991,60090454,60087991,60090454,111106234,XM_022440821.1,uncharacterized LOC111106234,2463
NC_035787.1,11146562,11152725,11146562,11152725,111106237,XM_022440825.1,uncharacterized LOC111106237,6163
NC_035787.1,10789897,10802641,10789897,10802641,111106238,XM_022440828.1,uncharacterized LOC111106238,12744
NC_035787.1,10789897,10802641,10789897,10796009,111106238,XM_022440827.1,uncharacterized LOC111106238,6112
NC_035787.1,32212631,32267883,32218322,32267883,111106240,XM_022440837.1,uncharacterized LOC111106240,49561
NC_035787.1,32212631,32267883,32218321,32267883,111106240,XM_022440830.1,uncharacterized LOC111106240,49562
NC_035787.1,32212631,32267883,32215331,32267883,111106240,XM_022440843.1,uncharacterized LOC111106240,52552
NC_035787.1,32212631,32267883,32212634,32267883,111106240,XM_022440832.1,uncharacterized LOC111106240,55249
NC_035787.1,32212631,32267883,32212631,32267883,111106240,XM_022440842.1,uncharacterized LOC111106240,55252
NC_035787.1,35701041,35720118,35701041,35720091,111106244,XM_022440848.1,uncharacterized LOC111106244,19050
NC_035787.1,35701041,35720118,35701041,35720118,111106244,XM_022440847.1,uncharacterized LOC111106244,19077
NC_035787.1,24539432,24576976,24539432,24576976,111106245,XM_022440851.1,uncharacterized LOC111106245,37544
NC_035787.1,27880834,27884682,27880834,27884682,111106248,XM_022440852.1,uncharacterized LOC111106248,3848
NC_035787.1,27886578,27890206,27886578,27890206,111106249,XM_022440853.1,uncharacterized LOC111106249,3628
NC_035787.1,27846842,27850604,27846842,27850604,111106250,XM_022440854.1,uncharacterized LOC111106250,3762
NC_035787.1,27865439,27869029,27865439,27869029,111106251,XM_022440855.1,uncharacterized LOC111106251,3590
NC_035787.1,27918132,27922958,27918132,27922958,111106252,XM_022440856.1,uncharacterized LOC111106252,4826
NC_035787.1,27905776,27913494,27905776,27913494,111106254,XM_022440857.1,uncharacterized LOC111106254,7718
NC_035787.1,9509729,9516070,9509729,9516070,111106259,XM_022440863.1,uncharacterized LOC111106259,6341
NC_035780.1,20401221,20409055,20401221,20409055,111106261,XM_022440870.1,uncharacterized LOC111106261,7834
NC_035787.1,11253159,11254475,11253159,11254475,111106262,XM_022440869.1,uncharacterized LOC111106262,1316
NC_035787.1,54968973,54972961,54968973,54972961,111106263,XM_022440871.1,uncharacterized LOC111106263,3988
NC_035787.1,68935611,68937105,68935611,68937105,111106266,XM_022440874.1,uncharacterized LOC111106266,1494
NC_035780.1,20751025,20772652,20751025,20772652,111106268,XM_022440882.1,uncharacterized LOC111106268,21627
NC_035787.1,71447202,71450364,71447202,71450364,111106270,XM_022440880.1,uncharacterized LOC111106270,3162
NC_035787.1,61940082,61948665,61940082,61948665,111106271,XM_022440881.1,uncharacterized LOC111106271,8583
NC_035787.1,19929492,19934327,19929494,19934327,111106273,XM_022440885.1,uncharacterized LOC111106273,4833
NC_035787.1,19929492,19934327,19929492,19934327,111106273,XM_022440884.1,uncharacterized LOC111106273,4835
NC_035787.1,47156746,47161042,47156746,47161042,111106274,XM_022440886.1,uncharacterized LOC111106274,4296
NC_035787.1,15649337,15664664,15649337,15664664,111106276,XM_022440888.1,uncharacterized LOC111106276,15327
NC_035787.1,68063551,68108269,68063551,68108269,111106277,XM_022440889.1,uncharacterized LOC111106277,44718
NC_035780.1,20790342,20797163,20790342,20797163,111106278,XM_022440893.1,uncharacterized LOC111106278,6821
NC_035787.1,54334680,54355070,54338730,54355070,111106281,XM_022440896.1,uncharacterized LOC111106281,16340
NC_035787.1,54334680,54355070,54336958,54355070,111106281,XM_022440895.1,uncharacterized LOC111106281,18112
NC_035787.1,54334680,54355070,54334680,54355070,111106281,XM_022440894.1,uncharacterized LOC111106281,20390
NC_035787.1,14302603,14304648,14302603,14304648,111106282,XM_022440897.1,uncharacterized LOC111106282,2045
NC_035787.1,71439526,71441363,71439526,71441363,111106285,XM_022440899.1,uncharacterized LOC111106285,1837
NC_035780.1,20947278,20955359,20947278,20955359,111106287,XM_022440905.1,uncharacterized LOC111106287,8081
NC_035787.1,16100456,16102096,16100456,16102096,111106288,XM_022440901.1,uncharacterized LOC111106288,1640
NC_035787.1,16104696,16107587,16104696,16107587,111106289,XM_022440902.1,uncharacterized LOC111106289,2891
NC_035787.1,55449666,55452562,55449666,55452562,111106291,XM_022440903.1,uncharacterized LOC111106291,2896
NC_035787.1,11691229,11694511,11691233,11693976,111106294,XM_022440909.1,uncharacterized LOC111106294,2743
NC_035787.1,11691229,11694511,11691229,11693976,111106294,XM_022440911.1,uncharacterized LOC111106294,2747
NC_035787.1,11691229,11694511,11691233,11694511,111106294,XM_022440910.1,uncharacterized LOC111106294,3278
NC_035787.1,49498207,49503439,49498207,49503439,111106302,XM_022440925.1,uncharacterized LOC111106302,5232
NC_035787.1,65578592,65583284,65578592,65583284,111106305,XM_022440929.1,uncharacterized LOC111106305,4692
NC_035787.1,45881427,45892135,45881427,45892135,111106315,XM_022440943.1,uncharacterized LOC111106315,10708
NC_035787.1,45881427,45892135,45881427,45891309,111106315,XM_022440944.1,uncharacterized LOC111106315,9882
NC_035787.1,45881427,45892135,45881427,45891332,111106315,XM_022440945.1,uncharacterized LOC111106315,9905
NC_035787.1,45934497,45938193,45934497,45938193,111106319,XM_022440950.1,uncharacterized LOC111106319,3696
NC_035787.1,4584887,4585688,4584887,4585688,111106323,XM_022440952.1,uncharacterized LOC111106323,801
NC_035787.1,11492509,11499065,11492509,11499065,111106324,XM_022440953.1,uncharacterized LOC111106324,6556
NC_035787.1,11290163,11296409,11290163,11296409,111106325,XM_022440955.1,uncharacterized LOC111106325,6246
NC_035787.1,39383801,39387972,39383801,39387972,111106327,XM_022440956.1,uncharacterized LOC111106327,4171
NC_035780.1,21544339,21548539,21544339,21548539,111106332,XM_022440965.1,uncharacterized LOC111106332,4200
NC_035787.1,50462487,50474884,50462487,50474884,111106336,XM_022440976.1,uncharacterized LOC111106336,12397
NC_035787.1,50462487,50474884,50468246,50474884,111106336,XM_022440977.1,uncharacterized LOC111106336,6638
NC_035780.1,21708117,21739152,21708117,21739152,111106337,XM_022440978.1,uncharacterized LOC111106337,31035
NC_035787.1,25764987,25765863,25764987,25765863,111106338,XM_022440979.1,uncharacterized LOC111106338,876
NC_035787.1,23686702,23699418,23687024,23699401,111106339,XM_022440987.1,uncharacterized LOC111106339,12377
NC_035787.1,23686702,23699418,23687024,23699402,111106339,XM_022440984.1,uncharacterized LOC111106339,12378
NC_035787.1,23686702,23699418,23687024,23699411,111106339,XM_022440983.1,uncharacterized LOC111106339,12387
NC_035787.1,23686702,23699418,23686705,23699410,111106339,XM_022440985.1,uncharacterized LOC111106339,12705
NC_035787.1,23686702,23699418,23686702,23699418,111106339,XM_022440981.1,uncharacterized LOC111106339,12716
NC_035787.1,23686702,23699418,23687024,23693828,111106339,XM_022440986.1,uncharacterized LOC111106339,6804
NC_035787.1,23686702,23699418,23687024,23693842,111106339,XM_022440982.1,uncharacterized LOC111106339,6818
NC_035780.1,21858419,21859690,21858419,21859690,111106340,XM_022440991.1,uncharacterized LOC111106340,1271
NC_035787.1,38597851,38628329,38597851,38628329,111106341,XM_022440989.1,uncharacterized LOC111106341,30478
NC_035787.1,73032515,73034393,73032515,73034393,111106345,XM_022440996.1,uncharacterized LOC111106345,1878
NC_035780.1,22029412,22032187,22029412,22032187,111106348,XM_022441003.1,uncharacterized LOC111106348,2775
NC_035787.1,37514770,37519231,37514770,37519231,111106351,XM_022441004.1,uncharacterized LOC111106351,4461
NC_035787.1,37744405,37750528,37744405,37750528,111106352,XM_022441006.1,uncharacterized LOC111106352,6123
NC_035787.1,37790556,37797055,37790556,37797055,111106353,XM_022441007.1,uncharacterized LOC111106353,6499
NC_035787.1,37809595,37822101,37809595,37822101,111106357,XM_022441012.1,uncharacterized LOC111106357,12506
NC_035787.1,37660060,37662648,37660060,37662648,111106366,XM_022441021.1,uncharacterized LOC111106366,2588
NC_035787.1,37694891,37698913,37694891,37698913,111106368,XM_022441022.1,uncharacterized LOC111106368,4022
NC_035787.1,34124052,34126257,34124052,34126257,111106374,XM_022441027.1,uncharacterized LOC111106374,2205
NC_035787.1,28908806,28920891,28908806,28920891,111106378,XM_022441030.1,uncharacterized LOC111106378,12085
NC_035780.1,22462295,22464338,22462295,22464338,111106379,XM_022441034.1,uncharacterized LOC111106379,2043
NC_035787.1,28208111,28210344,28208111,28210344,111106381,XM_022441032.1,uncharacterized LOC111106381,2233
NC_035787.1,72994215,73006400,72994215,73006400,111106384,XM_022441037.1,uncharacterized LOC111106384,12185
NC_035787.1,72994215,73006400,72994215,73003541,111106384,XM_022441038.1,uncharacterized LOC111106384,9326
NC_035787.1,72994215,73006400,72994215,73003972,111106384,XM_022441039.1,uncharacterized LOC111106384,9757
NC_035787.1,48538599,48545369,48538599,48543818,111106385,XM_022441041.1,uncharacterized LOC111106385,5219
NC_035787.1,48538599,48545369,48538599,48545369,111106385,XM_022441040.1,uncharacterized LOC111106385,6770
NC_035787.1,13333325,13346081,13333325,13346080,111106393,XM_022441054.1,uncharacterized LOC111106393,12755
NC_035787.1,13333325,13346081,13333325,13346081,111106393,XM_022441053.1,uncharacterized LOC111106393,12756
NC_035780.1,22780238,22792948,22780238,22792948,111106394,XM_022441057.1,uncharacterized LOC111106394,12710
NC_035787.1,11802836,11805143,11802836,11805143,111106396,XM_022441055.1,uncharacterized LOC111106396,2307
NC_035787.1,23918242,23921284,23918242,23921284,111106397,XM_022441056.1,uncharacterized LOC111106397,3042
NC_035787.1,48506663,48513105,48506663,48513105,111106398,XM_022441058.1,uncharacterized LOC111106398,6442
NC_035787.1,3730473,3755271,3730473,3755271,111106400,XM_022441060.1,uncharacterized LOC111106400,24798
NC_035787.1,3598906,3628051,3598906,3628049,111106401,XM_022441063.1,uncharacterized LOC111106401,29143
NC_035787.1,3598906,3628051,3598906,3628051,111106401,XM_022441062.1,uncharacterized LOC111106401,29145
NC_035787.1,3653121,3676900,3653121,3676899,111106402,XM_022441065.1,uncharacterized LOC111106402,23778
NC_035787.1,3653121,3676900,3653121,3676900,111106402,XM_022441064.1,uncharacterized LOC111106402,23779
NC_035787.1,3685023,3711212,3685023,3711212,111106404,XM_022441066.1,uncharacterized LOC111106404,26189
NC_035780.1,22960958,22961770,22960958,22961770,111106411,XM_022441079.1,uncharacterized LOC111106411,812
NC_035787.1,20845031,20853012,20845031,20853012,111106415,XM_022441082.1,uncharacterized LOC111106415,7981
NC_035787.1,69189398,69197723,69189408,69197723,111106421,XM_022441092.1,uncharacterized LOC111106421,8315
NC_035787.1,69189398,69197723,69189398,69197723,111106421,XM_022441093.1,uncharacterized LOC111106421,8325
NC_035780.1,23371712,23375516,23371712,23375516,111106426,XM_022441103.1,uncharacterized LOC111106426,3804
NC_035787.1,7796967,7799882,7796967,7799882,111106429,XM_022441104.1,uncharacterized LOC111106429,2915
NC_035780.1,23389722,23416249,23389722,23416249,111106437,XM_022441113.1,uncharacterized LOC111106437,26527
NC_035787.1,18689502,18691708,18689502,18691708,111106439,XM_022441114.1,uncharacterized LOC111106439,2206
NC_035787.1,18669562,18671981,18669562,18671981,111106441,XM_022441116.1,uncharacterized LOC111106441,2419
NC_035787.1,18633105,18647653,18633105,18647653,111106442,XM_022441117.1,uncharacterized LOC111106442,14548
NC_035787.1,52868093,52871301,52868093,52871301,111106445,XM_022441120.1,uncharacterized LOC111106445,3208
NC_035780.1,24003862,24005499,24003862,24005499,111106446,XM_022441123.1,uncharacterized LOC111106446,1637
NC_035780.1,24031086,24034004,24031086,24034004,111106456,XM_022441137.1,uncharacterized LOC111106456,2918
NC_035787.1,70981502,70986955,70981531,70986955,111106459,XM_022441140.1,uncharacterized LOC111106459,5424
NC_035787.1,70981502,70986955,70981502,70986955,111106459,XM_022441141.1,uncharacterized LOC111106459,5453
NC_035787.1,3116426,3119670,3116797,3119670,111106461,XM_022441144.1,uncharacterized LOC111106461,2873
NC_035787.1,3116426,3119670,3116712,3119670,111106461,XM_022441143.1,uncharacterized LOC111106461,2958
NC_035787.1,3116426,3119670,3116426,3119670,111106461,XM_022441145.1,uncharacterized LOC111106461,3244
NC_035787.1,26033408,26050236,26033408,26050236,111106463,XM_022441148.1,uncharacterized LOC111106463,16828
NC_035780.1,24374550,24381323,24374550,24381323,111106472,XM_022441174.1,uncharacterized LOC111106472,6773
NC_035787.1,55132497,55137369,55133425,55137369,111106473,XM_022441171.1,uncharacterized LOC111106473,3944
NC_035787.1,55132497,55137369,55132497,55137369,111106473,XM_022441170.1,uncharacterized LOC111106473,4872
NC_035787.1,9824118,9832581,9824118,9832581,111106474,XM_022441172.1,uncharacterized LOC111106474,8463
NC_035787.1,34790905,34793818,34790905,34793818,111106476,XM_022441175.1,uncharacterized LOC111106476,2913
NC_035787.1,21074302,21100540,21086999,21100540,111106480,XM_022441178.1,uncharacterized LOC111106480,13541
NC_035787.1,21074302,21100540,21074302,21100540,111106480,XM_022441179.1,uncharacterized LOC111106480,26238
NC_035780.1,24385004,24386615,24385004,24386615,111106482,XM_022441185.1,uncharacterized LOC111106482,1611
NC_035787.1,46165706,46167282,46165706,46167282,111106484,XM_022441186.1,uncharacterized LOC111106484,1576
NC_035787.1,13189151,13192908,13189151,13192908,111106485,XM_022441187.1,uncharacterized LOC111106485,3757
NC_035787.1,67724678,67736358,67724678,67736358,111106486,XM_022441188.1,uncharacterized LOC111106486,11680
NC_035787.1,53613485,53623609,53613485,53623609,111106489,XM_022441191.1,uncharacterized LOC111106489,10124
NC_035780.1,24407914,24409805,24407914,24409805,111106490,XM_022441195.1,uncharacterized LOC111106490,1891
NC_035787.1,53617250,53617900,53617250,53617900,111106491,XM_022441192.1,uncharacterized LOC111106491,650
NC_035787.1,51726455,51729598,51726455,51729598,111106492,XM_022441193.1,uncharacterized LOC111106492,3143
NC_035787.1,59982920,59985106,59982920,59985106,111106493,XM_022441194.1,uncharacterized LOC111106493,2186
NC_035780.1,24415377,24417398,24415377,24417398,111106499,XM_022441208.1,uncharacterized LOC111106499,2021
NC_035787.1,52932721,52933839,52932721,52933839,111106500,XM_022441204.1,uncharacterized LOC111106500,1118
NC_035787.1,58376179,58383200,58376179,58383199,111106507,XM_022441213.1,uncharacterized LOC111106507,7020
NC_035787.1,58376179,58383200,58376179,58383200,111106507,XM_022441214.1,uncharacterized LOC111106507,7021
NC_035787.1,31385272,31390267,31385272,31390267,111106510,XM_022441222.1,uncharacterized LOC111106510,4995
NC_035787.1,4809372,4816201,4809372,4816201,111106511,XM_022441223.1,uncharacterized LOC111106511,6829
NC_035787.1,68937745,68980945,68945150,68980945,111106512,XM_022441225.1,uncharacterized LOC111106512,35795
NC_035787.1,68937745,68980945,68937745,68980935,111106512,XM_022441224.1,uncharacterized LOC111106512,43190
NC_035787.1,68942723,68944490,68942723,68944490,111106513,XM_022441226.1,uncharacterized LOC111106513,1767
NC_035787.1,27046962,27058107,27046962,27058107,111106514,XM_022441228.1,uncharacterized LOC111106514,11145
NC_035780.1,24432868,24439009,24432868,24439009,111106515,XM_022441234.1,uncharacterized LOC111106515,6141
NC_035787.1,57191520,57196031,57191520,57196031,111106517,XM_022441235.1,uncharacterized LOC111106517,4511
NC_035787.1,58982816,58987645,58983640,58987645,111106518,XM_022441237.1,uncharacterized LOC111106518,4005
NC_035787.1,58982816,58987645,58982816,58987645,111106518,XM_022441236.1,uncharacterized LOC111106518,4829
NC_035787.1,47418751,47421816,47418751,47421816,111106519,XM_022441238.1,uncharacterized LOC111106519,3065
NC_035787.1,641001,650014,641001,648809,111106520,XM_022441240.1,uncharacterized LOC111106520,7808
NC_035787.1,641001,650014,641001,650014,111106520,XM_022441239.1,uncharacterized LOC111106520,9013
NC_035780.1,24441646,24446671,24441646,24446671,111106522,XM_022441246.1,uncharacterized LOC111106522,5025
NC_035787.1,10084777,10098293,10084777,10098291,111106525,XM_022441245.1,uncharacterized LOC111106525,13514
NC_035787.1,10084777,10098293,10091190,10098293,111106525,XM_022441244.1,uncharacterized LOC111106525,7103
NC_035787.1,17991022,17995903,17991022,17995903,111106527,XM_022441248.1,uncharacterized LOC111106527,4881
NC_035787.1,27950308,27953744,27950308,27953744,111106528,XM_022441249.1,uncharacterized LOC111106528,3436
NC_035787.1,9814246,9819689,9814246,9819689,111106530,XM_022441250.1,uncharacterized LOC111106530,5443
NC_035787.1,47425607,47433010,47425607,47433010,111106531,XM_022441251.1,uncharacterized LOC111106531,7403
NC_035780.1,24461021,24462437,24461021,24462437,111106533,XM_022441257.1,uncharacterized LOC111106533,1416
NC_035787.1,24310651,24315919,24313684,24315919,111106535,XM_022441256.1,uncharacterized LOC111106535,2235
NC_035787.1,24310651,24315919,24310651,24315919,111106535,XM_022441255.1,uncharacterized LOC111106535,5268
NC_035787.1,34070157,34073696,34070157,34073696,111106538,XM_022441260.1,uncharacterized LOC111106538,3539
NC_035787.1,60319981,60329555,60319981,60329555,111106540,XM_022441263.1,uncharacterized LOC111106540,9574
NC_035787.1,58931165,58959221,58931165,58959221,111106546,XM_022441267.1,uncharacterized LOC111106546,28056
NC_035787.1,58931165,58959221,58953091,58959204,111106546,XM_022441268.1,uncharacterized LOC111106546,6113
NC_035787.1,58931165,58959221,58949629,58959215,111106546,XM_022441269.1,uncharacterized LOC111106546,9586
NC_035787.1,58940684,58946096,58940684,58946096,111106547,XM_022441270.1,uncharacterized LOC111106547,5412
NC_035787.1,29818175,29819584,29818175,29819584,111106554,XM_022441276.1,uncharacterized LOC111106554,1409
NC_035787.1,25980461,26006398,25980461,26006398,111106562,XM_022441284.1,uncharacterized LOC111106562,25937
NC_035787.1,13056017,13062830,13056017,13062830,111106563,XM_022441285.1,uncharacterized LOC111106563,6813
NC_035787.1,22832471,22833355,22832471,22833355,111106564,XM_022441286.1,uncharacterized LOC111106564,884
NC_035787.1,22442410,22446722,22442410,22446722,111106566,XM_022441290.1,uncharacterized LOC111106566,4312
NC_035787.1,49425249,49432193,49425541,49432193,111106569,XM_022441295.1,uncharacterized LOC111106569,6652
NC_035787.1,49425249,49432193,49425249,49432193,111106569,XM_022441294.1,uncharacterized LOC111106569,6944
NC_035787.1,15086580,15096407,15086580,15096407,111106571,XM_022441297.1,uncharacterized LOC111106571,9827
NC_035787.1,28019627,28059414,28019627,28059414,111106572,XM_022441298.1,uncharacterized LOC111106572,39787
NC_035787.1,24845495,24865240,24846260,24865240,111106578,XM_022441305.1,uncharacterized LOC111106578,18980
NC_035787.1,24845495,24865240,24845495,24865240,111106578,XM_022441308.1,uncharacterized LOC111106578,19745
NC_035780.1,24848577,24853858,24848577,24853858,111106579,XM_022441310.1,uncharacterized LOC111106579,5281
NC_035787.1,21629219,21641576,21629219,21641576,111106580,XM_022441309.1,uncharacterized LOC111106580,12357
NC_035787.1,21629219,21641576,21629219,21636163,111106580,XM_022441311.1,uncharacterized LOC111106580,6944
NC_035787.1,70330370,70350458,70330370,70350458,111106585,XM_022441315.1,uncharacterized LOC111106585,20088
NC_035780.1,24884412,24891616,24884412,24891616,111106588,XM_022441320.1,uncharacterized LOC111106588,7204
NC_035787.1,27326075,27326949,27326075,27326949,111106593,XM_022441322.1,uncharacterized LOC111106593,874
NC_035787.1,58875291,58879397,58875291,58879397,111106597,XM_022441326.1,uncharacterized LOC111106597,4106
NC_035780.1,24964021,24965946,24964021,24965946,111106598,XM_022441329.1,uncharacterized LOC111106598,1925
NC_035787.1,11133987,11141638,11133987,11141638,111106600,XM_022441327.1,uncharacterized LOC111106600,7651
NC_035787.1,49322292,49331082,49322292,49331082,111106603,XM_022441330.1,uncharacterized LOC111106603,8790
NC_035787.1,7557530,7567324,7557530,7567324,111106604,XM_022441331.1,uncharacterized LOC111106604,9794
NC_035787.1,11668508,11671667,11668508,11671666,111106606,XM_022441335.1,uncharacterized LOC111106606,3158
NC_035787.1,11668508,11671667,11668508,11671667,111106606,XM_022441336.1,uncharacterized LOC111106606,3159
NC_035787.1,9470172,9474860,9470172,9474860,111106609,XM_022441339.1,uncharacterized LOC111106609,4688
NC_035787.1,7208312,7251408,7217158,7251408,111106610,XM_022441342.1,uncharacterized LOC111106610,34250
NC_035787.1,7208312,7251408,7208312,7251408,111106610,XM_022441340.1,uncharacterized LOC111106610,43096
NC_035780.1,25450870,25458794,25450870,25458794,111106624,XM_022441363.1,uncharacterized LOC111106624,7924
NC_035787.1,52371104,52373319,52371104,52373319,111106625,XM_022441359.1,uncharacterized LOC111106625,2215
NC_035787.1,52524054,52526543,52524054,52526543,111106626,XM_022441360.1,uncharacterized LOC111106626,2489
NC_035787.1,52657212,52659981,52657212,52659981,111106627,XM_022441361.1,uncharacterized LOC111106627,2769
NC_035787.1,52398778,52400984,52398778,52400984,111106631,XM_022441371.1,uncharacterized LOC111106631,2206
NC_035780.1,25531798,25540461,25531798,25540461,111106632,XM_022441375.1,uncharacterized LOC111106632,8663
NC_035787.1,52281719,52288523,52281719,52288523,111106636,XM_022441376.1,uncharacterized LOC111106636,6804
NC_035787.1,52413002,52442068,52414077,52442068,111106637,XM_022441379.1,uncharacterized LOC111106637,27991
NC_035787.1,52413002,52442068,52413043,52442068,111106637,XM_022441378.1,uncharacterized LOC111106637,29025
NC_035787.1,52413002,52442068,52413030,52442068,111106637,XM_022441377.1,uncharacterized LOC111106637,29038
NC_035787.1,52413002,52442068,52413042,52417655,111106637,XM_022441381.1,uncharacterized LOC111106637,4613
NC_035787.1,52413002,52442068,52413002,52417657,111106637,XM_022441380.1,uncharacterized LOC111106637,4655
NC_035787.1,52427365,52428699,52427365,52428699,111106638,XM_022441382.1,uncharacterized LOC111106638,1334
NC_035787.1,20410044,20428453,20410044,20428453,111106644,XM_022441395.1,uncharacterized LOC111106644,18409
NC_035780.1,25666075,25666692,25666075,25666692,111106652,XM_022441409.1,uncharacterized LOC111106652,617
NC_035787.1,23769919,23778454,23769919,23776047,111106656,XM_022441419.1,uncharacterized LOC111106656,6128
NC_035787.1,23769919,23778454,23769948,23778454,111106656,XM_022441413.1,uncharacterized LOC111106656,8506
NC_035787.1,23769919,23778454,23769944,23778454,111106656,XM_022441417.1,uncharacterized LOC111106656,8510
NC_035787.1,23769919,23778454,23769919,23778454,111106656,XM_022441410.1,uncharacterized LOC111106656,8535
NC_035787.1,9494456,9498353,9494456,9498353,111106658,XM_022441420.1,uncharacterized LOC111106658,3897
NC_035787.1,50169305,50198316,50169493,50198109,111106659,XM_022441423.1,uncharacterized LOC111106659,28616
NC_035787.1,50169305,50198316,50169305,50198316,111106659,XM_022441421.1,uncharacterized LOC111106659,29011
NC_035787.1,50175925,50181450,50175925,50181450,111106660,XM_022441424.1,uncharacterized LOC111106660,5525
NC_035787.1,50220079,50225083,50220079,50225083,111106661,XM_022441425.1,uncharacterized LOC111106661,5004
NC_035787.1,50237050,50238010,50237050,50238010,111106662,XM_022441426.1,uncharacterized LOC111106662,960
NC_035787.1,50214229,50216512,50214229,50216512,111106663,XM_022441427.1,uncharacterized LOC111106663,2283
NC_035780.1,26012256,26015181,26012256,26015181,111106665,XM_022441434.1,uncharacterized LOC111106665,2925
NC_035787.1,16450683,16454871,16450684,16454871,111106671,XM_022441448.1,uncharacterized LOC111106671,4187
NC_035787.1,16450683,16454871,16450683,16454871,111106671,XM_022441447.1,uncharacterized LOC111106671,4188
NC_035787.1,16341232,16409481,16341232,16344358,111106672,XM_022441449.1,uncharacterized LOC111106672,3126
NC_035787.1,16341232,16409481,16341232,16409481,111106672,XM_022441450.1,uncharacterized LOC111106672,68249
NC_035787.1,16371918,16379910,16371918,16379910,111106673,XM_022441451.1,uncharacterized LOC111106673,7992
NC_035787.1,16257551,16260748,16257551,16260748,111106674,XM_022441452.1,uncharacterized LOC111106674,3197
NC_035780.1,26078191,26085328,26078191,26085328,111106676,XM_022441458.1,uncharacterized LOC111106676,7137
NC_035787.1,16386333,16389495,16386333,16389495,111106679,XM_022441460.1,uncharacterized LOC111106679,3162
NC_035780.1,26085370,26087778,26085370,26087778,111106685,XM_022441469.1,uncharacterized LOC111106685,2408
NC_035787.1,16525878,16527204,16525878,16527204,111106688,XM_022441468.1,uncharacterized LOC111106688,1326
NC_035787.1,16177609,16178818,16177609,16178818,111106692,XM_022441473.1,uncharacterized LOC111106692,1209
NC_035787.1,16211483,16215027,16211483,16215027,111106693,XM_022441474.1,uncharacterized LOC111106693,3544
NC_035780.1,26251905,26285617,26251905,26285617,111106696,XM_022441478.1,uncharacterized LOC111106696,33712
NC_035787.1,64649803,64663088,64649805,64663087,111106698,XM_022441475.1,uncharacterized LOC111106698,13282
NC_035787.1,64649803,64663088,64649803,64663088,111106698,XM_022441476.1,uncharacterized LOC111106698,13285
NC_035787.1,64649803,64663088,64649805,64654853,111106698,XM_022441477.1,uncharacterized LOC111106698,5048
NC_035787.1,270130,280778,270130,280778,111106700,XM_022441480.1,uncharacterized LOC111106700,10648
NC_035787.1,3783112,3812690,3783113,3812688,111106701,XM_022441482.1,uncharacterized LOC111106701,29575
NC_035787.1,3783112,3812690,3783112,3812690,111106701,XM_022441481.1,uncharacterized LOC111106701,29578
NC_035787.1,24337429,24347737,24337429,24347737,111106703,XM_022441485.1,uncharacterized LOC111106703,10308
NC_035780.1,26455635,26457227,26455635,26457227,111106704,XM_022441490.1,uncharacterized LOC111106704,1592
NC_035787.1,72154451,72156913,72154451,72156913,111106709,XM_022441495.1,uncharacterized LOC111106709,2462
NC_035787.1,29581754,29605110,29581754,29605084,111106711,XM_022441500.1,uncharacterized LOC111106711,23330
NC_035787.1,29581754,29605110,29581754,29605098,111106711,XM_022441501.1,uncharacterized LOC111106711,23344
NC_035787.1,29581754,29605110,29581754,29605110,111106711,XM_022441499.1,uncharacterized LOC111106711,23356
NC_035787.1,1439371,1448181,1443219,1448181,111106714,XM_022441505.1,uncharacterized LOC111106714,4962
NC_035787.1,1439371,1448181,1439371,1448181,111106714,XM_022441504.1,uncharacterized LOC111106714,8810
NC_035787.1,49270462,49290164,49270462,49290164,111106715,XM_022441506.1,uncharacterized LOC111106715,19702
NC_035787.1,11510511,11514416,11510511,11514416,111106718,XM_022441510.1,uncharacterized LOC111106718,3905
NC_035780.1,26511382,26526552,26511382,26526552,111106719,XM_022441513.1,uncharacterized LOC111106719,15170
NC_035787.1,68797552,68828145,68797552,68828145,111106722,XM_022441512.1,uncharacterized LOC111106722,30593
NC_035787.1,69964035,70010185,69964035,70010185,111106724,XM_022441514.1,uncharacterized LOC111106724,46150
NC_035787.1,9406512,9412153,9406512,9412153,111106727,XM_022441518.1,uncharacterized LOC111106727,5641
NC_035787.1,2266942,2272990,2270387,2272990,111106729,XM_022441519.1,uncharacterized LOC111106729,2603
NC_035787.1,2266942,2272990,2266942,2270089,111106729,XM_022441520.1,uncharacterized LOC111106729,3147
NC_035780.1,26879414,26880409,26879414,26880409,111106730,XM_022441524.1,uncharacterized LOC111106730,995
NC_035787.1,14314241,14316371,14314350,14316371,111106732,XM_022441527.1,uncharacterized LOC111106732,2021
NC_035787.1,14314241,14316371,14314241,14316371,111106732,XM_022441528.1,uncharacterized LOC111106732,2130
NC_035787.1,18865579,18867342,18865579,18867342,111106733,XM_022441529.1,uncharacterized LOC111106733,1763
NC_035787.1,65352965,65355757,65352965,65355757,111106736,XM_022441531.1,uncharacterized LOC111106736,2792
NC_035787.1,48462583,48467047,48462583,48463868,111106741,XM_022441541.1,uncharacterized LOC111106741,1285
NC_035787.1,48462583,48467047,48462583,48467047,111106741,XM_022441540.1,uncharacterized LOC111106741,4464
NC_035787.1,47400363,47403621,47400363,47403621,111106742,XM_022441542.1,uncharacterized LOC111106742,3258
NC_035787.1,13071145,13088036,13071145,13088036,111106746,XM_022441543.1,uncharacterized LOC111106746,16891
NC_035787.1,2739942,2887523,2748838,2886112,111106749,XM_022441548.1,uncharacterized LOC111106749,137274
NC_035787.1,2739942,2887523,2748838,2887523,111106749,XM_022441547.1,uncharacterized LOC111106749,138685
NC_035787.1,2739942,2887523,2739942,2886112,111106749,XM_022441546.1,uncharacterized LOC111106749,146170
NC_035787.1,2844324,2865045,2844324,2862586,111106751,XM_022441552.1,uncharacterized LOC111106751,18262
NC_035787.1,2844324,2865045,2844324,2865045,111106751,XM_022441551.1,uncharacterized LOC111106751,20721
NC_035787.1,3042186,3082133,3067740,3082130,111106752,XM_022441555.1,uncharacterized LOC111106752,14390
NC_035787.1,3042186,3082133,3063084,3082128,111106752,XM_022441560.1,uncharacterized LOC111106752,19044
NC_035787.1,3042186,3082133,3057719,3082128,111106752,XM_022441557.1,uncharacterized LOC111106752,24409
NC_035787.1,3042186,3082133,3057295,3082128,111106752,XM_022441559.1,uncharacterized LOC111106752,24833
NC_035787.1,3042186,3082133,3049318,3082128,111106752,XM_022441556.1,uncharacterized LOC111106752,32810
NC_035787.1,3042186,3082133,3042187,3082132,111106752,XM_022441554.1,uncharacterized LOC111106752,39945
NC_035787.1,3042186,3082133,3042186,3082133,111106752,XM_022441553.1,uncharacterized LOC111106752,39947
NC_035787.1,3042186,3082133,3075922,3082131,111106752,XM_022441561.1,uncharacterized LOC111106752,6209
NC_035787.1,2904645,2907076,2904645,2907076,111106757,XM_022441569.1,uncharacterized LOC111106757,2431
NC_035787.1,2699657,2706395,2699657,2706395,111106758,XM_022441570.1,uncharacterized LOC111106758,6738
NC_035787.1,3086326,3090126,3086326,3090126,111106759,XM_022441571.1,uncharacterized LOC111106759,3800
NC_035787.1,72135266,72148293,72135678,72148293,111106764,XM_022441573.1,uncharacterized LOC111106764,12615
NC_035787.1,72135266,72148293,72135266,72148293,111106764,XM_022441574.1,uncharacterized LOC111106764,13027
NC_035787.1,7584073,7599074,7584074,7599074,111106773,XM_022441587.1,uncharacterized LOC111106773,15000
NC_035787.1,7584073,7599074,7584073,7599074,111106773,XM_022441588.1,uncharacterized LOC111106773,15001
NC_035787.1,53844626,53848707,53844626,53848707,111106774,XM_022441589.1,uncharacterized LOC111106774,4081
NC_035787.1,48556366,48582459,48556367,48582459,111106775,XM_022441592.1,uncharacterized LOC111106775,26092
NC_035787.1,48556366,48582459,48556366,48582459,111106775,XM_022441593.1,uncharacterized LOC111106775,26093
NC_035787.1,48567131,48572279,48567131,48569969,111106776,XM_022441595.1,uncharacterized LOC111106776,2838
NC_035787.1,48567131,48572279,48567131,48572279,111106776,XM_022441594.1,uncharacterized LOC111106776,5148
NC_035787.1,67958376,67991973,67958376,67982441,111106778,XM_022441599.1,uncharacterized LOC111106778,24065
NC_035787.1,67958376,67991973,67958376,67984272,111106778,XM_022441598.1,uncharacterized LOC111106778,25896
NC_035787.1,67958376,67991973,67958376,67991973,111106778,XM_022441600.1,uncharacterized LOC111106778,33597
NC_035787.1,1487046,1488511,1487046,1488511,111106784,XM_022441605.1,uncharacterized LOC111106784,1465
NC_035787.1,1515807,1518044,1515807,1518044,111106785,XM_022441606.1,uncharacterized LOC111106785,2237
NC_035787.1,3821422,3848588,3821422,3848588,111106789,XM_022441609.1,uncharacterized LOC111106789,27166
NC_035787.1,40807533,40863431,40807533,40809813,111106790,XM_022441610.1,uncharacterized LOC111106790,2280
NC_035787.1,40807533,40863431,40807533,40863431,111106790,XM_022441611.1,uncharacterized LOC111106790,55898
NC_035787.1,40861367,40863381,40861367,40863381,111106791,XM_022441612.1,uncharacterized LOC111106791,2014
NC_035787.1,40836426,40838563,40836426,40838563,111106792,XM_022441614.1,uncharacterized LOC111106792,2137
NC_035787.1,40837061,40842737,40837061,40842737,111106794,XM_022441616.1,uncharacterized LOC111106794,5676
NC_035780.1,30777542,30783834,30777542,30783834,111106797,XM_022441620.1,uncharacterized LOC111106797,6292
NC_035787.1,47226081,47233539,47226081,47233539,111106801,XM_022441623.1,uncharacterized LOC111106801,7458
NC_035787.1,34166111,34180913,34166111,34180905,111106802,XM_022441625.1,uncharacterized LOC111106802,14794
NC_035787.1,34166111,34180913,34166111,34180913,111106802,XM_022441624.1,uncharacterized LOC111106802,14802
NC_035787.1,59548204,59552216,59548204,59552216,111106803,XM_022441626.1,uncharacterized LOC111106803,4012
NC_035787.1,7615975,7624418,7615975,7624418,111106807,XM_022441627.1,uncharacterized LOC111106807,8443
NC_035787.1,59392567,59396806,59392567,59396806,111106811,XM_022441634.1,uncharacterized LOC111106811,4239
NC_035787.1,32440818,32467085,32440818,32467085,111106812,XM_022441635.1,uncharacterized LOC111106812,26267
NC_035787.1,22787970,22793210,22787970,22793210,111106824,XM_022441650.1,uncharacterized LOC111106824,5240
NC_035787.1,72095303,72111487,72109482,72111487,111106825,XM_022441651.1,uncharacterized LOC111106825,2005
NC_035787.1,38336754,38339541,38336754,38339541,111106826,XM_022441653.1,uncharacterized LOC111106826,2787
NC_035787.1,35820958,35831267,35820958,35831267,111106828,XM_022441656.1,uncharacterized LOC111106828,10309
NC_035787.1,16834020,16849309,16834020,16849309,111106834,XM_022441675.1,uncharacterized LOC111106834,15289
NC_035787.1,62913755,62919574,62913755,62919574,111106840,XM_022441685.1,uncharacterized LOC111106840,5819
NC_035787.1,23283282,23326599,23283282,23317964,111106843,XM_022441690.1,uncharacterized LOC111106843,34682
NC_035787.1,23283282,23326599,23287921,23326599,111106843,XM_022441691.1,uncharacterized LOC111106843,38678
NC_035787.1,23283282,23326599,23283282,23326599,111106843,XM_022441688.1,uncharacterized LOC111106843,43317
NC_035787.1,19154101,19157721,19154101,19157721,111106844,XM_022441692.1,uncharacterized LOC111106844,3620
NC_035787.1,58831464,58833834,58831464,58833834,111106846,XM_022441694.1,uncharacterized LOC111106846,2370
NC_035787.1,58819394,58822393,58819394,58822393,111106847,XM_022441695.1,uncharacterized LOC111106847,2999
NC_035787.1,49437944,49440427,49437944,49440427,111106848,XM_022441696.1,uncharacterized LOC111106848,2483
NC_035780.1,30216824,30218712,30216824,30218712,111106850,XM_022441701.1,uncharacterized LOC111106850,1888
NC_035787.1,58785342,58794249,58785342,58792552,111106854,XM_022441702.1,uncharacterized LOC111106854,7210
NC_035787.1,58785342,58794249,58785342,58794249,111106854,XM_022441703.1,uncharacterized LOC111106854,8907
NC_035780.1,26741724,26743728,26741724,26743728,111106855,XM_022442097.1,uncharacterized LOC111106855,2004
NC_035787.1,25021651,25024878,25021651,25024878,111106858,XM_022441705.1,uncharacterized LOC111106858,3227
NC_035780.1,30311046,30312534,30311046,30312534,111106864,XM_022441727.1,uncharacterized LOC111106864,1488
NC_035787.1,14765919,14777878,14765928,14777878,111106867,XM_022441726.1,uncharacterized LOC111106867,11950
NC_035787.1,14765919,14777878,14765919,14777878,111106867,XM_022441728.1,uncharacterized LOC111106867,11959
NC_035787.1,14765919,14777878,14768139,14777878,111106867,XM_022441729.1,uncharacterized LOC111106867,9739
NC_035787.1,70872472,70879815,70872472,70879815,111106868,XM_022441730.1,uncharacterized LOC111106868,7343
NC_035787.1,862890,866116,862890,866116,111106870,XM_022441733.1,uncharacterized LOC111106870,3226
NC_035787.1,48475075,48493969,48475075,48493969,111106871,XM_022441735.1,uncharacterized LOC111106871,18894
NC_035780.1,30315185,30316745,30315185,30316745,111106872,XM_022441739.1,uncharacterized LOC111106872,1560
NC_035787.1,67537440,67583514,67570244,67583514,111106874,XM_022441745.1,uncharacterized LOC111106874,13270
NC_035787.1,67537440,67583514,67537531,67583514,111106874,XM_022441737.1,uncharacterized LOC111106874,45983
NC_035787.1,67537440,67583514,67537454,67583514,111106874,XM_022441738.1,uncharacterized LOC111106874,46060
NC_035787.1,67537440,67583514,67537445,67583514,111106874,XM_022441740.1,uncharacterized LOC111106874,46069
NC_035787.1,67537440,67583514,67537440,67583514,111106874,XM_022441744.1,uncharacterized LOC111106874,46074
NC_035787.1,46663920,46666288,46663920,46666288,111106875,XM_022441746.1,uncharacterized LOC111106875,2368
NC_035780.1,30380783,30384189,30380783,30384189,111106878,XM_022441750.1,uncharacterized LOC111106878,3406
NC_035787.1,10043952,10046435,10043952,10046435,111106879,XM_022441747.1,uncharacterized LOC111106879,2483
NC_035787.1,10027688,10029971,10027688,10029971,111106881,XM_022441749.1,uncharacterized LOC111106881,2283
NC_035787.1,10061135,10063420,10061135,10063420,111106882,XM_022441751.1,uncharacterized LOC111106882,2285
NC_035787.1,10064940,10072745,10066420,10072745,111106884,XM_022441754.1,uncharacterized LOC111106884,6325
NC_035787.1,10064940,10072745,10064940,10072745,111106884,XM_022441753.1,uncharacterized LOC111106884,7805
NC_035787.1,10019799,10043129,10019799,10030596,111106885,XM_022441755.1,uncharacterized LOC111106885,10797
NC_035787.1,10019799,10043129,10019799,10035301,111106885,XM_022441756.1,uncharacterized LOC111106885,15502
NC_035787.1,10019799,10043129,10019799,10021939,111106885,XM_022441759.1,uncharacterized LOC111106885,2140
NC_035787.1,10019799,10043129,10019799,10043129,111106885,XM_022441758.1,uncharacterized LOC111106885,23330
NC_035787.1,10019799,10043129,10019799,10027037,111106885,XM_022441757.1,uncharacterized LOC111106885,7238
NC_035780.1,30529314,30554849,30529314,30554849,111106886,XM_022441763.1,uncharacterized LOC111106886,25535
NC_035787.1,38106840,38110161,38106840,38110161,111106888,XM_022441761.1,uncharacterized LOC111106888,3321
NC_035787.1,30159302,30162974,30159302,30162974,111106891,XM_022441772.1,uncharacterized LOC111106891,3672
NC_035787.1,30787522,30789003,30787522,30789003,111106894,XM_022441774.1,uncharacterized LOC111106894,1481
NC_035787.1,47435320,47437867,47435320,47437867,111106895,XM_022441775.1,uncharacterized LOC111106895,2547
NC_035787.1,4774394,4785185,4774394,4785185,111106896,XM_022441777.1,uncharacterized LOC111106896,10791
NC_035787.1,9737640,9739352,9737640,9739352,111106899,XM_022441780.1,uncharacterized LOC111106899,1712
NC_035787.1,27391999,27414956,27391999,27413904,111106900,XM_022441781.1,uncharacterized LOC111106900,21905
NC_035787.1,27391999,27414956,27407365,27414956,111106900,XM_022441782.1,uncharacterized LOC111106900,7591
NC_035787.1,15227732,15231436,15227732,15231436,111106904,XM_022441784.1,uncharacterized LOC111106904,3704
NC_035787.1,24674477,24696128,24674477,24696128,111106908,XM_022441789.1,uncharacterized LOC111106908,21651
NC_035787.1,42740111,42742795,42740111,42742795,111106909,XM_022441790.1,uncharacterized LOC111106909,2684
NC_035787.1,24354823,24360633,24354823,24360633,111106910,XM_022441791.1,uncharacterized LOC111106910,5810
NC_035787.1,72826182,72886640,72826182,72886640,111106917,XM_022441798.1,uncharacterized LOC111106917,60458
NC_035780.1,31901605,31902782,31901605,31902782,111106934,XM_022441816.1,uncharacterized LOC111106934,1177
NC_035787.1,48457305,48461452,48457305,48461452,111106935,XM_022441813.1,uncharacterized LOC111106935,4147
NC_035787.1,68168610,68170545,68168610,68170545,111106937,XM_022441817.1,uncharacterized LOC111106937,1935
NC_035787.1,68165711,68171739,68165711,68171739,111106938,XM_022441818.1,uncharacterized LOC111106938,6028
NC_035787.1,14739241,14750151,14739241,14750151,111106944,XM_022441824.1,uncharacterized LOC111106944,10910
NC_035787.1,14870874,14886700,14870874,14884502,111106946,XM_022441831.1,uncharacterized LOC111106946,13628
NC_035787.1,14870874,14886700,14870874,14886700,111106946,XM_022441832.1,uncharacterized LOC111106946,15826
NC_035787.1,45268937,45271001,45268937,45271001,111106947,XM_022441833.1,uncharacterized LOC111106947,2064
NC_035780.1,32474689,32475989,32474689,32475989,111106950,XM_022441841.1,uncharacterized LOC111106950,1300
NC_035787.1,46123112,46135120,46123112,46134468,111106952,XM_022441844.1,uncharacterized LOC111106952,11356
NC_035787.1,46123112,46135120,46123112,46135120,111106952,XM_022441843.1,uncharacterized LOC111106952,12008
NC_035780.1,32481349,32484992,32481349,32484992,111106956,XM_022441854.1,uncharacterized LOC111106956,3643
NC_035787.1,48528125,48534235,48528125,48534235,111106957,XM_022441851.1,uncharacterized LOC111106957,6110
NC_035787.1,67935192,67953744,67935192,67953744,111106959,XM_022441855.1,uncharacterized LOC111106959,18552
NC_035787.1,67939769,67940464,67939769,67940464,111106960,XM_022441856.1,uncharacterized LOC111106960,695
NC_035787.1,21146804,21149070,21146804,21149070,111106962,XM_022441858.1,uncharacterized LOC111106962,2266
NC_035787.1,2540191,2542478,2540191,2542478,111106963,XM_022441859.1,uncharacterized LOC111106963,2287
NC_035787.1,47503584,47512390,47503584,47512390,111106964,XM_022441860.1,uncharacterized LOC111106964,8806
NC_035787.1,22338895,22341290,22338895,22341290,111106965,XM_022441861.1,uncharacterized LOC111106965,2395
NC_035787.1,50447634,50462358,50451804,50462358,111106967,XM_022441865.1,uncharacterized LOC111106967,10554
NC_035787.1,50447634,50462358,50449048,50462358,111106967,XM_022441868.1,uncharacterized LOC111106967,13310
NC_035787.1,50447634,50462358,50447634,50462358,111106967,XM_022441867.1,uncharacterized LOC111106967,14724
NC_035787.1,50447634,50462358,50456506,50462358,111106967,XM_022441862.1,uncharacterized LOC111106967,5852
NC_035787.1,1137031,1147800,1137031,1147800,111106969,XM_022441871.1,uncharacterized LOC111106969,10769
NC_035787.1,49483012,49493971,49483012,49493971,111106971,XM_022441873.1,uncharacterized LOC111106971,10959
NC_035787.1,61491650,61495923,61493483,61495923,111106975,XM_022441876.1,uncharacterized LOC111106975,2440
NC_035787.1,61491650,61495923,61491650,61495923,111106975,XM_022441877.1,uncharacterized LOC111106975,4273
NC_035787.1,26017965,26024855,26017965,26024855,111106976,XM_022441880.1,uncharacterized LOC111106976,6890
NC_035787.1,35817336,35820187,35817336,35820187,111106979,XM_022441883.1,uncharacterized LOC111106979,2851
NC_035787.1,26472715,26481305,26472715,26481305,111106987,XM_022441908.1,uncharacterized LOC111106987,8590
NC_035787.1,26481392,26483468,26481392,26483468,111106988,XM_022441909.1,uncharacterized LOC111106988,2076
NC_035787.1,1451063,1455769,1451063,1455769,111106991,XM_022441914.1,uncharacterized LOC111106991,4706
NC_035787.1,25025077,25028934,25025077,25028934,111106993,XM_022441919.1,uncharacterized LOC111106993,3857
NC_035787.1,60107268,60110545,60107268,60109015,111106994,XM_022441920.1,uncharacterized LOC111106994,1747
NC_035787.1,60107268,60110545,60107268,60110545,111106994,XM_022441921.1,uncharacterized LOC111106994,3277
NC_035787.1,11659298,11663729,11659298,11663729,111106998,XM_022441923.1,uncharacterized LOC111106998,4431
NC_035787.1,44647227,44658129,44647227,44658129,111106999,XM_022441925.1,uncharacterized LOC111106999,10902
NC_035787.1,73986130,73988331,73986130,73988331,111107000,XM_022441926.1,uncharacterized LOC111107000,2201
NC_035787.1,21956744,21961508,21956744,21961508,111107004,XM_022441928.1,uncharacterized LOC111107004,4764
NC_035787.1,49962426,49967069,49962426,49967069,111107005,XM_022441929.1,uncharacterized LOC111107005,4643
NC_035780.1,33105191,33106364,33105191,33106364,111107006,XM_022441933.1,uncharacterized LOC111107006,1173
NC_035787.1,20303031,20305960,20303031,20305960,111107008,XM_022441931.1,uncharacterized LOC111107008,2929
NC_035787.1,2277143,2279859,2277143,2279859,111107010,XM_022441937.1,uncharacterized LOC111107010,2716
NC_035787.1,36827415,36836425,36827415,36836425,111107013,XM_022441938.1,uncharacterized LOC111107013,9010
NC_035780.1,33728089,33728460,33728089,33728460,111107015,XM_022441944.1,uncharacterized LOC111107015,371
NC_035787.1,19085860,19095982,19085860,19095982,111107018,XM_022441946.1,uncharacterized LOC111107018,10122
NC_035787.1,19085860,19095982,19085860,19092581,111107018,XM_022441947.1,uncharacterized LOC111107018,6721
NC_035787.1,19085860,19095982,19085860,19092766,111107018,XM_022441948.1,uncharacterized LOC111107018,6906
NC_035787.1,19118448,19121270,19118448,19121270,111107021,XM_022441955.1,uncharacterized LOC111107021,2822
NC_035787.1,61204110,61210258,61204110,61210258,111107023,XM_022441958.1,uncharacterized LOC111107023,6148
NC_035787.1,50625072,50635896,50625072,50635896,111107024,XM_022441960.1,uncharacterized LOC111107024,10824
NC_035787.1,15623711,15630829,15623711,15630829,111107025,XM_022441963.1,uncharacterized LOC111107025,7118
NC_035787.1,23435794,23444012,23435794,23444012,111107026,XM_022441965.1,uncharacterized LOC111107026,8218
NC_035787.1,24977390,24981584,24977390,24979393,111107032,XM_022441975.1,uncharacterized LOC111107032,2003
NC_035787.1,24977390,24981584,24977390,24981584,111107032,XM_022441974.1,uncharacterized LOC111107032,4194
NC_035787.1,40564942,40566975,40564942,40566975,111107033,XM_022441976.1,uncharacterized LOC111107033,2033
NC_035787.1,40647441,40649737,40647441,40649737,111107034,XM_022441977.1,uncharacterized LOC111107034,2296
NC_035787.1,40514932,40517023,40514932,40517023,111107037,XM_022441978.1,uncharacterized LOC111107037,2091
NC_035787.1,40625148,40627247,40625148,40627247,111107038,XM_022441979.1,uncharacterized LOC111107038,2099
NC_035787.1,40616089,40620534,40616089,40620534,111107039,XM_022441980.1,uncharacterized LOC111107039,4445
NC_035787.1,40489009,40501939,40489009,40501939,111107040,XM_022441983.1,uncharacterized LOC111107040,12930
NC_035787.1,40489009,40501939,40489009,40494615,111107040,XM_022441986.1,uncharacterized LOC111107040,5606
NC_035787.1,40489009,40501939,40489009,40496587,111107040,XM_022441985.1,uncharacterized LOC111107040,7578
NC_035787.1,40489009,40501939,40489009,40496588,111107040,XM_022441984.1,uncharacterized LOC111107040,7579
NC_035787.1,40489009,40501939,40489009,40496593,111107040,XM_022441982.1,uncharacterized LOC111107040,7584
NC_035787.1,40637015,40650443,40637016,40650443,111107041,XM_022441988.1,uncharacterized LOC111107041,13427
NC_035787.1,40637015,40650443,40637015,40650443,111107041,XM_022441987.1,uncharacterized LOC111107041,13428
NC_035787.1,40555575,40562192,40555575,40562192,111107042,XM_022441989.1,uncharacterized LOC111107042,6617
NC_035787.1,40580359,40594057,40580359,40594057,111107043,XM_022441990.1,uncharacterized LOC111107043,13698
NC_035780.1,34458570,34462620,34458570,34462620,111107044,XM_022441994.1,uncharacterized LOC111107044,4050
NC_035787.1,40525151,40530991,40525151,40530991,111107045,XM_022441991.1,uncharacterized LOC111107045,5840
NC_035787.1,40630881,40633661,40630881,40633661,111107047,XM_022441998.1,uncharacterized LOC111107047,2780
NC_035780.1,34469588,34478385,34469588,34478385,111107051,XM_022442005.1,uncharacterized LOC111107051,8797
NC_035787.1,4300253,4302484,4300253,4302484,111107052,XM_022442002.1,uncharacterized LOC111107052,2231
NC_035787.1,32799600,32823357,32799600,32823357,111107053,XM_022442003.1,uncharacterized LOC111107053,23757
NC_035787.1,48514539,48519315,48514539,48519315,111107054,XM_022442004.1,uncharacterized LOC111107054,4776
NC_035787.1,926138,927717,926138,927717,111107056,XM_022442006.1,uncharacterized LOC111107056,1579
NC_035780.1,34485996,34492569,34485996,34492569,111107059,XM_022442019.1,uncharacterized LOC111107059,6573
NC_035787.1,11212029,11234060,11212029,11234060,111107060,XM_022442015.1,uncharacterized LOC111107060,22031
NC_035787.1,25246716,25252875,25246716,25252875,111107061,XM_022442016.1,uncharacterized LOC111107061,6159
NC_035780.1,34608962,34618016,34608962,34618016,111107065,XM_022442034.1,uncharacterized LOC111107065,9054
NC_035787.1,56490810,56496309,56490810,56496309,111107066,XM_022442037.1,uncharacterized LOC111107066,5499
NC_035787.1,47806860,47816296,47806860,47813202,111107068,XM_022442041.1,uncharacterized LOC111107068,6342
NC_035787.1,47806860,47816296,47806860,47816285,111107068,XM_022442040.1,uncharacterized LOC111107068,9425
NC_035787.1,47806860,47816296,47806860,47816296,111107068,XM_022442039.1,uncharacterized LOC111107068,9436
NC_035780.1,34939704,34944651,34939704,34944651,111107070,XM_022442043.1,uncharacterized LOC111107070,4947
NC_035787.1,51083032,51083618,51083032,51083618,111107073,XM_022442042.1,uncharacterized LOC111107073,586
NC_035787.1,63237136,63241185,63237136,63241185,111107078,XM_022442044.1,uncharacterized LOC111107078,4049
NC_035787.1,2018094,2041849,2018094,2041849,111107079,XM_022442045.1,uncharacterized LOC111107079,23755
NC_035787.1,47373572,47376172,47373572,47376172,111107080,XM_022442046.1,uncharacterized LOC111107080,2600
NC_035787.1,47386885,47392636,47386887,47392635,111107084,XM_022442051.1,uncharacterized LOC111107084,5748
NC_035787.1,47386885,47392636,47386887,47392636,111107084,XM_022442048.1,uncharacterized LOC111107084,5749
NC_035787.1,47386885,47392636,47386885,47392635,111107084,XM_022442050.1,uncharacterized LOC111107084,5750
NC_035787.1,47326455,47333040,47326460,47333040,111107085,XM_022442054.1,uncharacterized LOC111107085,6580
NC_035787.1,47326455,47333040,47326455,47333040,111107085,XM_022442053.1,uncharacterized LOC111107085,6585
NC_035787.1,47360645,47362249,47360645,47362249,111107086,XM_022442055.1,uncharacterized LOC111107086,1604
NC_035787.1,47343153,47348665,47343153,47348665,111107087,XM_022442056.1,uncharacterized LOC111107087,5512
NC_035780.1,35215189,35230995,35215189,35230995,111107091,XM_022442063.1,uncharacterized LOC111107091,15806
NC_035787.1,30408189,30414009,30408189,30414009,111107092,XM_022442059.1,uncharacterized LOC111107092,5820
NC_035787.1,9921409,9945003,9942992,9945003,111107094,XM_022442065.1,uncharacterized LOC111107094,2011
NC_035787.1,9921409,9945003,9942787,9945002,111107094,XM_022442062.1,uncharacterized LOC111107094,2215
NC_035787.1,9921409,9945003,9921409,9945003,111107094,XM_022442064.1,uncharacterized LOC111107094,23594
NC_035787.1,74703496,74711255,74703496,74711255,111107101,XM_022442081.1,uncharacterized LOC111107101,7759
NC_035787.1,22313062,22320622,22313062,22320622,111107103,XM_022442082.1,uncharacterized LOC111107103,7560
NC_035787.1,22279092,22324635,22279092,22301622,111107104,XM_022442096.1,uncharacterized LOC111107104,22530
NC_035787.1,22279092,22324635,22279092,22304708,111107104,XM_022442095.1,uncharacterized LOC111107104,25616
NC_035787.1,22279092,22324635,22279092,22323971,111107104,XM_022442083.1,uncharacterized LOC111107104,44879
NC_035787.1,22279092,22324635,22279092,22324635,111107104,XM_022442084.1,uncharacterized LOC111107104,45543
NC_035787.1,61676869,61793257,61676869,61793257,111107105,XM_022442099.1,uncharacterized LOC111107105,116388
NC_035787.1,68521247,68555863,68521247,68555863,111107107,XM_022442101.1,uncharacterized LOC111107107,34616
NC_035787.1,51639982,51664993,51639982,51664993,111107110,XM_022442105.1,uncharacterized LOC111107110,25011
NC_035787.1,51588355,51592381,51588355,51592381,111107116,XM_022442111.1,uncharacterized LOC111107116,4026
NC_035787.1,51481106,51482505,51481106,51482505,111107117,XM_022442112.1,uncharacterized LOC111107117,1399
NC_035787.1,7918822,7962038,7918822,7962038,111107125,XM_022442120.1,uncharacterized LOC111107125,43216
NC_035787.1,74449452,74451705,74449452,74451705,111107128,XM_022442124.1,uncharacterized LOC111107128,2253
NC_035787.1,10630773,10664675,10630774,10664675,111107138,XM_022442144.1,uncharacterized LOC111107138,33901
NC_035787.1,10630773,10664675,10630773,10664675,111107138,XM_022442141.1,uncharacterized LOC111107138,33902
NC_035780.1,35587365,35588816,35587365,35588816,111107139,XM_022442145.1,uncharacterized LOC111107139,1451
NC_035787.1,31343060,31346113,31343060,31346113,111107141,XM_022442154.1,uncharacterized LOC111107141,3053
NC_035787.1,31341067,31348358,31341085,31348358,111107143,XM_022442155.1,uncharacterized LOC111107143,7273
NC_035787.1,31341067,31348358,31341067,31348358,111107143,XM_022442156.1,uncharacterized LOC111107143,7291
NC_035787.1,51311965,51370398,51315323,51354376,111107144,XM_022442161.1,uncharacterized LOC111107144,39053
NC_035787.1,51311965,51370398,51315323,51358608,111107144,XM_022442157.1,uncharacterized LOC111107144,43285
NC_035787.1,51311965,51370398,51315323,51358609,111107144,XM_022442162.1,uncharacterized LOC111107144,43286
NC_035787.1,51311965,51370398,51315244,51358607,111107144,XM_022442166.1,uncharacterized LOC111107144,43363
NC_035787.1,51311965,51370398,51313312,51358607,111107144,XM_022442163.1,uncharacterized LOC111107144,45295
NC_035787.1,51311965,51370398,51312038,51358607,111107144,XM_022442164.1,uncharacterized LOC111107144,46569
NC_035787.1,51311965,51370398,51311965,51358607,111107144,XM_022442165.1,uncharacterized LOC111107144,46642
NC_035787.1,51311965,51370398,51315323,51370001,111107144,XM_022442158.1,uncharacterized LOC111107144,54678
NC_035787.1,51311965,51370398,51315323,51370398,111107144,XM_022442160.1,uncharacterized LOC111107144,55075
NC_035787.1,51358730,51361849,51358730,51361849,111107145,XM_022442167.1,uncharacterized LOC111107145,3119
NC_035787.1,51370943,51372219,51370943,51372219,111107147,XM_022442168.1,uncharacterized LOC111107147,1276
NC_035787.1,19503868,19521345,19503868,19514223,111107155,XM_022442191.1,uncharacterized LOC111107155,10355
NC_035787.1,19503868,19521345,19503868,19514806,111107155,XM_022442192.1,uncharacterized LOC111107155,10938
NC_035787.1,19503868,19521345,19503868,19515145,111107155,XM_022442187.1,uncharacterized LOC111107155,11277
NC_035787.1,19503868,19521345,19503868,19515596,111107155,XM_022442189.1,uncharacterized LOC111107155,11728
NC_035787.1,19503868,19521345,19503868,19519772,111107155,XM_022442186.1,uncharacterized LOC111107155,15904
NC_035787.1,19503868,19521345,19503868,19521345,111107155,XM_022442185.1,uncharacterized LOC111107155,17477
NC_035787.1,19503868,19521345,19503868,19511597,111107155,XM_022442188.1,uncharacterized LOC111107155,7729
NC_035787.1,19503868,19521345,19503868,19511727,111107155,XM_022442190.1,uncharacterized LOC111107155,7859
NC_035787.1,19246681,19254858,19246681,19254858,111107156,XM_022442193.1,uncharacterized LOC111107156,8177
NC_035780.1,35716471,35716953,35716471,35716953,111107157,XM_022442198.1,uncharacterized LOC111107157,482
NC_035787.1,19291699,19302306,19291699,19302306,111107159,XM_022442197.1,uncharacterized LOC111107159,10607
NC_035787.1,19291699,19302306,19298081,19302306,111107159,XM_022442196.1,uncharacterized LOC111107159,4225
NC_035787.1,19546361,19550065,19546361,19550065,111107160,XM_022442199.1,uncharacterized LOC111107160,3704
NC_035787.1,19374891,19377525,19374891,19377525,111107161,XM_022442200.1,uncharacterized LOC111107161,2634
NC_035787.1,19426452,19429458,19426452,19429458,111107162,XM_022442201.1,uncharacterized LOC111107162,3006
NC_035787.1,19257124,19260888,19257124,19260888,111107164,XM_022442204.1,uncharacterized LOC111107164,3764
NC_035787.1,19261742,19265583,19261742,19265583,111107165,XM_022442205.1,uncharacterized LOC111107165,3841
NC_035780.1,35903251,35904553,35903251,35904553,111107166,XM_022442208.1,uncharacterized LOC111107166,1302
NC_035787.1,19352162,19355132,19352162,19354880,111107167,XM_022442206.1,uncharacterized LOC111107167,2718
NC_035787.1,61327080,61330118,61327080,61329957,111107170,XM_022442210.1,uncharacterized LOC111107170,2877
NC_035787.1,61327080,61330118,61327080,61330110,111107170,XM_022442211.1,uncharacterized LOC111107170,3030
NC_035787.1,61327080,61330118,61327080,61330118,111107170,XM_022442209.1,uncharacterized LOC111107170,3038
NC_035787.1,39069980,39078169,39069980,39078164,111107177,XM_022442219.1,uncharacterized LOC111107177,8184
NC_035787.1,39069980,39078169,39069980,39078169,111107177,XM_022442220.1,uncharacterized LOC111107177,8189
NC_035787.1,39152596,39157087,39152596,39157087,111107178,XM_022442222.1,uncharacterized LOC111107178,4491
NC_035787.1,39238929,39247728,39238929,39247728,111107184,XM_022442229.1,uncharacterized LOC111107184,8799
NC_035787.1,39312431,39320971,39313488,39320971,111107185,XM_022442236.1,uncharacterized LOC111107185,7483
NC_035787.1,39312431,39320971,39313483,39320971,111107185,XM_022442235.1,uncharacterized LOC111107185,7488
NC_035787.1,39312431,39320971,39313454,39320971,111107185,XM_022442238.1,uncharacterized LOC111107185,7517
NC_035787.1,39312431,39320971,39312441,39320971,111107185,XM_022442232.1,uncharacterized LOC111107185,8530
NC_035787.1,39312431,39320971,39312431,39320971,111107185,XM_022442231.1,uncharacterized LOC111107185,8540
NC_035787.1,39301615,39309044,39301638,39309042,111107186,XM_022442240.1,uncharacterized LOC111107186,7404
NC_035787.1,39301615,39309044,39301615,39309041,111107186,XM_022442239.1,uncharacterized LOC111107186,7426
NC_035787.1,39301615,39309044,39301615,39309044,111107186,XM_022442241.1,uncharacterized LOC111107186,7429
NC_035787.1,39330008,39332068,39330008,39332068,111107191,XM_022442246.1,uncharacterized LOC111107191,2060
NC_035787.1,39266156,39272816,39266156,39272816,111107195,XM_022442252.1,uncharacterized LOC111107195,6660
NC_035787.1,39321883,39323883,39321883,39323883,111107196,XM_022442253.1,uncharacterized LOC111107196,2000
NC_035787.1,12052316,12090742,12059559,12090740,111107204,XM_022442288.1,uncharacterized LOC111107204,31181
NC_035787.1,12052316,12090742,12058815,12090741,111107204,XM_022442284.1,uncharacterized LOC111107204,31926
NC_035787.1,12052316,12090742,12056084,12090741,111107204,XM_022442286.1,uncharacterized LOC111107204,34657
NC_035787.1,12052316,12090742,12052316,12090740,111107204,XM_022442285.1,uncharacterized LOC111107204,38424
NC_035787.1,12052316,12090742,12052316,12090741,111107204,XM_022442279.1,uncharacterized LOC111107204,38425
NC_035787.1,12052316,12090742,12052316,12090742,111107204,XM_022442261.1,uncharacterized LOC111107204,38426
NC_035780.1,36834001,36835559,36834001,36835559,111107206,XM_022442287.1,uncharacterized LOC111107206,1558
NC_035787.1,8315049,8317688,8315049,8317688,111107209,XM_022442292.1,uncharacterized LOC111107209,2639
NC_035787.1,8312907,8314953,8312907,8314953,111107210,XM_022442293.1,uncharacterized LOC111107210,2046
NC_035780.1,36846780,36848927,36846780,36848927,111107213,XM_022442299.1,uncharacterized LOC111107213,2147
NC_035787.1,54046991,54048352,54046991,54048352,111107217,XM_022442300.1,uncharacterized LOC111107217,1361
NC_035787.1,54103322,54104772,54103488,54104772,111107218,XM_022442301.1,uncharacterized LOC111107218,1284
NC_035787.1,57949420,57982169,57963947,57982169,111107219,XM_022442305.1,uncharacterized LOC111107219,18222
NC_035787.1,57949420,57982169,57957328,57982169,111107219,XM_022442303.1,uncharacterized LOC111107219,24841
NC_035787.1,57949420,57982169,57949441,57982169,111107219,XM_022442304.1,uncharacterized LOC111107219,32728
NC_035787.1,57949420,57982169,57949420,57982169,111107219,XM_022442302.1,uncharacterized LOC111107219,32749
NC_035780.1,36850724,36853532,36850724,36853532,111107221,XM_022442310.1,uncharacterized LOC111107221,2808
NC_035787.1,60077076,60081588,60077076,60081588,111107222,XM_022442306.1,uncharacterized LOC111107222,4512
NC_035787.1,44834117,44843841,44834117,44843841,111107225,XM_022442315.1,uncharacterized LOC111107225,9724
NC_035787.1,44857526,44859416,44857526,44859416,111107227,XM_022442317.1,uncharacterized LOC111107227,1890
NC_035780.1,36869628,36870550,36869628,36870550,111107229,XM_022442322.1,uncharacterized LOC111107229,922
NC_035780.1,37021053,37021688,37021053,37021688,111107239,XM_022442333.1,uncharacterized LOC111107239,635
NC_035787.1,5077187,5080258,5077187,5080258,111107241,XM_022442330.1,uncharacterized LOC111107241,3071
NC_035787.1,5066612,5069092,5066612,5069092,111107242,XM_022442332.1,uncharacterized LOC111107242,2480
NC_035787.1,25905851,25916336,25905851,25916336,111107244,XM_022442334.1,uncharacterized LOC111107244,10485
NC_035787.1,73302702,73307001,73302702,73307001,111107245,XM_022442335.1,uncharacterized LOC111107245,4299
NC_035787.1,73302785,73303844,73302785,73303844,111107247,XM_022442337.1,uncharacterized LOC111107247,1059
NC_035787.1,73291215,73302652,73291215,73302652,111107248,XM_022442338.1,uncharacterized LOC111107248,11437
NC_035787.1,73313371,73323529,73313371,73323529,111107249,XM_022442339.1,uncharacterized LOC111107249,10158
NC_035780.1,37257768,37262530,37257768,37262530,111107251,XM_022442358.1,uncharacterized LOC111107251,4762
NC_035787.1,28636594,28669074,28636594,28669074,111107252,XM_022442356.1,uncharacterized LOC111107252,32480
NC_035787.1,28610340,28616706,28610340,28616705,111107257,XM_022442368.1,uncharacterized LOC111107257,6365
NC_035787.1,28610340,28616706,28610340,28616706,111107257,XM_022442365.1,uncharacterized LOC111107257,6366
NC_035787.1,28251222,28255069,28251222,28255069,111107262,XM_022442373.1,uncharacterized LOC111107262,3847
NC_035787.1,28687979,28690808,28687979,28690808,111107263,XM_022442374.1,uncharacterized LOC111107263,2829
NC_035787.1,28410191,28412366,28410191,28412366,111107264,XM_022442375.1,uncharacterized LOC111107264,2175
NC_035787.1,28360093,28362611,28360093,28362611,111107269,XM_022442382.1,uncharacterized LOC111107269,2518
NC_035787.1,28392778,28401664,28392778,28401664,111107276,XM_022442391.1,uncharacterized LOC111107276,8886
NC_035787.1,28503851,28526603,28503851,28513905,111107278,XM_022442401.1,uncharacterized LOC111107278,10054
NC_035787.1,28503851,28526603,28503851,28514190,111107278,XM_022442396.1,uncharacterized LOC111107278,10339
NC_035787.1,28503851,28526603,28503851,28515620,111107278,XM_022442400.1,uncharacterized LOC111107278,11769
NC_035787.1,28503851,28526603,28503851,28515928,111107278,XM_022442402.1,uncharacterized LOC111107278,12077
NC_035787.1,28503851,28526603,28503851,28516156,111107278,XM_022442403.1,uncharacterized LOC111107278,12305
NC_035787.1,28503851,28526603,28503851,28526603,111107278,XM_022442394.1,uncharacterized LOC111107278,22752
NC_035787.1,28503851,28526603,28503851,28510226,111107278,XM_022442397.1,uncharacterized LOC111107278,6375
NC_035787.1,28503851,28526603,28503851,28513412,111107278,XM_022442399.1,uncharacterized LOC111107278,9561
NC_035787.1,28503851,28526603,28503851,28513738,111107278,XM_022442398.1,uncharacterized LOC111107278,9887
NC_035787.1,28518617,28526097,28518617,28525404,111107279,XM_022442406.1,uncharacterized LOC111107279,6787
NC_035787.1,28518617,28526097,28518617,28526030,111107279,XM_022442405.1,uncharacterized LOC111107279,7413
NC_035787.1,28518617,28526097,28518617,28526097,111107279,XM_022442404.1,uncharacterized LOC111107279,7480
NC_035780.1,37618015,37620667,37618015,37620667,111107280,XM_022442409.1,uncharacterized LOC111107280,2652
NC_035787.1,28313577,28323798,28313579,28323789,111107281,XM_022442408.1,uncharacterized LOC111107281,10210
NC_035787.1,28313577,28323798,28313577,28323798,111107281,XM_022442407.1,uncharacterized LOC111107281,10221
NC_035787.1,28490849,28497527,28490849,28497527,111107282,XM_022442411.1,uncharacterized LOC111107282,6678
NC_035787.1,28484536,28490486,28484536,28490486,111107283,XM_022442412.1,uncharacterized LOC111107283,5950
NC_035787.1,28540852,28548680,28540852,28544745,111107284,XM_022442416.1,uncharacterized LOC111107284,3893
NC_035787.1,28540852,28548680,28540852,28548151,111107284,XM_022442413.1,uncharacterized LOC111107284,7299
NC_035787.1,28540852,28548680,28540852,28548564,111107284,XM_022442415.1,uncharacterized LOC111107284,7712
NC_035787.1,28540852,28548680,28540852,28548680,111107284,XM_022442414.1,uncharacterized LOC111107284,7828
NC_035787.1,28556757,28575824,28556757,28575824,111107285,XM_022442418.1,uncharacterized LOC111107285,19067
NC_035787.1,28556757,28575824,28556757,28563657,111107285,XM_022442417.1,uncharacterized LOC111107285,6900
NC_035787.1,28374308,28383466,28374308,28383465,111107287,XM_022442419.1,uncharacterized LOC111107287,9157
NC_035787.1,28374308,28383466,28374308,28383466,111107287,XM_022442420.1,uncharacterized LOC111107287,9158
NC_035787.1,28580074,28589263,28580735,28589263,111107288,XM_022442421.1,uncharacterized LOC111107288,8528
NC_035787.1,28580074,28589263,28580074,28589263,111107288,XM_022442422.1,uncharacterized LOC111107288,9189
NC_035787.1,28589406,28607519,28589406,28606943,111107289,XM_022442426.1,uncharacterized LOC111107289,17537
NC_035787.1,28589406,28607519,28589406,28607509,111107289,XM_022442427.1,uncharacterized LOC111107289,18103
NC_035787.1,28589406,28607519,28589406,28607511,111107289,XM_022442425.1,uncharacterized LOC111107289,18105
NC_035787.1,28589406,28607519,28589406,28607519,111107289,XM_022442429.1,uncharacterized LOC111107289,18113
NC_035787.1,28309641,28312428,28309641,28312428,111107290,XM_022442430.1,uncharacterized LOC111107290,2787
NC_035787.1,28678200,28686548,28678200,28686548,111107293,XM_022442433.1,uncharacterized LOC111107293,8348
NC_035787.1,28428873,28432553,28429044,28432317,111107294,XM_022442436.1,uncharacterized LOC111107294,3273
NC_035787.1,28428873,28432553,28428873,28432299,111107294,XM_022442434.1,uncharacterized LOC111107294,3426
NC_035787.1,28428873,28432553,28428873,28432553,111107294,XM_022442435.1,uncharacterized LOC111107294,3680
NC_035787.1,28306507,28308433,28306507,28308433,111107295,XM_022442438.1,uncharacterized LOC111107295,1926
NC_035787.1,28710218,28724247,28710218,28724247,111107296,XM_022442439.1,uncharacterized LOC111107296,14029
NC_035787.1,28367762,28373364,28370514,28373364,111107297,XM_022442441.1,uncharacterized LOC111107297,2850
NC_035787.1,28367762,28373364,28367762,28373361,111107297,XM_022442440.1,uncharacterized LOC111107297,5599
NC_035787.1,30074116,30077936,30074116,30077936,111107309,XM_022442448.1,uncharacterized LOC111107309,3820
NC_035787.1,30087940,30090459,30087940,30090459,111107313,XM_022442451.1,uncharacterized LOC111107313,2519
NC_035780.1,37931513,37940396,37931513,37940396,111107320,XM_022442465.1,uncharacterized LOC111107320,8883
NC_035787.1,58748071,58783635,58748753,58783635,111107321,XM_022442463.1,uncharacterized LOC111107321,34882
NC_035787.1,58748071,58783635,58748071,58783635,111107321,XM_022442462.1,uncharacterized LOC111107321,35564
NC_035787.1,69763230,69780061,69763230,69780061,111107322,XM_022442464.1,uncharacterized LOC111107322,16831
NC_035787.1,69780471,69784739,69780471,69784739,111107323,XM_022442466.1,uncharacterized LOC111107323,4268
NC_035780.1,38332029,38334419,38332029,38334419,111107329,XM_022442494.1,uncharacterized LOC111107329,2390
NC_035787.1,2533945,2535721,2533945,2535721,111107331,XM_022442493.1,uncharacterized LOC111107331,1776
NC_035787.1,38182415,38184441,38182415,38184441,111107333,XM_022442496.1,uncharacterized LOC111107333,2026
NC_035787.1,38272469,38274238,38272469,38274238,111107334,XM_022442497.1,uncharacterized LOC111107334,1769
NC_035787.1,63944226,63958194,63944226,63958194,111107337,XM_022442500.1,uncharacterized LOC111107337,13968
NC_035780.1,38511369,38518890,38511369,38518890,111107339,XM_022442505.1,uncharacterized LOC111107339,7521
NC_035780.1,38525368,38528282,38525368,38528282,111107348,XM_022442518.1,uncharacterized LOC111107348,2914
NC_035787.1,63928103,63931132,63928103,63931132,111107352,XM_022442526.1,uncharacterized LOC111107352,3029
NC_035780.1,39092840,39094273,39092840,39094273,111107362,XM_022442544.1,uncharacterized LOC111107362,1433
NC_035787.1,63609562,63610923,63609562,63610923,111107366,XM_022442554.1,uncharacterized LOC111107366,1361
NC_035780.1,39143482,39147703,39143482,39147703,111107367,XM_022442558.1,uncharacterized LOC111107367,4221
NC_035787.1,63962022,63964392,63962909,63964392,111107370,XM_022442557.1,uncharacterized LOC111107370,1483
NC_035787.1,63962022,63964392,63962022,63964392,111107370,XM_022442559.1,uncharacterized LOC111107370,2370
NC_035780.1,39401353,39402484,39401353,39402484,111107390,XM_022442573.1,uncharacterized LOC111107390,1131
NC_035787.1,74313353,74317389,74313353,74317389,111107392,XM_022442572.1,uncharacterized LOC111107392,4036
NC_035780.1,39403810,39408432,39403810,39408432,111107399,XM_022442584.1,uncharacterized LOC111107399,4622
NC_035780.1,39413327,39426221,39413327,39426221,111107405,XM_022442597.1,uncharacterized LOC111107405,12894
NC_035787.1,3980804,4000912,3980804,4000912,111107406,XM_022442595.1,uncharacterized LOC111107406,20108
NC_035787.1,4005956,4009939,4005956,4009939,111107408,XM_022442598.1,uncharacterized LOC111107408,3983
NC_035787.1,60172868,60191719,60172868,60191719,111107411,XM_022442605.1,uncharacterized LOC111107411,18851
NC_035780.1,39546507,39549761,39546507,39549761,111107412,XM_022442610.1,uncharacterized LOC111107412,3254
NC_035787.1,60198856,60199734,60198856,60199734,111107415,XM_022442611.1,uncharacterized LOC111107415,878
NC_035780.1,39550399,39557318,39550399,39557318,111107423,XM_022442621.1,uncharacterized LOC111107423,6919
NC_035787.1,5687453,5692839,5687453,5692839,111107425,XM_022442623.1,uncharacterized LOC111107425,5386
NC_035787.1,6487898,6493304,6487898,6492770,111107429,XM_022442629.1,uncharacterized LOC111107429,4872
NC_035787.1,6487898,6493304,6487898,6493304,111107429,XM_022442630.1,uncharacterized LOC111107429,5406
NC_035787.1,257120,259346,257120,259346,111107433,XM_022442633.1,uncharacterized LOC111107433,2226
NC_035787.1,324152,325333,324152,325333,111107434,XM_022442634.1,uncharacterized LOC111107434,1181
NC_035780.1,39617141,39618662,39617141,39618662,111107440,XM_022442643.1,uncharacterized LOC111107440,1521
NC_035787.1,814216,815770,814216,815770,111107441,XM_022442640.1,uncharacterized LOC111107441,1554
NC_035787.1,828934,831938,828934,831938,111107442,XM_022442641.1,uncharacterized LOC111107442,3004
NC_035787.1,1190997,1200741,1190997,1200741,111107449,XM_022442659.1,uncharacterized LOC111107449,9744
NC_035787.1,1488451,1491227,1488451,1491227,111107451,XM_022442662.1,uncharacterized LOC111107451,2776
NC_035787.1,1571248,1572278,1571248,1572278,111107452,XM_022442663.1,uncharacterized LOC111107452,1030
NC_035787.1,1581028,1582266,1581028,1582266,111107453,XM_022442664.1,uncharacterized LOC111107453,1238
NC_035787.1,1582803,1585029,1582803,1585029,111107454,XM_022442665.1,uncharacterized LOC111107454,2226
NC_035780.1,39692574,39695929,39692574,39695929,111107455,XM_022442669.1,uncharacterized LOC111107455,3355
NC_035787.1,1650194,1652327,1650194,1652327,111107456,XM_022442666.1,uncharacterized LOC111107456,2133
NC_035787.1,2065204,2068759,2065204,2068759,111107457,XM_022442667.1,uncharacterized LOC111107457,3555
NC_035787.1,2150068,2151738,2150068,2151738,111107458,XM_022442668.1,uncharacterized LOC111107458,1670
NC_035780.1,39875372,39896220,39875372,39896220,111107463,XM_022442681.1,uncharacterized LOC111107463,20848
NC_035787.1,2464007,2487245,2464007,2487245,111107465,XM_022442682.1,uncharacterized LOC111107465,23238
NC_035787.1,2638948,2649218,2638948,2649218,111107467,XM_022442684.1,uncharacterized LOC111107467,10270
NC_035787.1,2893371,2894729,2893371,2894729,111107468,XM_022442685.1,uncharacterized LOC111107468,1358
NC_035787.1,57983350,57987589,57983350,57987589,111107469,XM_022442686.1,uncharacterized LOC111107469,4239
NC_035787.1,3089767,3092374,3089767,3092374,111107470,XM_022442687.1,uncharacterized LOC111107470,2607
NC_035787.1,3167314,3169413,3167314,3169413,111107471,XM_022442688.1,uncharacterized LOC111107471,2099
NC_035780.1,39920694,39926985,39920694,39926985,111107479,XM_022442699.1,uncharacterized LOC111107479,6291
NC_035787.1,75204492,75211954,75204492,75211954,111107480,XM_022442695.1,uncharacterized LOC111107480,7462
NC_035787.1,33037065,33069535,33037065,33069535,111107483,XM_022442700.1,uncharacterized LOC111107483,32470
NC_035787.1,33234918,33246923,33234943,33246923,111107486,XM_022442705.1,uncharacterized LOC111107486,11980
NC_035787.1,33234918,33246923,33234918,33246923,111107486,XM_022442704.1,uncharacterized LOC111107486,12005
NC_035787.1,33234918,33246923,33234918,33244740,111107486,XM_022442706.1,uncharacterized LOC111107486,9822
NC_035787.1,33221613,33230453,33224902,33230453,111107489,XM_022442710.1,uncharacterized LOC111107489,5551
NC_035787.1,33221613,33230453,33221613,33230453,111107489,XM_022442709.1,uncharacterized LOC111107489,8840
NC_035787.1,33109271,33111631,33109271,33111631,111107494,XM_022442718.1,uncharacterized LOC111107494,2360
NC_035780.1,40257326,40258648,40257326,40258648,111107496,XM_022442723.1,uncharacterized LOC111107496,1322
NC_035787.1,33105118,33108221,33105118,33108221,111107497,XM_022442720.1,uncharacterized LOC111107497,3103
NC_035787.1,33093456,33097484,33093456,33097484,111107501,XM_022442726.1,uncharacterized LOC111107501,4028
NC_035787.1,4270934,4279628,4270934,4279628,111107503,XM_022442728.1,uncharacterized LOC111107503,8694
NC_035780.1,40265509,40266099,40265509,40266099,111107504,XM_022442732.1,uncharacterized LOC111107504,590
NC_035787.1,51230967,51240333,51235771,51240333,111107510,XM_022442737.1,uncharacterized LOC111107510,4562
NC_035787.1,5409322,5410487,5409322,5410487,111107517,XM_022442744.1,uncharacterized LOC111107517,1165
NC_035787.1,31223339,31242737,31223339,31238125,111107519,XM_022442764.1,uncharacterized LOC111107519,14786
NC_035787.1,31223339,31242737,31223339,31242737,111107519,XM_022442763.1,uncharacterized LOC111107519,19398
NC_035787.1,31223339,31242737,31223339,31231766,111107519,XM_022442762.1,uncharacterized LOC111107519,8427
NC_035780.1,41244253,41244798,41244253,41244798,111107521,XM_022442769.1,uncharacterized LOC111107521,545
NC_035787.1,31249251,31269641,31249251,31260674,111107523,XM_022442768.1,uncharacterized LOC111107523,11423
NC_035787.1,31249251,31269641,31249251,31267861,111107523,XM_022442771.1,uncharacterized LOC111107523,18610
NC_035787.1,31249251,31269641,31249251,31268278,111107523,XM_022442772.1,uncharacterized LOC111107523,19027
NC_035787.1,31249251,31269641,31249251,31269421,111107523,XM_022442770.1,uncharacterized LOC111107523,20170
NC_035787.1,31249251,31269641,31249251,31269641,111107523,XM_022442773.1,uncharacterized LOC111107523,20390
NC_035787.1,5995574,6000433,5995574,6000433,111107526,XM_022442776.1,uncharacterized LOC111107526,4859
NC_035780.1,41281006,41286688,41281006,41286688,111107528,XM_022442780.1,uncharacterized LOC111107528,5682
NC_035787.1,6054785,6055630,6054785,6055630,111107529,XM_022442778.1,uncharacterized LOC111107529,845
NC_035787.1,6155726,6257765,6155726,6257765,111107530,XM_022442779.1,uncharacterized LOC111107530,102039
NC_035787.1,6282597,6294010,6282597,6294010,111107531,XM_022442781.1,uncharacterized LOC111107531,11413
NC_035787.1,6339714,6343485,6339714,6343485,111107533,XM_022442782.1,uncharacterized LOC111107533,3771
NC_035787.1,7292740,7294692,7292740,7294692,111107541,XM_022442787.1,uncharacterized LOC111107541,1952
NC_035787.1,42816173,42834310,42816173,42834310,111107545,XM_022442799.1,uncharacterized LOC111107545,18137
NC_035787.1,42809432,42813916,42809432,42813916,111107547,XM_022442800.1,uncharacterized LOC111107547,4484
NC_035787.1,58571717,58602097,58571717,58602097,111107550,XM_022442809.1,uncharacterized LOC111107550,30380
NC_035780.1,50266606,50273440,50266606,50272636,111107551,XM_022442919.1,uncharacterized LOC111107551,6030
NC_035780.1,50266606,50273440,50266606,50273439,111107551,XM_022442844.1,uncharacterized LOC111107551,6833
NC_035780.1,50266606,50273440,50266606,50273440,111107551,XM_022443006.1,uncharacterized LOC111107551,6834
NC_035787.1,47749892,47774358,47749892,47774358,111107554,XM_022442811.1,uncharacterized LOC111107554,24466
NC_035780.1,42667193,42670227,42667193,42670227,111107559,XM_022442823.1,uncharacterized LOC111107559,3034
NC_035787.1,3483141,3486213,3483141,3486208,111107567,XM_022442829.1,uncharacterized LOC111107567,3067
NC_035787.1,3483141,3486213,3483141,3486213,111107567,XM_022442828.1,uncharacterized LOC111107567,3072
NC_035787.1,3493233,3495794,3493233,3495794,111107568,XM_022442830.1,uncharacterized LOC111107568,2561
NC_035787.1,59248440,59260661,59248440,59260661,111107573,XM_022442835.1,uncharacterized LOC111107573,12221
NC_035787.1,59248440,59260661,59251981,59258867,111107573,XM_022442836.1,uncharacterized LOC111107573,6886
NC_035780.1,43014784,43019797,43014784,43019797,111107575,XM_022442845.1,uncharacterized LOC111107575,5013
NC_035787.1,8935246,8939214,8935246,8939214,111107578,XM_022442847.1,uncharacterized LOC111107578,3968
NC_035787.1,8952089,8952727,8952089,8952727,111107579,XM_022442848.1,uncharacterized LOC111107579,638
NC_035787.1,8960329,8962797,8960329,8962797,111107580,XM_022442849.1,uncharacterized LOC111107580,2468
NC_035787.1,8974981,8975517,8974981,8975517,111107581,XM_022442850.1,uncharacterized LOC111107581,536
NC_035787.1,8990540,8991308,8990540,8991308,111107582,XM_022442851.1,uncharacterized LOC111107582,768
NC_035787.1,9342595,9344242,9342595,9344242,111107585,XM_022442852.1,uncharacterized LOC111107585,1647
NC_035787.1,15391540,15492277,15391540,15492277,111107586,XM_022442853.1,uncharacterized LOC111107586,100737
NC_035787.1,15391540,15492277,15482294,15492277,111107586,XM_022442854.1,uncharacterized LOC111107586,9983
NC_035787.1,15449659,15455977,15449659,15455977,111107587,XM_022442856.1,uncharacterized LOC111107587,6318
NC_035787.1,55421939,55434026,55421939,55432383,111107589,XM_022442858.1,uncharacterized LOC111107589,10444
NC_035787.1,55421939,55434026,55421939,55434026,111107589,XM_022442857.1,uncharacterized LOC111107589,12087
NC_035787.1,9850021,9851021,9850021,9851021,111107590,XM_022442859.1,uncharacterized LOC111107590,1000
NC_035787.1,9908542,9909567,9908542,9909567,111107592,XM_022442860.1,uncharacterized LOC111107592,1025
NC_035787.1,9927324,9930366,9927324,9930366,111107598,XM_022442873.1,uncharacterized LOC111107598,3042
NC_035787.1,9935605,9938811,9935605,9938811,111107599,XM_022442874.1,uncharacterized LOC111107599,3206
NC_035780.1,43179579,43200438,43179579,43200438,111107600,XM_022442879.1,uncharacterized LOC111107600,20859
NC_035787.1,9951438,9952475,9951438,9952475,111107601,XM_022442875.1,uncharacterized LOC111107601,1037
NC_035787.1,64855941,64886269,64855941,64871635,111107602,XM_022442878.1,uncharacterized LOC111107602,15694
NC_035787.1,64855941,64886269,64855941,64886267,111107602,XM_022442877.1,uncharacterized LOC111107602,30326
NC_035787.1,64855941,64886269,64855941,64886269,111107602,XM_022442876.1,uncharacterized LOC111107602,30328
NC_035787.1,10057007,10058356,10057007,10058356,111107603,XM_022442880.1,uncharacterized LOC111107603,1349
NC_035787.1,10196598,10204380,10196598,10204380,111107605,XM_022442881.1,uncharacterized LOC111107605,7782
NC_035787.1,10237757,10240672,10237757,10240672,111107613,XM_022442888.1,uncharacterized LOC111107613,2915
NC_035787.1,10354768,10362740,10354768,10362740,111107614,XM_022442889.1,uncharacterized LOC111107614,7972
NC_035787.1,10586589,10594061,10586589,10594061,111107615,XM_022442890.1,uncharacterized LOC111107615,7472
NC_035787.1,10782824,10785734,10782824,10785734,111107617,XM_022442891.1,uncharacterized LOC111107617,2910
NC_035787.1,10916245,10917396,10916245,10917396,111107618,XM_022442892.1,uncharacterized LOC111107618,1151
NC_035787.1,11052210,11053055,11052210,11053055,111107623,XM_022442901.1,uncharacterized LOC111107623,845
NC_035787.1,11539581,11543376,11539581,11543376,111107624,XM_022442902.1,uncharacterized LOC111107624,3795
NC_035787.1,11975579,11979817,11975579,11979817,111107625,XM_022442903.1,uncharacterized LOC111107625,4238
NC_035787.1,12021306,12022283,12021306,12022283,111107626,XM_022442904.1,uncharacterized LOC111107626,977
NC_035787.1,41008698,41047839,41008698,41047839,111107627,XM_022442906.1,uncharacterized LOC111107627,39141
NC_035780.1,43449957,43464316,43449957,43464316,111107628,XM_022442912.1,uncharacterized LOC111107628,14359
NC_035787.1,41884249,41886796,41884249,41886796,111107630,XM_022442910.1,uncharacterized LOC111107630,2547
NC_035787.1,41913443,42047138,42044535,42047108,111107631,XM_022442911.1,uncharacterized LOC111107631,2573
NC_035787.1,41064384,41067132,41064384,41067132,111107632,XM_022442913.1,uncharacterized LOC111107632,2748
NC_035787.1,42180801,42182813,42180801,42182813,111107633,XM_022442914.1,uncharacterized LOC111107633,2012
NC_035787.1,41324522,41342103,41324522,41342103,111107634,XM_022442915.1,uncharacterized LOC111107634,17581
NC_035787.1,41324522,41342103,41324522,41326770,111107634,XM_022442916.1,uncharacterized LOC111107634,2248
NC_035787.1,41156715,41159431,41156715,41159431,111107635,XM_022442917.1,uncharacterized LOC111107635,2716
NC_035787.1,41989069,41991955,41989069,41991955,111107636,XM_022442918.1,uncharacterized LOC111107636,2886
NC_035787.1,41209627,41212627,41209627,41212577,111107637,XM_022442921.1,uncharacterized LOC111107637,2950
NC_035787.1,41209627,41212627,41209627,41212627,111107637,XM_022442920.1,uncharacterized LOC111107637,3000
NC_035787.1,41495776,41497885,41495776,41497885,111107638,XM_022442922.1,uncharacterized LOC111107638,2109
NC_035787.1,41410916,41413637,41410916,41413637,111107639,XM_022442923.1,uncharacterized LOC111107639,2721
NC_035787.1,42450401,42452777,42450401,42452777,111107640,XM_022442924.1,uncharacterized LOC111107640,2376
NC_035787.1,41382578,41385061,41382578,41385061,111107641,XM_022442925.1,uncharacterized LOC111107641,2483
NC_035787.1,41902853,41905253,41902853,41905253,111107642,XM_022442926.1,uncharacterized LOC111107642,2400
NC_035787.1,42352575,42354662,42352575,42354662,111107643,XM_022442927.1,uncharacterized LOC111107643,2087
NC_035787.1,41099027,41102127,41099027,41102127,111107644,XM_022442928.1,uncharacterized LOC111107644,3100
NC_035787.1,42418318,42420993,42418318,42420993,111107645,XM_022442929.1,uncharacterized LOC111107645,2675
NC_035787.1,42488373,42490956,42488373,42490956,111107646,XM_022442930.1,uncharacterized LOC111107646,2583
NC_035787.1,41120175,41122979,41120175,41122979,111107648,XM_022442931.1,uncharacterized LOC111107648,2804
NC_035787.1,42163378,42165737,42163378,42165737,111107649,XM_022442932.1,uncharacterized LOC111107649,2359
NC_035787.1,42223287,42225676,42223287,42225676,111107650,XM_022442933.1,uncharacterized LOC111107650,2389
NC_035787.1,41197310,41199901,41197310,41199901,111107651,XM_022442935.1,uncharacterized LOC111107651,2591
NC_035787.1,42191930,42194348,42191930,42194348,111107652,XM_022442936.1,uncharacterized LOC111107652,2418
NC_035787.1,42277868,42280134,42277868,42280134,111107653,XM_022442937.1,uncharacterized LOC111107653,2266
NC_035787.1,41847215,41850096,41847215,41850096,111107654,XM_022442938.1,uncharacterized LOC111107654,2881
NC_035787.1,41299159,41301471,41299159,41301471,111107655,XM_022442939.1,uncharacterized LOC111107655,2312
NC_035787.1,42247707,42251000,42247707,42251000,111107656,XM_022442940.1,uncharacterized LOC111107656,3293
NC_035787.1,40967389,40969408,40967389,40969408,111107657,XM_022442941.1,uncharacterized LOC111107657,2019
NC_035787.1,41049671,41053720,41049671,41053720,111107659,XM_022442942.1,uncharacterized LOC111107659,4049
NC_035787.1,42323217,42326636,42323217,42326636,111107660,XM_022442943.1,uncharacterized LOC111107660,3419
NC_035787.1,41056920,41275195,41262689,41275195,111107662,XM_022442947.1,uncharacterized LOC111107662,12506
NC_035787.1,41056920,41275195,41056921,41275195,111107662,XM_022442948.1,uncharacterized LOC111107662,218274
NC_035787.1,41056920,41275195,41056920,41275195,111107662,XM_022442946.1,uncharacterized LOC111107662,218275
NC_035787.1,41056920,41275195,41269565,41275195,111107662,XM_022442949.1,uncharacterized LOC111107662,5630
NC_035787.1,41056920,41275195,41268366,41275195,111107662,XM_022442951.1,uncharacterized LOC111107662,6829
NC_035787.1,41056920,41275195,41268362,41275195,111107662,XM_022442950.1,uncharacterized LOC111107662,6833
NC_035787.1,41095780,41393993,41095783,41393991,111107663,XM_022442953.1,uncharacterized LOC111107663,298208
NC_035787.1,41095780,41393993,41095780,41393993,111107663,XM_022442952.1,uncharacterized LOC111107663,298213
NC_035780.1,43833130,43837625,43833130,43837625,111107665,XM_022442959.1,uncharacterized LOC111107665,4495
NC_035787.1,42304353,42333271,42311587,42333264,111107666,XM_022442958.1,uncharacterized LOC111107666,21677
NC_035787.1,42304353,42333271,42311578,42333271,111107666,XM_022442955.1,uncharacterized LOC111107666,21693
NC_035787.1,42304353,42333271,42304353,42333271,111107666,XM_022442956.1,uncharacterized LOC111107666,28918
NC_035787.1,41098390,41111751,41098398,41111750,111107667,XM_022442961.1,uncharacterized LOC111107667,13352
NC_035787.1,41098390,41111751,41098390,41111751,111107667,XM_022442960.1,uncharacterized LOC111107667,13361
NC_035787.1,41098390,41111751,41103750,41111751,111107667,XM_022442962.1,uncharacterized LOC111107667,8001
NC_035787.1,41061061,41078577,41065898,41078577,111107668,XM_022442964.1,uncharacterized LOC111107668,12679
NC_035787.1,41061061,41078577,41061061,41078577,111107668,XM_022442963.1,uncharacterized LOC111107668,17516
NC_035787.1,41061061,41078577,41071786,41078577,111107668,XM_022442966.1,uncharacterized LOC111107668,6791
NC_035787.1,41061061,41078577,41070938,41078577,111107668,XM_022442965.1,uncharacterized LOC111107668,7639
NC_035787.1,42037675,42092960,42041197,42058737,111107669,XM_022442970.1,uncharacterized LOC111107669,17540
NC_035787.1,42037675,42092960,42051915,42092960,111107669,XM_022442973.1,uncharacterized LOC111107669,41045
NC_035787.1,42037675,42092960,42051082,42092960,111107669,XM_022442972.1,uncharacterized LOC111107669,41878
NC_035787.1,42037675,42092960,42045933,42092959,111107669,XM_022442968.1,uncharacterized LOC111107669,47026
NC_035787.1,42037675,42092960,42041207,42092710,111107669,XM_022442971.1,uncharacterized LOC111107669,51503
NC_035787.1,42037675,42092960,42041190,42092959,111107669,XM_022442967.1,uncharacterized LOC111107669,51769
NC_035787.1,42037675,42092960,42037675,42092959,111107669,XM_022442969.1,uncharacterized LOC111107669,55284
NC_035780.1,43853675,43864631,43853675,43864631,111107670,XM_022442974.1,uncharacterized LOC111107670,10956
NC_035787.1,42493710,42507128,42495231,42507126,111107671,XM_022442977.1,uncharacterized LOC111107671,11895
NC_035787.1,42493710,42507128,42493710,42507126,111107671,XM_022442976.1,uncharacterized LOC111107671,13416
NC_035787.1,42493710,42507128,42493710,42507128,111107671,XM_022442975.1,uncharacterized LOC111107671,13418
NC_035787.1,41699860,41714526,41702718,41714526,111107672,XM_022442979.1,uncharacterized LOC111107672,11808
NC_035787.1,41699860,41714526,41699865,41714526,111107672,XM_022442982.1,uncharacterized LOC111107672,14661
NC_035787.1,41699860,41714526,41699860,41714526,111107672,XM_022442978.1,uncharacterized LOC111107672,14666
NC_035787.1,42283104,42290661,42283734,42290661,111107673,XM_022442984.1,uncharacterized LOC111107673,6927
NC_035787.1,42283104,42290661,42283725,42290661,111107673,XM_022442985.1,uncharacterized LOC111107673,6936
NC_035787.1,42283104,42290661,42283104,42290660,111107673,XM_022442983.1,uncharacterized LOC111107673,7556
NC_035780.1,44000706,44003209,44000706,44003209,111107674,XM_022442988.1,uncharacterized LOC111107674,2503
NC_035787.1,42456485,42472742,42456490,42472739,111107675,XM_022442987.1,uncharacterized LOC111107675,16249
NC_035787.1,42456485,42472742,42456485,42472742,111107675,XM_022442986.1,uncharacterized LOC111107675,16257
NC_035787.1,41517457,41531046,41517457,41531046,111107676,XM_022442989.1,uncharacterized LOC111107676,13589
NC_035787.1,41209023,41230789,41209023,41224413,111107677,XM_022442991.1,uncharacterized LOC111107677,15390
NC_035787.1,41209023,41230789,41209023,41230784,111107677,XM_022442992.1,uncharacterized LOC111107677,21761
NC_035787.1,41209023,41230789,41209023,41230789,111107677,XM_022442990.1,uncharacterized LOC111107677,21766
NC_035787.1,41736983,41782670,41736990,41749868,111107678,XM_022442993.1,uncharacterized LOC111107678,12878
NC_035787.1,41736983,41782670,41736983,41782670,111107678,XM_022442994.1,uncharacterized LOC111107678,45687
NC_035787.1,41736983,41782670,41742330,41749868,111107678,XM_022442995.1,uncharacterized LOC111107678,7538
NC_035787.1,41337953,41353120,41337953,41353120,111107679,XM_022442996.1,uncharacterized LOC111107679,15167
NC_035787.1,41337953,41353120,41346427,41353115,111107679,XM_022442997.1,uncharacterized LOC111107679,6688
NC_035787.1,41425791,41459183,41425791,41459183,111107681,XM_022442998.1,uncharacterized LOC111107681,33392
NC_035787.1,41504087,41507873,41504087,41507873,111107683,XM_022443005.1,uncharacterized LOC111107683,3786
NC_035787.1,41915652,41925502,41915693,41925502,111107684,XM_022443008.1,uncharacterized LOC111107684,9809
NC_035787.1,41915652,41925502,41915652,41925502,111107684,XM_022443007.1,uncharacterized LOC111107684,9850
NC_035787.1,41302353,41319779,41302353,41319779,111107685,XM_022443009.1,uncharacterized LOC111107685,17426
NC_035780.1,44337415,44338074,44337415,44338074,111107687,XM_022443014.1,uncharacterized LOC111107687,659
NC_035787.1,41863481,41869336,41863481,41869336,111107688,XM_022443011.1,uncharacterized LOC111107688,5855
NC_035787.1,41647540,41649962,41647540,41649962,111107689,XM_022443012.1,uncharacterized LOC111107689,2422
NC_035787.1,41166913,41201440,41166913,41201440,111107690,XM_022443013.1,uncharacterized LOC111107690,34527
NC_035787.1,40998054,41001231,40998054,41001231,111107691,XM_022443015.1,uncharacterized LOC111107691,3177
NC_035787.1,41244882,41246596,41244882,41246596,111107692,XM_022443016.1,uncharacterized LOC111107692,1714
NC_035787.1,41851022,41862749,41851022,41862749,111107693,XM_022443017.1,uncharacterized LOC111107693,11727
NC_035787.1,42103875,42105568,42103875,42105568,111107694,XM_022443018.1,uncharacterized LOC111107694,1693
NC_035787.1,41358694,41362255,41359536,41362255,111107697,XM_022443022.1,uncharacterized LOC111107697,2719
NC_035787.1,41115719,41133991,41115719,41133991,111107698,XM_022443025.1,uncharacterized LOC111107698,18272
NC_035787.1,41115719,41133991,41130431,41133991,111107698,XM_022443024.1,uncharacterized LOC111107698,3560
NC_035787.1,42075550,42080625,42075550,42080625,111107700,XM_022443027.1,uncharacterized LOC111107700,5075
NC_035787.1,12030395,12031136,12030395,12031136,111107707,XM_022443028.1,uncharacterized LOC111107707,741
NC_035787.1,12330891,12332000,12330891,12332000,111107710,XM_022443031.1,uncharacterized LOC111107710,1109
NC_035787.1,12328326,12338826,12328326,12338826,111107711,XM_022443032.1,uncharacterized LOC111107711,10500
NC_035787.1,12368119,12369929,12368119,12369929,111107713,XM_022443034.1,uncharacterized LOC111107713,1810
NC_035787.1,12428233,12430147,12428233,12430147,111107714,XM_022443035.1,uncharacterized LOC111107714,1914
NC_035787.1,12582269,12589465,12582269,12589465,111107718,XM_022443043.1,uncharacterized LOC111107718,7196
NC_035787.1,12805713,12808411,12805713,12808411,111107720,XM_022443045.1,uncharacterized LOC111107720,2698
NC_035787.1,12814085,12826633,12814085,12826633,111107721,XM_022443046.1,uncharacterized LOC111107721,12548
NC_035787.1,57453078,57489177,57471022,57489177,111107722,XM_022443047.1,uncharacterized LOC111107722,18155
NC_035787.1,57453078,57489177,57453078,57489177,111107722,XM_022443048.1,uncharacterized LOC111107722,36099
NC_035787.1,12871155,12880369,12871155,12880369,111107724,XM_022443049.1,uncharacterized LOC111107724,9214
NC_035787.1,12883289,12886908,12883289,12886908,111107725,XM_022443050.1,uncharacterized LOC111107725,3619
NC_035780.1,45181843,45186013,45181843,45186013,111107729,XM_022443063.1,uncharacterized LOC111107729,4170
NC_035787.1,13266395,13270936,13266395,13270936,111107730,XM_022443062.1,uncharacterized LOC111107730,4541
NC_035780.1,45186546,45187136,45186546,45187136,111107732,XM_022443077.1,uncharacterized LOC111107732,590
NC_035787.1,13391496,13400057,13391496,13400057,111107733,XM_022443075.1,uncharacterized LOC111107733,8561
NC_035787.1,6878915,6886269,6878915,6886269,111107734,XM_022443076.1,uncharacterized LOC111107734,7354
NC_035787.1,6859240,6869080,6859240,6869080,111107735,XM_022443078.1,uncharacterized LOC111107735,9840
NC_035787.1,6930491,6948264,6930491,6948264,111107737,XM_022443079.1,uncharacterized LOC111107737,17773
NC_035787.1,6956634,6963009,6956634,6963009,111107738,XM_022443081.1,uncharacterized LOC111107738,6375
NC_035787.1,6900172,6909216,6900172,6907021,111107739,XM_022443084.1,uncharacterized LOC111107739,6849
NC_035787.1,6900172,6909216,6900172,6907107,111107739,XM_022443085.1,uncharacterized LOC111107739,6935
NC_035787.1,6900172,6909216,6900172,6909214,111107739,XM_022443083.1,uncharacterized LOC111107739,9042
NC_035787.1,6900172,6909216,6900172,6909216,111107739,XM_022443086.1,uncharacterized LOC111107739,9044
NC_035780.1,45187943,45205037,45187943,45205037,111107740,XM_022443088.1,uncharacterized LOC111107740,17094
NC_035787.1,6873683,6875353,6873683,6875353,111107741,XM_022443087.1,uncharacterized LOC111107741,1670
NC_035787.1,13542148,13547185,13542148,13547185,111107745,XM_022443089.1,uncharacterized LOC111107745,5037
NC_035787.1,65180001,65182702,65180001,65182702,111107747,XM_022443090.1,uncharacterized LOC111107747,2701
NC_035787.1,6065865,6155636,6065865,6155636,111107758,XM_022443102.1,uncharacterized LOC111107758,89771
NC_035780.1,45946655,45949811,45946655,45949811,111107761,XM_022443109.1,uncharacterized LOC111107761,3156
NC_035787.1,13679331,13679876,13679331,13679876,111107762,XM_022443106.1,uncharacterized LOC111107762,545
NC_035787.1,13572464,13581884,13572464,13581884,111107763,XM_022443107.1,uncharacterized LOC111107763,9420
NC_035787.1,13683759,13687727,13683759,13687727,111107766,XM_022443113.1,uncharacterized LOC111107766,3968
NC_035787.1,13761554,13763962,13761554,13763962,111107769,XM_022443117.1,uncharacterized LOC111107769,2408
NC_035787.1,13788579,13789340,13788579,13789340,111107771,XM_022443118.1,uncharacterized LOC111107771,761
NC_035787.1,13831820,13837001,13831820,13837001,111107772,XM_022443119.1,uncharacterized LOC111107772,5181
NC_035787.1,14247137,14248390,14247137,14248390,111107773,XM_022443120.1,uncharacterized LOC111107773,1253
NC_035787.1,14307064,14311525,14307064,14311525,111107774,XM_022443122.1,uncharacterized LOC111107774,4461
NC_035787.1,53656938,53688555,53656938,53688555,111107775,XM_022443123.1,uncharacterized LOC111107775,31617
NC_035787.1,14610092,14612222,14610092,14612222,111107776,XM_022443124.1,uncharacterized LOC111107776,2130
NC_035787.1,14911715,14952652,14911715,14952652,111107777,XM_022443125.1,uncharacterized LOC111107777,40937
NC_035780.1,46660786,46667861,46660786,46667861,111107780,XM_022443131.1,uncharacterized LOC111107780,7075
NC_035787.1,15151492,15155482,15151492,15155482,111107782,XM_022443130.1,uncharacterized LOC111107782,3990
NC_035787.1,15535158,15537570,15535158,15537570,111107783,XM_022443132.1,uncharacterized LOC111107783,2412
NC_035787.1,6217928,6219301,6217928,6219301,111107784,XM_022443133.1,uncharacterized LOC111107784,1373
NC_035787.1,6180298,6194114,6180298,6194114,111107785,XM_022443134.1,uncharacterized LOC111107785,13816
NC_035787.1,14254617,14265693,14254617,14265684,111107786,XM_022443135.1,uncharacterized LOC111107786,11067
NC_035787.1,14254617,14265693,14254617,14265693,111107786,XM_022443137.1,uncharacterized LOC111107786,11076
NC_035787.1,14254617,14265693,14254617,14256593,111107786,XM_022443138.1,uncharacterized LOC111107786,1976
NC_035787.1,14254617,14265693,14254617,14256702,111107786,XM_022443136.1,uncharacterized LOC111107786,2085
NC_035787.1,14263658,14265358,14263658,14265358,111107788,XM_022443139.1,uncharacterized LOC111107788,1700
NC_035780.1,23484962,23485975,23484962,23485975,111107793,XM_022443188.1,uncharacterized LOC111107793,1013
NC_035787.1,17704440,17707212,17704440,17707212,111107801,XM_022443159.1,uncharacterized LOC111107801,2772
NC_035787.1,17781133,17784359,17781133,17784359,111107803,XM_022443161.1,uncharacterized LOC111107803,3226
NC_035787.1,17723858,17725410,17723858,17725410,111107804,XM_022443162.1,uncharacterized LOC111107804,1552
NC_035787.1,15520302,15526903,15520303,15522634,111107805,XM_022443166.1,uncharacterized LOC111107805,2331
NC_035787.1,15520302,15526903,15520302,15526903,111107805,XM_022443165.1,uncharacterized LOC111107805,6601
NC_035787.1,15559743,15578052,15559743,15578052,111107806,XM_022443167.1,uncharacterized LOC111107806,18309
NC_035787.1,15540839,15551648,15540839,15551648,111107807,XM_022443168.1,uncharacterized LOC111107807,10809
NC_035787.1,15509505,15517224,15509505,15517224,111107811,XM_022443173.1,uncharacterized LOC111107811,7719
NC_035787.1,40003398,40005628,40003398,40005628,111107817,XM_022443181.1,uncharacterized LOC111107817,2230
NC_035787.1,39983925,39986271,39983925,39986271,111107818,XM_022443182.1,uncharacterized LOC111107818,2346
NC_035787.1,40027820,40030384,40027820,40030384,111107819,XM_022443183.1,uncharacterized LOC111107819,2564
NC_035780.1,47687922,47707031,47687922,47707031,111107820,XM_022443189.1,uncharacterized LOC111107820,19109
NC_035787.1,40116195,40118650,40116195,40118650,111107821,XM_022443184.1,uncharacterized LOC111107821,2455
NC_035787.1,40001513,40033597,40017265,40030873,111107822,XM_022443187.1,uncharacterized LOC111107822,13608
NC_035787.1,40001513,40033597,40017265,40030877,111107822,XM_022443185.1,uncharacterized LOC111107822,13612
NC_035787.1,40001513,40033597,40017265,40033597,111107822,XM_022443186.1,uncharacterized LOC111107822,16332
NC_035787.1,40001513,40033597,40001513,40030878,111107822,XM_022443190.1,uncharacterized LOC111107822,29365
NC_035787.1,40001513,40033597,40017265,40024932,111107822,XM_022443191.1,uncharacterized LOC111107822,7667
NC_035787.1,40081665,40095527,40081665,40095527,111107823,XM_022443192.1,uncharacterized LOC111107823,13862
NC_035787.1,40081665,40095527,40081665,40089195,111107823,XM_022443194.1,uncharacterized LOC111107823,7530
NC_035787.1,40081665,40095527,40081665,40089276,111107823,XM_022443193.1,uncharacterized LOC111107823,7611
NC_035787.1,40142698,40149391,40142698,40149391,111107824,XM_022443196.1,uncharacterized LOC111107824,6693
NC_035780.1,47710211,47717204,47710211,47717204,111107825,XM_022443199.1,uncharacterized LOC111107825,6993
NC_035787.1,51413071,51438928,51413071,51438928,111107827,XM_022443198.1,uncharacterized LOC111107827,25857
NC_035787.1,12354411,12358770,12354411,12358770,111107828,XM_022443208.1,uncharacterized LOC111107828,4359
NC_035780.1,47721347,47722802,47721347,47722802,111107829,XM_022443213.1,uncharacterized LOC111107829,1455
NC_035787.1,12345625,12349776,12345625,12349776,111107830,XM_022443209.1,uncharacterized LOC111107830,4151
NC_035787.1,12371340,12374019,12371340,12374019,111107831,XM_022443210.1,uncharacterized LOC111107831,2679
NC_035787.1,4820567,4850006,4821028,4850006,111107834,XM_022443219.1,uncharacterized LOC111107834,28978
NC_035787.1,4820567,4850006,4820567,4849850,111107834,XM_022443218.1,uncharacterized LOC111107834,29283
NC_035787.1,4855900,4866890,4855900,4866890,111107835,XM_022443221.1,uncharacterized LOC111107835,10990
NC_035780.1,47844765,47850352,47844765,47850352,111107836,XM_022443224.1,uncharacterized LOC111107836,5587
NC_035787.1,4825243,4830793,4825243,4829694,111107837,XM_022443222.1,uncharacterized LOC111107837,4451
NC_035787.1,4825243,4830793,4825243,4830793,111107837,XM_022443223.1,uncharacterized LOC111107837,5550
NC_035787.1,68861282,68894598,68861282,68894598,111107843,XM_022443228.1,uncharacterized LOC111107843,33316
NC_035787.1,19037729,19047598,19040254,19047598,111107845,XM_022443232.1,uncharacterized LOC111107845,7344
NC_035787.1,19037729,19047598,19037729,19047598,111107845,XM_022443231.1,uncharacterized LOC111107845,9869
NC_035780.1,48119435,48131383,48119435,48131383,111107853,XM_022443249.1,uncharacterized LOC111107853,11948
NC_035787.1,71755757,71770982,71755757,71770982,111107860,XM_022443259.1,uncharacterized LOC111107860,15225
NC_035780.1,48599552,48600559,48599552,48600559,111107867,XM_022443304.1,uncharacterized LOC111107867,1007
NC_035780.1,49343965,49348096,49343965,49348096,111107868,XM_022443272.1,uncharacterized LOC111107868,4131
NC_035787.1,55266572,55268678,55266572,55268678,111107874,XM_022443275.1,uncharacterized LOC111107874,2106
NC_035787.1,55249107,55251161,55249107,55251161,111107875,XM_022443276.1,uncharacterized LOC111107875,2054
NC_035787.1,55254372,55258048,55254372,55258048,111107876,XM_022443277.1,uncharacterized LOC111107876,3676
NC_035787.1,29120029,29126570,29120029,29126570,111107883,XM_022443284.1,uncharacterized LOC111107883,6541
NC_035787.1,29224337,29258454,29224337,29258454,111107886,XM_022443288.1,uncharacterized LOC111107886,34117
NC_035780.1,49623735,49628286,49623735,49628286,111107887,XM_022443292.1,uncharacterized LOC111107887,4551
NC_035780.1,49629285,49631664,49629285,49631664,111107898,XM_022443305.1,uncharacterized LOC111107898,2379
NC_035780.1,49767978,49769825,49767978,49769825,111107908,XM_022443315.1,uncharacterized LOC111107908,1847
NC_035787.1,47893528,47895808,47893528,47895808,111107909,XM_022443314.1,uncharacterized LOC111107909,2280
NC_035780.1,49770905,49782755,49770905,49782755,111107914,XM_022443330.1,uncharacterized LOC111107914,11850
NC_035780.1,50400983,50403488,50400983,50403488,111107918,XM_022443343.1,uncharacterized LOC111107918,2505
NC_035787.1,21115940,21116860,21115940,21116860,111107919,XM_022443350.1,uncharacterized LOC111107919,920
NC_035787.1,45947239,45953707,45947239,45953707,111107921,XM_022443351.1,uncharacterized LOC111107921,6468
NC_035787.1,58974009,58981046,58975181,58981046,111107923,XM_022443352.1,uncharacterized LOC111107923,5865
NC_035787.1,58974009,58981046,58974085,58981046,111107923,XM_022443354.1,uncharacterized LOC111107923,6961
NC_035787.1,58974009,58981046,58974009,58981046,111107923,XM_022443353.1,uncharacterized LOC111107923,7037
NC_035787.1,43166247,43188482,43166247,43180052,111107927,XM_022443366.1,uncharacterized LOC111107927,13805
NC_035787.1,43166247,43188482,43166247,43188482,111107927,XM_022443367.1,uncharacterized LOC111107927,22235
NC_035787.1,43235528,43250853,43235528,43250853,111107929,XM_022443368.1,uncharacterized LOC111107929,15325
NC_035787.1,43574051,43581569,43574755,43581569,111107930,XM_022443372.1,uncharacterized LOC111107930,6814
NC_035787.1,43574051,43581569,43574051,43581569,111107930,XM_022443369.1,uncharacterized LOC111107930,7518
NC_035787.1,42995467,43494006,42995473,43012552,111107933,XM_022443385.1,uncharacterized LOC111107933,17079
NC_035787.1,42995467,43494006,42995473,43013213,111107933,XM_022443375.1,uncharacterized LOC111107933,17740
NC_035787.1,42995467,43494006,42995473,43013300,111107933,XM_022443379.1,uncharacterized LOC111107933,17827
NC_035787.1,42995467,43494006,42995472,43013300,111107933,XM_022443381.1,uncharacterized LOC111107933,17828
NC_035787.1,42995467,43494006,42995471,43013300,111107933,XM_022443378.1,uncharacterized LOC111107933,17829
NC_035787.1,42995467,43494006,42995470,43013300,111107933,XM_022443391.1,uncharacterized LOC111107933,17830
NC_035787.1,42995467,43494006,42995470,43013301,111107933,XM_022443388.1,uncharacterized LOC111107933,17831
NC_035787.1,42995467,43494006,42995468,43013300,111107933,XM_022443390.1,uncharacterized LOC111107933,17832
NC_035787.1,42995467,43494006,42995467,43013300,111107933,XM_022443389.1,uncharacterized LOC111107933,17833
NC_035787.1,42995467,43494006,42995473,43013372,111107933,XM_022443376.1,uncharacterized LOC111107933,17899
NC_035787.1,42995467,43494006,42995473,43022296,111107933,XM_022443386.1,uncharacterized LOC111107933,26823
NC_035787.1,42995467,43494006,43009879,43013301,111107933,XM_022443392.1,uncharacterized LOC111107933,3422
NC_035787.1,42995467,43494006,42995473,43494006,111107933,XM_022443387.1,uncharacterized LOC111107933,498533
NC_035787.1,42969006,42982466,42969006,42982466,111107935,XM_022443395.1,uncharacterized LOC111107935,13460
NC_035787.1,42969006,42982466,42969006,42975020,111107935,XM_022443394.1,uncharacterized LOC111107935,6014
NC_035787.1,42969006,42982466,42969006,42975271,111107935,XM_022443393.1,uncharacterized LOC111107935,6265
NC_035780.1,22866021,22876577,22866021,22876433,111107936,XM_022443495.1,uncharacterized LOC111107936,10412
NC_035780.1,22866021,22876577,22866021,22876577,111107936,XM_022443571.1,uncharacterized LOC111107936,10556
NC_035787.1,43551221,43565074,43551221,43565074,111107938,XM_022443397.1,uncharacterized LOC111107938,13853
NC_035787.1,43551221,43565074,43551221,43560274,111107938,XM_022443399.1,uncharacterized LOC111107938,9053
NC_035787.1,43551221,43565074,43551221,43561207,111107938,XM_022443400.1,uncharacterized LOC111107938,9986
NC_035787.1,43490335,43492437,43490335,43492437,111107941,XM_022443404.1,uncharacterized LOC111107941,2102
NC_035787.1,43612188,43614119,43612188,43614119,111107946,XM_022443409.1,uncharacterized LOC111107946,1931
NC_035787.1,43590426,43591981,43590426,43591981,111107948,XM_022443412.1,uncharacterized LOC111107948,1555
NC_035787.1,43030438,43122082,43030438,43046178,111107949,XM_022443415.1,uncharacterized LOC111107949,15740
NC_035787.1,43030438,43122082,43030438,43122082,111107949,XM_022443414.1,uncharacterized LOC111107949,91644
NC_035787.1,43513105,43523934,43520204,43523934,111107953,XM_022443418.1,uncharacterized LOC111107953,3730
NC_035787.1,43297758,43299411,43297758,43299411,111107954,XM_022443420.1,uncharacterized LOC111107954,1653
NC_035787.1,75100223,75105859,75100223,75105859,111107967,XM_022443424.1,uncharacterized LOC111107967,5636
NC_035780.1,52631779,52635062,52631779,52635062,111107969,XM_022443430.1,uncharacterized LOC111107969,3283
NC_035787.1,27013175,27023390,27013175,27023390,111107970,XM_022443428.1,uncharacterized LOC111107970,10215
NC_035787.1,26979034,26985071,26979034,26985071,111107971,XM_022443429.1,uncharacterized LOC111107971,6037
NC_035787.1,26925330,26931173,26925330,26931173,111107972,XM_022443431.1,uncharacterized LOC111107972,5843
NC_035787.1,49223556,49238791,49223556,49238791,111107976,XM_022443433.1,uncharacterized LOC111107976,15235
NC_035787.1,49223556,49238791,49223556,49232527,111107976,XM_022443434.1,uncharacterized LOC111107976,8971
NC_035787.1,10923343,10925456,10923343,10925451,111107978,XM_022443436.1,uncharacterized LOC111107978,2108
NC_035787.1,10923343,10925456,10923343,10925456,111107978,XM_022443437.1,uncharacterized LOC111107978,2113
NC_035780.1,52751416,52752420,52751416,52752420,111107979,XM_022443440.1,uncharacterized LOC111107979,1004
NC_035787.1,10966316,10969187,10966316,10969187,111107980,XM_022443438.1,uncharacterized LOC111107980,2871
NC_035787.1,10909818,10912047,10909818,10912047,111107981,XM_022443439.1,uncharacterized LOC111107981,2229
NC_035787.1,10823333,10825343,10823333,10825343,111107983,XM_022443444.1,uncharacterized LOC111107983,2010
NC_035787.1,10830520,10832838,10830520,10832838,111107984,XM_022443445.1,uncharacterized LOC111107984,2318
NC_035780.1,52764106,52783643,52764106,52783643,111107987,XM_022443453.1,uncharacterized LOC111107987,19537
NC_035787.1,10888741,10893956,10888741,10893956,111107988,XM_022443450.1,uncharacterized LOC111107988,5215
NC_035787.1,10963747,10965492,10963747,10965492,111107989,XM_022443451.1,uncharacterized LOC111107989,1745
NC_035787.1,10858671,10875675,10858671,10875675,111107990,XM_022443452.1,uncharacterized LOC111107990,17004
NC_035787.1,10814010,10821770,10814010,10820165,111107991,XM_022443455.1,uncharacterized LOC111107991,6155
NC_035787.1,10814010,10821770,10814010,10821770,111107991,XM_022443454.1,uncharacterized LOC111107991,7760
NC_035787.1,10815009,10840394,10838274,10840394,111107992,XM_022443458.1,uncharacterized LOC111107992,2120
NC_035787.1,10815009,10840394,10815009,10840394,111107992,XM_022443457.1,uncharacterized LOC111107992,25385
NC_035787.1,10815009,10840394,10833499,10840394,111107992,XM_022443456.1,uncharacterized LOC111107992,6895
NC_035787.1,73844377,73881560,73844378,73858254,111107993,XM_022443463.1,uncharacterized LOC111107993,13876
NC_035787.1,73844377,73881560,73844379,73863082,111107993,XM_022443466.1,uncharacterized LOC111107993,18703
NC_035787.1,73844377,73881560,73844379,73867100,111107993,XM_022443465.1,uncharacterized LOC111107993,22721
NC_035787.1,73844377,73881560,73844379,73873730,111107993,XM_022443468.1,uncharacterized LOC111107993,29351
NC_035787.1,73844377,73881560,73844379,73875729,111107993,XM_022443464.1,uncharacterized LOC111107993,31350
NC_035787.1,73844377,73881560,73844378,73881559,111107993,XM_022443462.1,uncharacterized LOC111107993,37181
NC_035787.1,73844377,73881560,73844377,73881560,111107993,XM_022443461.1,uncharacterized LOC111107993,37183
NC_035787.1,73844377,73881560,73844377,73850581,111107993,XM_022443469.1,uncharacterized LOC111107993,6204
NC_035787.1,43765024,43771632,43768541,43771632,111107997,XM_022443473.1,uncharacterized LOC111107997,3091
NC_035780.1,52943885,52965858,52943885,52965858,111107999,XM_022443477.1,uncharacterized LOC111107999,21973
NC_035780.1,53283110,53288914,53283110,53288914,111108008,XM_022443485.1,uncharacterized LOC111108008,5804
NC_035787.1,45319043,45341271,45330221,45341271,111108010,XM_022443488.1,uncharacterized LOC111108010,11050
NC_035787.1,45319043,45341271,45323156,45341271,111108010,XM_022443486.1,uncharacterized LOC111108010,18115
NC_035787.1,45319043,45341271,45322042,45341271,111108010,XM_022443487.1,uncharacterized LOC111108010,19229
NC_035787.1,45319043,45341271,45319725,45341271,111108010,XM_022443484.1,uncharacterized LOC111108010,21546
NC_035787.1,45319043,45341271,45319043,45341271,111108010,XM_022443483.1,uncharacterized LOC111108010,22228
NC_035787.1,45319043,45341271,45333552,45341271,111108010,XM_022443489.1,uncharacterized LOC111108010,7719
NC_035787.1,34718383,34727957,34718383,34727957,111108013,XM_022443494.1,uncharacterized LOC111108013,9574
NC_035787.1,30739051,30741614,30739929,30741614,111108016,XM_022443499.1,uncharacterized LOC111108016,1685
NC_035787.1,30739051,30741614,30739060,30741614,111108016,XM_022443497.1,uncharacterized LOC111108016,2554
NC_035787.1,30739051,30741614,30739051,30741614,111108016,XM_022443498.1,uncharacterized LOC111108016,2563
NC_035787.1,30741588,30743399,30741588,30743399,111108017,XM_022443500.1,uncharacterized LOC111108017,1811
NC_035787.1,30747346,30750525,30748692,30750525,111108018,XM_022443502.1,uncharacterized LOC111108018,1833
NC_035787.1,30747346,30750525,30747346,30750525,111108018,XM_022443501.1,uncharacterized LOC111108018,3179
NC_035787.1,55209408,55212096,55209408,55212096,111108025,XM_022443514.1,uncharacterized LOC111108025,2688
NC_035787.1,11815503,11874007,11823711,11874007,111108026,XM_022443515.1,uncharacterized LOC111108026,50296
NC_035787.1,11815503,11874007,11815503,11874007,111108026,XM_022443516.1,uncharacterized LOC111108026,58504
NC_035787.1,2075498,2076842,2075498,2076842,111108031,XM_022443521.1,uncharacterized LOC111108031,1344
NC_035780.1,53652830,53658057,53652830,53658057,111108039,XM_022443529.1,uncharacterized LOC111108039,5227
NC_035787.1,18583565,18585838,18583565,18585838,111108040,XM_022443526.1,uncharacterized LOC111108040,2273
NC_035787.1,18612669,18614766,18612669,18614766,111108041,XM_022443527.1,uncharacterized LOC111108041,2097
NC_035787.1,61651811,61669266,61651811,61669266,111108042,XM_022443528.1,uncharacterized LOC111108042,17455
NC_035787.1,22689566,22692831,22690220,22692831,111108045,XM_022443535.1,uncharacterized LOC111108045,2611
NC_035787.1,22689566,22692831,22689566,22692831,111108045,XM_022443534.1,uncharacterized LOC111108045,3265
NC_035787.1,22618891,22663690,22618891,22663690,111108046,XM_022443539.1,uncharacterized LOC111108046,44799
NC_035787.1,22618891,22663690,22618891,22624541,111108046,XM_022443537.1,uncharacterized LOC111108046,5650
NC_035787.1,22618891,22663690,22618891,22625329,111108046,XM_022443538.1,uncharacterized LOC111108046,6438
NC_035787.1,22706570,22723983,22706570,22723862,111108048,XM_022443542.1,uncharacterized LOC111108048,17292
NC_035787.1,22706570,22723983,22706570,22723983,111108048,XM_022443540.1,uncharacterized LOC111108048,17413
NC_035787.1,45346393,45383516,45349123,45383516,111108050,XM_022443548.1,uncharacterized LOC111108050,34393
NC_035787.1,45346393,45383516,45349059,45383516,111108050,XM_022443550.1,uncharacterized LOC111108050,34457
NC_035787.1,45346393,45383516,45348923,45383516,111108050,XM_022443549.1,uncharacterized LOC111108050,34593
NC_035787.1,45346393,45383516,45346393,45383024,111108050,XM_022443547.1,uncharacterized LOC111108050,36631
NC_035787.1,45346393,45383516,45346393,45383516,111108050,XM_022443544.1,uncharacterized LOC111108050,37123
NC_035787.1,33551432,33584921,33551432,33584921,111108065,XM_022443586.1,uncharacterized LOC111108065,33489
NC_035787.1,33606548,33640461,33606548,33638565,111108066,XM_022443588.1,uncharacterized LOC111108066,32017
NC_035787.1,33606548,33640461,33606548,33640461,111108066,XM_022443587.1,uncharacterized LOC111108066,33913
NC_035787.1,33720990,33722275,33720990,33722275,111108073,XM_022443596.1,uncharacterized LOC111108073,1285
NC_035787.1,32130318,32157696,32130318,32157696,111108083,XM_022443605.1,uncharacterized LOC111108083,27378
NC_035787.1,34299142,34325067,34299142,34314093,111108091,XM_022443648.1,uncharacterized LOC111108091,14951
NC_035787.1,34299142,34325067,34299142,34325067,111108091,XM_022443650.1,uncharacterized LOC111108091,25925
NC_035787.1,34299142,34325067,34299142,34307875,111108091,XM_022443647.1,uncharacterized LOC111108091,8733
NC_035787.1,34248399,34257372,34248399,34256407,111108092,XM_022443652.1,uncharacterized LOC111108092,8008
NC_035787.1,34248399,34257372,34248399,34256577,111108092,XM_022443653.1,uncharacterized LOC111108092,8178
NC_035787.1,34248399,34257372,34248399,34257372,111108092,XM_022443651.1,uncharacterized LOC111108092,8973
NC_035780.1,54803182,54804324,54803182,54804324,111108093,XM_022443660.1,uncharacterized LOC111108093,1142
NC_035787.1,34259988,34293137,34259990,34276797,111108094,XM_022443659.1,uncharacterized LOC111108094,16807
NC_035787.1,34259988,34293137,34259990,34285604,111108094,XM_022443661.1,uncharacterized LOC111108094,25614
NC_035787.1,34259988,34293137,34259990,34289126,111108094,XM_022443658.1,uncharacterized LOC111108094,29136
NC_035787.1,34259988,34293137,34259988,34289139,111108094,XM_022443663.1,uncharacterized LOC111108094,29151
NC_035787.1,34259988,34293137,34259989,34293137,111108094,XM_022443662.1,uncharacterized LOC111108094,33148
NC_035787.1,36312862,36318127,36312862,36318127,111108096,XM_022443665.1,uncharacterized LOC111108096,5265
NC_035780.1,55017124,55018914,55017124,55018914,111108109,XM_022443682.1,uncharacterized LOC111108109,1790
NC_035787.1,52062126,52081770,52062126,52081770,111108110,XM_022443679.1,uncharacterized LOC111108110,19644
NC_035787.1,28925989,28931171,28925989,28931171,111108111,XM_022443680.1,uncharacterized LOC111108111,5182
NC_035787.1,17894924,17897986,17894924,17897986,111108115,XM_022443686.1,uncharacterized LOC111108115,3062
NC_035787.1,17898274,17901501,17898274,17901501,111108117,XM_022443690.1,uncharacterized LOC111108117,3227
NC_035787.1,56300275,56346991,56300281,56311978,111108120,XM_022443693.1,uncharacterized LOC111108120,11697
NC_035787.1,56300275,56346991,56300275,56311978,111108120,XM_022443694.1,uncharacterized LOC111108120,11703
NC_035787.1,56300275,56346991,56300277,56346991,111108120,XM_022443695.1,uncharacterized LOC111108120,46714
NC_035787.1,56300275,56346991,56340225,56346991,111108120,XM_022443696.1,uncharacterized LOC111108120,6766
NC_035780.1,55139458,55140063,55139458,55140063,111108122,XM_022443709.1,uncharacterized LOC111108122,605
NC_035787.1,71304521,71308165,71304521,71308165,111108123,XM_022443711.1,uncharacterized LOC111108123,3644
NC_035787.1,54921051,54944178,54921051,54943151,111108126,XM_022443729.1,uncharacterized LOC111108126,22100
NC_035787.1,54921051,54944178,54921051,54944178,111108126,XM_022443728.1,uncharacterized LOC111108126,23127
NC_035787.1,55123920,55131057,55123996,55131057,111108127,XM_022443731.1,uncharacterized LOC111108127,7061
NC_035787.1,55123920,55131057,55123920,55131057,111108127,XM_022443730.1,uncharacterized LOC111108127,7137
NC_035780.1,55219368,55220282,55219368,55220282,111108130,XM_022443737.1,uncharacterized LOC111108130,914
NC_035787.1,1861087,1862482,1861087,1862482,111108131,XM_022443734.1,uncharacterized LOC111108131,1395
NC_035787.1,37111945,37114872,37111945,37114872,111108135,XM_022443738.1,uncharacterized LOC111108135,2927
NC_035787.1,37223186,37225429,37223226,37225429,111108136,XM_022443739.1,uncharacterized LOC111108136,2203
NC_035787.1,37223186,37225429,37223186,37225429,111108136,XM_022443740.1,uncharacterized LOC111108136,2243
NC_035787.1,37177539,37191828,37177539,37191828,111108140,XM_022443748.1,uncharacterized LOC111108140,14289
NC_035787.1,73677511,73692403,73677511,73692402,111108147,XM_022443760.1,uncharacterized LOC111108147,14891
NC_035787.1,73677511,73692403,73677511,73692403,111108147,XM_022443759.1,uncharacterized LOC111108147,14892
NC_035787.1,74893498,74896368,74893498,74896368,111108152,XM_022443769.1,uncharacterized LOC111108152,2870
NC_035787.1,74968194,74972895,74968194,74972895,111108153,XM_022443770.1,uncharacterized LOC111108153,4701
NC_035787.1,74982543,74983815,74982543,74983815,111108154,XM_022443771.1,uncharacterized LOC111108154,1272
NC_035787.1,74939095,74940818,74939095,74940818,111108155,XM_022443773.1,uncharacterized LOC111108155,1723
NC_035787.1,32335493,32391832,32335493,32391832,111108160,XM_022443774.1,uncharacterized LOC111108160,56339
NC_035787.1,10543452,10548107,10543452,10548107,111108166,XM_022443789.1,uncharacterized LOC111108166,4655
NC_035787.1,9151136,9209813,9151136,9202357,111108169,XM_022443801.1,uncharacterized LOC111108169,51221
NC_035787.1,9151136,9209813,9151136,9208276,111108169,XM_022443803.1,uncharacterized LOC111108169,57140
NC_035787.1,9151136,9209813,9151136,9209813,111108169,XM_022443802.1,uncharacterized LOC111108169,58677
NC_035787.1,15296601,15318050,15296601,15311885,111108172,XM_022443806.1,uncharacterized LOC111108172,15284
NC_035787.1,15296601,15318050,15296601,15318050,111108172,XM_022443807.1,uncharacterized LOC111108172,21449
NC_035787.1,15322184,15342649,15322184,15342649,111108173,XM_022443809.1,uncharacterized LOC111108173,20465
NC_035787.1,60383450,60401982,60383450,60401982,111108177,XM_022443816.1,uncharacterized LOC111108177,18532
NC_035787.1,33482604,33539584,33482604,33539584,111108186,XM_022443851.1,uncharacterized LOC111108186,56980
NC_035787.1,7137628,7156564,7137628,7156564,111108191,XM_022443859.1,uncharacterized LOC111108191,18936
NC_035787.1,48376366,48379632,48376366,48379632,111108203,XM_022443880.1,uncharacterized LOC111108203,3266
NC_035780.1,57091869,57099248,57091869,57099248,111108205,XM_022443888.1,uncharacterized LOC111108205,7379
NC_035787.1,17406352,17420194,17406352,17420194,111108211,XM_022443893.1,uncharacterized LOC111108211,13842
NC_035780.1,57195552,57196250,57195552,57196250,111108213,XM_022443902.1,uncharacterized LOC111108213,698
NC_035780.1,57668613,57675518,57668613,57675518,111108214,XM_022443919.1,uncharacterized LOC111108214,6905
NC_035787.1,51402619,51411093,51405123,51411093,111108218,XM_022443952.1,uncharacterized LOC111108218,5970
NC_035787.1,51402619,51411093,51404872,51411093,111108218,XM_022443953.1,uncharacterized LOC111108218,6221
NC_035787.1,51402619,51411093,51402686,51411093,111108218,XM_022443951.1,uncharacterized LOC111108218,8407
NC_035787.1,51402619,51411093,51402619,51411093,111108218,XM_022443949.1,uncharacterized LOC111108218,8474
NC_035787.1,45209721,45240833,45209721,45240833,111108225,XM_022443965.1,uncharacterized LOC111108225,31112
NC_035787.1,13487268,13516521,13487296,13516521,111108228,XM_022443972.1,uncharacterized LOC111108228,29225
NC_035787.1,13487268,13516521,13487268,13516521,111108228,XM_022443971.1,uncharacterized LOC111108228,29253
NC_035787.1,26344812,26371994,26344812,26371994,111108236,XM_022443985.1,uncharacterized LOC111108236,27182
NC_035787.1,72449067,72472942,72449067,72472942,111108238,XM_022443987.1,uncharacterized LOC111108238,23875
NC_035787.1,72472097,72483293,72472097,72483293,111108240,XM_022443989.1,uncharacterized LOC111108240,11196
NC_035787.1,72472097,72483293,72480213,72483293,111108240,XM_022443990.1,uncharacterized LOC111108240,3080
NC_035787.1,56534171,56540310,56534171,56540310,111108247,XM_022444002.1,uncharacterized LOC111108247,6139
NC_035787.1,29673823,29702362,29674343,29702362,111108248,XM_022444010.1,uncharacterized LOC111108248,28019
NC_035787.1,29673823,29702362,29673823,29702362,111108248,XM_022444003.1,uncharacterized LOC111108248,28539
NC_035787.1,25650429,25663639,25650429,25663639,111108258,XM_022444022.1,uncharacterized LOC111108258,13210
NC_035787.1,25591039,25595762,25591039,25595762,111108259,XM_022444023.1,uncharacterized LOC111108259,4723
NC_035780.1,58812377,58814023,58812377,58814023,111108264,XM_022444033.1,uncharacterized LOC111108264,1646
NC_035787.1,36957976,36965406,36962047,36965406,111108265,XM_022444030.1,uncharacterized LOC111108265,3359
NC_035787.1,36957976,36965406,36960979,36965406,111108265,XM_022444028.1,uncharacterized LOC111108265,4427
NC_035787.1,36957976,36965406,36960765,36965406,111108265,XM_022444031.1,uncharacterized LOC111108265,4641
NC_035787.1,36957976,36965406,36957976,36963612,111108265,XM_022444032.1,uncharacterized LOC111108265,5636
NC_035780.1,59211484,59224520,59211484,59224520,111108270,XM_022444045.1,uncharacterized LOC111108270,13036
NC_035787.1,47594969,47599917,47594969,47599917,111108272,XM_022444043.1,uncharacterized LOC111108272,4948
NC_035787.1,61167650,61183096,61167650,61183096,111108281,XM_022444059.1,uncharacterized LOC111108281,15446
NC_035787.1,62011203,62013087,62011203,62013087,111108283,XM_022444063.1,uncharacterized LOC111108283,1884
NC_035787.1,1615982,1618697,1615982,1618697,111108284,XM_022444064.1,uncharacterized LOC111108284,2715
NC_035787.1,1740474,1744140,1740474,1744140,111108285,XM_022444065.1,uncharacterized LOC111108285,3666
NC_035787.1,1737712,1740475,1737884,1740475,111108288,XM_022444069.1,uncharacterized LOC111108288,2591
NC_035787.1,1737712,1740475,1737712,1740475,111108288,XM_022444068.1,uncharacterized LOC111108288,2763
NC_035787.1,1698778,1704683,1698778,1704683,111108290,XM_022444072.1,uncharacterized LOC111108290,5905
NC_035787.1,1620552,1624997,1620552,1624997,111108291,XM_022444073.1,uncharacterized LOC111108291,4445
NC_035787.1,19012227,19026909,19012227,19026909,111108298,XM_022444079.1,uncharacterized LOC111108298,14682
NC_035787.1,58910882,58914725,58910882,58914725,111108299,XM_022444080.1,uncharacterized LOC111108299,3843
NC_035787.1,58915652,58920937,58915652,58920937,111108300,XM_022444082.1,uncharacterized LOC111108300,5285
NC_035787.1,58888833,58892423,58888833,58892423,111108301,XM_022444083.1,uncharacterized LOC111108301,3590
NC_035787.1,58902235,58906115,58902235,58906115,111108302,XM_022444084.1,uncharacterized LOC111108302,3880
NC_035787.1,24389354,24415964,24389354,24415964,111108304,XM_022444088.1,uncharacterized LOC111108304,26610
NC_035780.1,59922691,59952327,59922691,59952327,111108306,XM_022444094.1,uncharacterized LOC111108306,29636
NC_035787.1,59276869,59278783,59276869,59278747,111108310,XM_022444103.1,uncharacterized LOC111108310,1878
NC_035787.1,59276869,59278783,59276870,59278782,111108310,XM_022444101.1,uncharacterized LOC111108310,1912
NC_035787.1,59276869,59278783,59276869,59278783,111108310,XM_022444102.1,uncharacterized LOC111108310,1914
NC_035780.1,60164275,60174279,60164275,60174279,111108311,XM_022444107.1,uncharacterized LOC111108311,10004
NC_035787.1,16869617,16917186,16869626,16871802,111108315,XM_022444111.1,uncharacterized LOC111108315,2176
NC_035787.1,16869617,16917186,16869617,16917186,111108315,XM_022444112.1,uncharacterized LOC111108315,47569
NC_035787.1,16946988,16949219,16946988,16949219,111108316,XM_022444113.1,uncharacterized LOC111108316,2231
NC_035787.1,16974913,16977146,16974913,16977146,111108317,XM_022444114.1,uncharacterized LOC111108317,2233
NC_035787.1,16915053,16963941,16961391,16963941,111108320,XM_022444115.1,uncharacterized LOC111108320,2550
NC_035787.1,16915053,16963941,16915053,16963941,111108320,XM_022444116.1,uncharacterized LOC111108320,48888
NC_035787.1,16928814,16933082,16930756,16933082,111108323,XM_022444123.1,uncharacterized LOC111108323,2326
NC_035787.1,16928814,16933082,16928814,16933082,111108323,XM_022444124.1,uncharacterized LOC111108323,4268
NC_035787.1,40365306,40367808,40365306,40367808,111108324,XM_022444125.1,uncharacterized LOC111108324,2502
NC_035787.1,40305561,40325517,40305561,40325517,111108325,XM_022444127.1,uncharacterized LOC111108325,19956
NC_035780.1,60492314,60497335,60492314,60497335,111108326,XM_022444131.1,uncharacterized LOC111108326,5021
NC_035787.1,40294576,40305297,40294576,40305297,111108327,XM_022444128.1,uncharacterized LOC111108327,10721
NC_035787.1,40372414,40377309,40372414,40377309,111108328,XM_022444129.1,uncharacterized LOC111108328,4895
NC_035787.1,59264943,59274116,59264943,59274116,111108331,XM_022444132.1,uncharacterized LOC111108331,9173
NC_035780.1,60783789,60795576,60783789,60795576,111108336,XM_022444142.1,uncharacterized LOC111108336,11787
NC_035787.1,70534756,70551152,70534756,70551152,111108347,XM_022444157.1,uncharacterized LOC111108347,16396
NC_035787.1,47647706,47659312,47647706,47659312,111108349,XM_022444159.1,uncharacterized LOC111108349,11606
NC_035787.1,47640983,47646892,47640983,47645472,111108350,XM_022444161.1,uncharacterized LOC111108350,4489
NC_035787.1,47640983,47646892,47640983,47646892,111108350,XM_022444160.1,uncharacterized LOC111108350,5909
NC_035787.1,35570547,35572992,35570547,35572992,111108362,XM_022444187.1,uncharacterized LOC111108362,2445
NC_035787.1,595121,603207,595121,603207,111108363,XM_022444188.1,uncharacterized LOC111108363,8086
NC_035787.1,69858402,69866922,69858402,69866922,111108364,XM_022444189.1,uncharacterized LOC111108364,8520
NC_035787.1,40751611,40769125,40751611,40769125,111108367,XM_022444190.1,uncharacterized LOC111108367,17514
NC_035787.1,40751611,40769125,40751612,40759447,111108367,XM_022444191.1,uncharacterized LOC111108367,7835
NC_035787.1,40751611,40769125,40751612,40759454,111108367,XM_022444192.1,uncharacterized LOC111108367,7842
NC_035787.1,40670115,40673414,40670122,40673409,111108368,XM_022444194.1,uncharacterized LOC111108368,3287
NC_035787.1,40670115,40673414,40670115,40673414,111108368,XM_022444193.1,uncharacterized LOC111108368,3299
NC_035787.1,237967,243919,237967,241356,111108372,XM_022444203.1,uncharacterized LOC111108372,3389
NC_035787.1,237967,243919,237967,243919,111108372,XM_022444204.1,uncharacterized LOC111108372,5952
NC_035787.1,40425969,40428882,40425969,40428882,111108380,XM_022444219.1,uncharacterized LOC111108380,2913
NC_035787.1,40416391,40482344,40416391,40430087,111108383,XM_022444227.1,uncharacterized LOC111108383,13696
NC_035787.1,40416391,40482344,40416391,40422393,111108383,XM_022444228.1,uncharacterized LOC111108383,6002
NC_035787.1,30867298,30873235,30870081,30873235,111108388,XM_022444240.1,uncharacterized LOC111108388,3154
NC_035787.1,30867298,30873235,30867298,30873234,111108388,XM_022444238.1,uncharacterized LOC111108388,5936
NC_035787.1,9984460,10001091,9984460,10001091,111108395,XM_022444247.1,uncharacterized LOC111108395,16631
NC_035787.1,31475831,31482704,31478864,31482704,111108399,XM_022444255.1,uncharacterized LOC111108399,3840
NC_035787.1,31475831,31482704,31475831,31482704,111108399,XM_022444253.1,uncharacterized LOC111108399,6873
NC_035787.1,24941686,24966372,24945063,24966372,111108403,XM_022444258.1,uncharacterized LOC111108403,21309
NC_035787.1,24941686,24966372,24941715,24966372,111108403,XM_022444259.1,uncharacterized LOC111108403,24657
NC_035787.1,24941686,24966372,24941686,24966372,111108403,XM_022444257.1,uncharacterized LOC111108403,24686
NC_035787.1,9809002,9812711,9809002,9812711,111108405,XM_022444263.1,uncharacterized LOC111108405,3709
NC_035787.1,570543,583935,570543,581528,111108407,XM_022444269.1,uncharacterized LOC111108407,10985
NC_035787.1,570543,583935,570543,583935,111108407,XM_022444268.1,uncharacterized LOC111108407,13392
NC_035787.1,4949393,4975681,4949394,4975680,111108409,XM_022444272.1,uncharacterized LOC111108409,26286
NC_035787.1,4949393,4975681,4949393,4975681,111108409,XM_022444271.1,uncharacterized LOC111108409,26288
NC_035780.1,61798655,61802981,61798655,61802981,111108411,XM_022444279.1,uncharacterized LOC111108411,4326
NC_035787.1,36764435,36771496,36764435,36771496,111108415,XM_022444281.1,uncharacterized LOC111108415,7061
NC_035787.1,7693191,7702917,7693191,7697038,111108416,XM_022444284.1,uncharacterized LOC111108416,3847
NC_035787.1,7693191,7702917,7693191,7701414,111108416,XM_022444283.1,uncharacterized LOC111108416,8223
NC_035787.1,7693191,7702917,7693191,7702917,111108416,XM_022444282.1,uncharacterized LOC111108416,9726
NC_035787.1,7678890,7690650,7678890,7690650,111108417,XM_022444285.1,uncharacterized LOC111108417,11760
NC_035787.1,7678890,7690650,7678890,7685572,111108417,XM_022444287.1,uncharacterized LOC111108417,6682
NC_035787.1,7678890,7690650,7678890,7688381,111108417,XM_022444286.1,uncharacterized LOC111108417,9491
NC_035787.1,7675124,7678519,7675124,7678519,111108419,XM_022444288.1,uncharacterized LOC111108419,3395
NC_035787.1,4344882,4347782,4344882,4347782,111108421,XM_022444290.1,uncharacterized LOC111108421,2900
NC_035787.1,4339322,4344154,4339322,4344154,111108422,XM_022444293.1,uncharacterized LOC111108422,4832
NC_035787.1,68650492,68654775,68650492,68654775,111108429,XM_022444309.1,uncharacterized LOC111108429,4283
NC_035787.1,21433168,21441431,21433168,21438976,111108436,XM_022444320.1,uncharacterized LOC111108436,5808
NC_035787.1,21433168,21441431,21433168,21439174,111108436,XM_022444319.1,uncharacterized LOC111108436,6006
NC_035787.1,21433168,21441431,21433174,21441431,111108436,XM_022444323.1,uncharacterized LOC111108436,8257
NC_035787.1,60143854,60150788,60143854,60150788,111108437,XM_022444324.1,uncharacterized LOC111108437,6934
NC_035787.1,1253377,1266302,1253377,1266302,111108441,XM_022444337.1,uncharacterized LOC111108441,12925
NC_035787.1,50565871,50570010,50565871,50570008,111108445,XM_022444344.1,uncharacterized LOC111108445,4137
NC_035787.1,50565871,50570010,50565871,50570010,111108445,XM_022444343.1,uncharacterized LOC111108445,4139
NC_035787.1,50559565,50564075,50559565,50564075,111108446,XM_022444345.1,uncharacterized LOC111108446,4510
NC_035787.1,7842025,7860974,7842025,7860974,111108456,XM_022444359.1,uncharacterized LOC111108456,18949
NC_035787.1,159865,166589,159865,166589,111108461,XM_022444369.1,uncharacterized LOC111108461,6724
NC_035787.1,156797,159226,156797,159226,111108462,XM_022444370.1,uncharacterized LOC111108462,2429
NC_035787.1,105138,155394,105138,155394,111108463,XM_022444371.1,uncharacterized LOC111108463,50256
NC_035787.1,54362108,54368579,54362108,54368575,111108469,XM_022444376.1,uncharacterized LOC111108469,6467
NC_035787.1,54362108,54368579,54362108,54368579,111108469,XM_022444378.1,uncharacterized LOC111108469,6471
NC_035787.1,3910537,3940600,3925934,3940599,111108471,XM_022444383.1,uncharacterized LOC111108471,14665
NC_035787.1,3910537,3940600,3925933,3940600,111108471,XM_022444382.1,uncharacterized LOC111108471,14667
NC_035787.1,3910537,3940600,3910537,3940584,111108471,XM_022444384.1,uncharacterized LOC111108471,30047
NC_035787.1,3859046,3898451,3859046,3898451,111108472,XM_022444385.1,uncharacterized LOC111108472,39405
NC_035787.1,57569764,57580396,57569764,57580396,111108475,XM_022444388.1,uncharacterized LOC111108475,10632
NC_035787.1,67472471,67481084,67472471,67481084,111108478,XM_022444396.1,uncharacterized LOC111108478,8613
NC_035787.1,2348413,2385114,2370605,2385114,111108482,XM_022444407.1,uncharacterized LOC111108482,14509
NC_035787.1,2348413,2385114,2348413,2373105,111108482,XM_022444405.1,uncharacterized LOC111108482,24692
NC_035787.1,2348413,2385114,2352269,2385114,111108482,XM_022444406.1,uncharacterized LOC111108482,32845
NC_035787.1,2348413,2385114,2348413,2385114,111108482,XM_022444404.1,uncharacterized LOC111108482,36701
NC_035787.1,67748256,67753721,67748256,67753721,111108486,XM_022444411.1,uncharacterized LOC111108486,5465
NC_035787.1,60277640,60297691,60277640,60292390,111108489,XM_022444415.1,uncharacterized LOC111108489,14750
NC_035787.1,60277640,60297691,60291660,60297691,111108489,XM_022444417.1,uncharacterized LOC111108489,6031
NC_035787.1,1842833,1845420,1842927,1845420,111108499,XM_022444433.1,uncharacterized LOC111108499,2493
NC_035787.1,1842833,1845420,1842833,1845420,111108499,XM_022444432.1,uncharacterized LOC111108499,2587
NC_035787.1,1836095,1841075,1836095,1841075,111108500,XM_022444434.1,uncharacterized LOC111108500,4980
NC_035780.1,63430714,63432682,63430714,63432682,111108502,XM_022444436.1,uncharacterized LOC111108502,1968
NC_035787.1,29892670,29917689,29907573,29917689,111108503,XM_022444444.1,uncharacterized LOC111108503,10116
NC_035787.1,29892670,29917689,29899271,29917689,111108503,XM_022444438.1,uncharacterized LOC111108503,18418
NC_035787.1,29892670,29917689,29895418,29915085,111108503,XM_022444445.1,uncharacterized LOC111108503,19667
NC_035787.1,29892670,29917689,29895439,29917689,111108503,XM_022444437.1,uncharacterized LOC111108503,22250
NC_035787.1,29892670,29917689,29892727,29917689,111108503,XM_022444442.1,uncharacterized LOC111108503,24962
NC_035787.1,29892670,29917689,29892719,29917689,111108503,XM_022444440.1,uncharacterized LOC111108503,24970
NC_035787.1,29892670,29917689,29892670,29917689,111108503,XM_022444441.1,uncharacterized LOC111108503,25019
NC_035780.1,63975466,63985944,63975466,63985944,111108520,XM_022444475.1,uncharacterized LOC111108520,10478
NC_035780.1,64031230,64038952,64031230,64038952,111108526,XM_022444488.1,uncharacterized LOC111108526,7722
NC_035787.1,30803856,30818323,30803856,30818323,111108529,XM_022444489.1,uncharacterized LOC111108529,14467
NC_035787.1,30831336,30836999,30833885,30836999,111108531,XM_022444494.1,uncharacterized LOC111108531,3114
NC_035787.1,30831336,30836999,30831336,30836999,111108531,XM_022444496.1,uncharacterized LOC111108531,5663
NC_035787.1,73444794,73448225,73444794,73448225,111108532,XM_022444497.1,uncharacterized LOC111108532,3431
NC_035780.1,64118702,64145562,64118702,64145562,111108533,XM_022444503.1,uncharacterized LOC111108533,26860
NC_035787.1,64555067,64568137,64555116,64568137,111108536,XM_022444506.1,uncharacterized LOC111108536,13021
NC_035787.1,64555067,64568137,64555067,64568137,111108536,XM_022444505.1,uncharacterized LOC111108536,13070
NC_035787.1,64569722,64581553,64569722,64581552,111108537,XM_022444508.1,uncharacterized LOC111108537,11830
NC_035787.1,64569722,64581553,64569722,64581553,111108537,XM_022444507.1,uncharacterized LOC111108537,11831
NC_035787.1,44380176,44416579,44398298,44416579,111108540,XM_022444514.1,uncharacterized LOC111108540,18281
NC_035787.1,44380176,44416579,44391921,44416579,111108540,XM_022444513.1,uncharacterized LOC111108540,24658
NC_035787.1,44380176,44416579,44388596,44416579,111108540,XM_022444511.1,uncharacterized LOC111108540,27983
NC_035787.1,44380176,44416579,44380176,44416579,111108540,XM_022444515.1,uncharacterized LOC111108540,36403
NC_035780.1,64280867,64282308,64280867,64282308,111108541,XM_022444516.1,uncharacterized LOC111108541,1441
NC_035787.1,44217741,44235832,44217741,44235832,111108543,XM_022444519.1,uncharacterized LOC111108543,18091
NC_035787.1,44243876,44247887,44243876,44247887,111108544,XM_022444520.1,uncharacterized LOC111108544,4011
NC_035787.1,44458566,44461542,44458566,44461542,111108547,XM_022444525.1,uncharacterized LOC111108547,2976
NC_035787.1,44050322,44052436,44050322,44052436,111108550,XM_022444529.1,uncharacterized LOC111108550,2114
NC_035787.1,43990673,43996320,43990673,43996320,111108551,XM_022444530.1,uncharacterized LOC111108551,5647
NC_035787.1,44109839,44114282,44109839,44114280,111108554,XM_022444535.1,uncharacterized LOC111108554,4441
NC_035787.1,44109839,44114282,44109839,44114281,111108554,XM_022444537.1,uncharacterized LOC111108554,4442
NC_035787.1,44109839,44114282,44109839,44114282,111108554,XM_022444536.1,uncharacterized LOC111108554,4443
NC_035787.1,44098429,44108696,44101660,44108696,111108556,XM_022444538.1,uncharacterized LOC111108556,7036
NC_035787.1,44098429,44108696,44098429,44105531,111108556,XM_022444540.1,uncharacterized LOC111108556,7102
NC_035787.1,44236499,44251609,44236499,44251609,111108557,XM_022444542.1,uncharacterized LOC111108557,15110
NC_035787.1,44344701,44355454,44344701,44355454,111108561,XM_022444549.1,uncharacterized LOC111108561,10753
NC_035787.1,44344701,44355454,44344701,44353070,111108561,XM_022444548.1,uncharacterized LOC111108561,8369
NC_035787.1,44326306,44334680,44326306,44334680,111108564,XM_022444552.1,uncharacterized LOC111108564,8374
NC_035787.1,44310922,44317186,44313677,44317186,111108565,XM_022444553.1,uncharacterized LOC111108565,3509
NC_035787.1,44310922,44317186,44310922,44317186,111108565,XM_022444555.1,uncharacterized LOC111108565,6264
NC_035787.1,44085333,44089428,44085333,44089428,111108566,XM_022444556.1,uncharacterized LOC111108566,4095
NC_035787.1,44077302,44081807,44077302,44081807,111108567,XM_022444557.1,uncharacterized LOC111108567,4505
NC_035787.1,44086342,44095908,44092200,44095908,111108568,XM_022444558.1,uncharacterized LOC111108568,3708
NC_035787.1,44086342,44095908,44086342,44095906,111108568,XM_022444559.1,uncharacterized LOC111108568,9564
NC_035787.1,44286146,44300034,44286146,44300034,111108570,XM_022444561.1,uncharacterized LOC111108570,13888
NC_035780.1,64677249,64712851,64677249,64712851,111108571,XM_022444563.1,uncharacterized LOC111108571,35602
NC_035780.1,64816569,64824003,64816569,64824003,111108584,XM_022444567.1,uncharacterized LOC111108584,7434
NC_035787.1,42276,47428,42276,47428,111108587,XM_022444571.1,uncharacterized LOC111108587,5152
NC_035787.1,37108,39695,37108,39695,111108588,XM_022444573.1,uncharacterized LOC111108588,2587
NC_035787.1,57536803,57543006,57536803,57543006,111108594,XM_022444577.1,uncharacterized LOC111108594,6203
NC_035787.1,57528959,57535568,57528959,57535568,111108596,XM_022444579.1,uncharacterized LOC111108596,6609
NC_035787.1,56550535,56553030,56550535,56553030,111108597,XM_022444580.1,uncharacterized LOC111108597,2495
NC_035787.1,55438606,55447729,55438606,55447729,111108599,XM_022444582.1,uncharacterized LOC111108599,9123
NC_035780.1,65155832,65186744,65155832,65186744,111108603,XM_022444590.1,uncharacterized LOC111108603,30912
NC_035787.1,22095639,22098999,22095639,22098999,111108610,XM_022444594.1,uncharacterized LOC111108610,3360
NC_035787.1,52747204,52752427,52747204,52752427,111108612,XM_022444596.1,uncharacterized LOC111108612,5223
NC_035780.1,65224734,65232992,65224734,65232992,111108613,XM_022444601.1,uncharacterized LOC111108613,8258
NC_035787.1,51871814,51873931,51871814,51873931,111108618,XM_022444608.1,uncharacterized LOC111108618,2117
NC_035780.1,65286550,65314849,65286550,65314849,111108627,XM_022444627.1,uncharacterized LOC111108627,28299
NC_035787.1,50121263,50132131,50121263,50132131,111108632,XM_022444631.1,uncharacterized LOC111108632,10868
NC_035780.1,65650076,65658622,65650076,65658622,111108635,XM_022444637.1,uncharacterized LOC111108635,8546
NC_035787.1,58848030,58854558,58848030,58854558,111108637,XM_022444636.1,uncharacterized LOC111108637,6528
NC_035780.1,15452874,15459106,15452874,15459106,111108643,XM_022444651.1,uncharacterized LOC111108643,6232
NC_035787.1,34406868,34420793,34406868,34420754,111108645,XM_022444653.1,uncharacterized LOC111108645,13886
NC_035787.1,34406868,34420793,34406868,34420793,111108645,XM_022444654.1,uncharacterized LOC111108645,13925
NC_035780.1,32840410,32850745,32840410,32850745,111108658,XM_022444684.1,uncharacterized LOC111108658,10335
NC_035787.1,18270954,18346764,18270954,18273364,111108663,XM_022444690.1,uncharacterized LOC111108663,2410
NC_035787.1,18270954,18346764,18270954,18273945,111108663,XM_022444691.1,uncharacterized LOC111108663,2991
NC_035787.1,18270954,18346764,18270954,18346764,111108663,XM_022444692.1,uncharacterized LOC111108663,75810
NC_035787.1,18290807,18292706,18290807,18292706,111108666,XM_022444695.1,uncharacterized LOC111108666,1899
NC_035787.1,18449616,18452439,18449616,18452439,111108667,XM_022444697.1,uncharacterized LOC111108667,2823
NC_035787.1,18165923,18168888,18165923,18168888,111108668,XM_022444698.1,uncharacterized LOC111108668,2965
NC_035787.1,18427054,18482764,18427054,18430886,111108670,XM_022444703.1,uncharacterized LOC111108670,3832
NC_035787.1,18427054,18482764,18427054,18482729,111108670,XM_022444704.1,uncharacterized LOC111108670,55675
NC_035787.1,18427054,18482764,18473078,18478802,111108670,XM_022444702.1,uncharacterized LOC111108670,5724
NC_035787.1,18427054,18482764,18473078,18482754,111108670,XM_022444700.1,uncharacterized LOC111108670,9676
NC_035787.1,18427054,18482764,18473078,18482764,111108670,XM_022444701.1,uncharacterized LOC111108670,9686
NC_035787.1,18251332,18255974,18251332,18255974,111108672,XM_022444707.1,uncharacterized LOC111108672,4642
NC_035787.1,18038333,18040865,18038333,18040865,111108673,XM_022444708.1,uncharacterized LOC111108673,2532
NC_035787.1,18101541,18105269,18101541,18105269,111108674,XM_022444709.1,uncharacterized LOC111108674,3728
NC_035787.1,18045166,18049285,18045166,18049285,111108675,XM_022444710.1,uncharacterized LOC111108675,4119
NC_035787.1,18105693,18110822,18105693,18110822,111108677,XM_022444712.1,uncharacterized LOC111108677,5129
NC_035787.1,18372666,18374472,18372666,18374472,111108678,XM_022444715.1,uncharacterized LOC111108678,1806
NC_035787.1,18340499,18342159,18340499,18342159,111108679,XM_022444716.1,uncharacterized LOC111108679,1660
NC_035787.1,18304160,18306586,18304160,18306586,111108680,XM_022444717.1,uncharacterized LOC111108680,2426
NC_035787.1,18240725,18245529,18240725,18245529,111108684,XM_022444720.1,uncharacterized LOC111108684,4804
NC_035787.1,11695559,11699664,11698191,11699664,111108693,XM_022444725.1,uncharacterized LOC111108693,1473
NC_035787.1,11695559,11699664,11695559,11699652,111108693,XM_022444726.1,uncharacterized LOC111108693,4093
NC_035780.1,16848527,16862178,16848544,16862178,111108695,XM_022444764.1,uncharacterized LOC111108695,13634
NC_035787.1,57661278,57683139,57665919,57683139,111108696,XM_022444730.1,uncharacterized LOC111108696,17220
NC_035787.1,57661278,57683139,57661278,57683139,111108696,XM_022444729.1,uncharacterized LOC111108696,21861
NC_035787.1,25058056,25064397,25058056,25064397,111108709,XM_022444749.1,uncharacterized LOC111108709,6341
NC_035780.1,41339114,41382887,41339119,41382887,111108711,XM_022444770.1,uncharacterized LOC111108711,43768
NC_035780.1,41339114,41382887,41339116,41382887,111108711,XM_022444761.1,uncharacterized LOC111108711,43771
NC_035780.1,41339114,41382887,41339114,41382887,111108711,XM_022444753.1,uncharacterized LOC111108711,43773
NC_035787.1,12196704,12246481,12196704,12246481,111108713,XM_022444751.1,uncharacterized LOC111108713,49777
NC_035787.1,603328,614710,603328,614710,111108715,XM_022444752.1,uncharacterized LOC111108715,11382
NC_035787.1,33455394,33473082,33455394,33473082,111108716,XM_022444755.1,uncharacterized LOC111108716,17688
NC_035787.1,53068287,53069549,53068287,53069549,111108717,XM_022444756.1,uncharacterized LOC111108717,1262
NC_035787.1,10469327,10475704,10473006,10475704,111108719,XM_022444758.1,uncharacterized LOC111108719,2698
NC_035787.1,10469327,10475704,10472816,10475704,111108719,XM_022444760.1,uncharacterized LOC111108719,2888
NC_035787.1,10469327,10475704,10469327,10475704,111108719,XM_022444759.1,uncharacterized LOC111108719,6377
NC_035787.1,17476690,17486996,17476690,17486996,111108727,XM_022444776.1,uncharacterized LOC111108727,10306
NC_035787.1,17582321,17586076,17582321,17586076,111108730,XM_022444782.1,uncharacterized LOC111108730,3755
NC_035787.1,17508148,17510478,17508148,17510478,111108731,XM_022444784.1,uncharacterized LOC111108731,2330
NC_035787.1,17599851,17610333,17599851,17610333,111108732,XM_022444785.1,uncharacterized LOC111108732,10482
NC_035787.1,17599851,17610333,17607384,17610333,111108732,XM_022444786.1,uncharacterized LOC111108732,2949
NC_035787.1,17558557,17560591,17558557,17560591,111108733,XM_022444787.1,uncharacterized LOC111108733,2034
NC_035787.1,17550761,17551843,17550761,17551843,111108734,XM_022444788.1,uncharacterized LOC111108734,1082
NC_035780.1,41104406,41106328,41104406,41106328,111108738,XM_022444794.1,uncharacterized LOC111108738,1922
NC_035787.1,17563137,17571390,17563137,17571390,111108739,XM_022444792.1,uncharacterized LOC111108739,8253
NC_035787.1,16749444,16752927,16749444,16752927,111108744,XM_022444803.1,uncharacterized LOC111108744,3483
NC_035787.1,4867557,4876720,4867557,4876720,111108748,XM_022444806.1,uncharacterized LOC111108748,9163
NC_035787.1,68313616,68400891,68313616,68399317,111108749,XM_022444808.1,uncharacterized LOC111108749,85701
NC_035787.1,68313616,68400891,68313616,68400891,111108749,XM_022444810.1,uncharacterized LOC111108749,87275
NC_035787.1,15687383,15692691,15687383,15692691,111108755,XM_022444816.1,uncharacterized LOC111108755,5308
NC_035787.1,71029258,71147174,71029258,71147174,111108757,XM_022444818.1,uncharacterized LOC111108757,117916
NC_035787.1,34828344,34857610,34828344,34857610,111108765,XM_022444825.1,uncharacterized LOC111108765,29266
NC_035787.1,34828344,34857610,34828344,34834096,111108765,XM_022444824.1,uncharacterized LOC111108765,5752
NC_035787.1,74434003,74440879,74434003,74440879,111108778,XM_022444851.1,uncharacterized LOC111108778,6876
NC_035787.1,74407696,74448077,74419717,74448077,111108779,XM_022444854.1,uncharacterized LOC111108779,28360
NC_035787.1,74407696,74448077,74407702,74448077,111108779,XM_022444855.1,uncharacterized LOC111108779,40375
NC_035787.1,74407696,74448077,74407696,74448077,111108779,XM_022444852.1,uncharacterized LOC111108779,40381
NC_035787.1,9691873,9696295,9691873,9696295,111108780,XM_022444856.1,uncharacterized LOC111108780,4422
NC_035787.1,75490728,75526842,75490728,75510829,111108787,XM_022444867.1,uncharacterized LOC111108787,20101
NC_035787.1,75490728,75526842,75490728,75526842,111108787,XM_022444868.1,uncharacterized LOC111108787,36114
NC_035787.1,58736912,58740272,58736912,58740272,111108789,XM_022444872.1,uncharacterized LOC111108789,3360
NC_035787.1,28880431,28881884,28880431,28881884,111108797,XM_022444880.1,uncharacterized LOC111108797,1453
NC_035787.1,9537871,9543985,9537871,9543985,111108800,XM_022444887.1,uncharacterized LOC111108800,6114
NC_035787.1,15634978,15672636,15634978,15672636,111108802,XM_022444889.1,uncharacterized LOC111108802,37658
NC_035787.1,15827215,15863843,15827215,15863843,111108810,XM_022444897.1,uncharacterized LOC111108810,36628
NC_035787.1,16284351,16284935,16284351,16284935,111108812,XM_022444899.1,uncharacterized LOC111108812,584
NC_035787.1,16291904,16295477,16291904,16295477,111108813,XM_022444900.1,uncharacterized LOC111108813,3573
NC_035787.1,16544411,16556440,16544411,16556440,111108822,XM_022444908.1,uncharacterized LOC111108822,12029
NC_035787.1,16636918,16637384,16636918,16637384,111108824,XM_022444910.1,uncharacterized LOC111108824,466
NC_035787.1,16642277,16653581,16642277,16653581,111108826,XM_022444911.1,uncharacterized LOC111108826,11304
NC_035787.1,16670977,16673772,16670977,16673772,111108828,XM_022444913.1,uncharacterized LOC111108828,2795
NC_035787.1,16722661,16723173,16722661,16723173,111108829,XM_022444915.1,uncharacterized LOC111108829,512
NC_035787.1,17184098,17188959,17184098,17188959,111108831,XM_022444917.1,uncharacterized LOC111108831,4861
NC_035787.1,17434030,17440886,17434030,17440886,111108833,XM_022444919.1,uncharacterized LOC111108833,6856
NC_035787.1,17536510,17545691,17536510,17545691,111108834,XM_022444920.1,uncharacterized LOC111108834,9181
NC_035780.1,4707053,4710471,4707053,4710471,111108836,XM_022444923.1,uncharacterized LOC111108836,3418
NC_035787.1,18030335,18032521,18030335,18032521,111108839,XM_022444922.1,uncharacterized LOC111108839,2186
NC_035787.1,18051014,18089502,18051014,18089502,111108840,XM_022444924.1,uncharacterized LOC111108840,38488
NC_035787.1,18229163,18229870,18229163,18229870,111108842,XM_022444926.1,uncharacterized LOC111108842,707
NC_035787.1,18232132,18250252,18232132,18250252,111108843,XM_022444927.1,uncharacterized LOC111108843,18120
NC_035787.1,18298977,18304314,18298977,18304314,111108844,XM_022444928.1,uncharacterized LOC111108844,5337
NC_035787.1,18763407,18764718,18763407,18764718,111108850,XM_022444934.1,uncharacterized LOC111108850,1311
NC_035787.1,18839951,18841585,18839951,18841585,111108851,XM_022444935.1,uncharacterized LOC111108851,1634
NC_035787.1,18869973,18874327,18869973,18874327,111108852,XM_022444936.1,uncharacterized LOC111108852,4354
NC_035787.1,19137877,19141717,19137877,19141717,111108854,XM_022444938.1,uncharacterized LOC111108854,3840
NC_035787.1,19150520,19153301,19150520,19153301,111108856,XM_022444940.1,uncharacterized LOC111108856,2781
NC_035787.1,19395873,19401863,19395873,19401863,111108859,XM_022444942.1,uncharacterized LOC111108859,5990
NC_035787.1,19636233,19637537,19636233,19637537,111108861,XM_022444945.1,uncharacterized LOC111108861,1304
NC_035787.1,19695143,19695772,19695143,19695772,111108862,XM_022444946.1,uncharacterized LOC111108862,629
NC_035787.1,19927389,19929429,19927389,19929429,111108863,XM_022444947.1,uncharacterized LOC111108863,2040
NC_035787.1,20889978,20895189,20889978,20895189,111108873,XM_022444957.1,uncharacterized LOC111108873,5211
NC_035787.1,20931332,20932219,20931332,20932219,111108874,XM_022444958.1,uncharacterized LOC111108874,887
NC_035787.1,21546652,21549019,21546652,21549019,111108875,XM_022444959.1,uncharacterized LOC111108875,2367
NC_035787.1,21616313,21626641,21616313,21626641,111108877,XM_022444961.1,uncharacterized LOC111108877,10328
NC_035787.1,21860050,21893510,21860050,21893510,111108880,XM_022444963.1,uncharacterized LOC111108880,33460
NC_035787.1,21913693,21919121,21913693,21919121,111108881,XM_022444964.1,uncharacterized LOC111108881,5428
NC_035787.1,22128497,22129564,22128497,22129564,111108882,XM_022444966.1,uncharacterized LOC111108882,1067
NC_035787.1,22136572,22137515,22136572,22137515,111108883,XM_022444967.1,uncharacterized LOC111108883,943
NC_035787.1,22569261,22576883,22569261,22576883,111108886,XM_022444969.1,uncharacterized LOC111108886,7622
NC_035787.1,23250407,23257849,23250407,23257849,111108890,XM_022444974.1,uncharacterized LOC111108890,7442
NC_035787.1,23950970,23956449,23950970,23956449,111108892,XM_022444976.1,uncharacterized LOC111108892,5479
NC_035787.1,23970547,23973539,23970547,23973539,111108893,XM_022444977.1,uncharacterized LOC111108893,2992
NC_035787.1,24584414,24588116,24584414,24588116,111108896,XM_022444981.1,uncharacterized LOC111108896,3702
NC_035787.1,24601191,24602763,24601191,24602763,111108897,XM_022444982.1,uncharacterized LOC111108897,1572
NC_035787.1,24622813,24627200,24622813,24627200,111108898,XM_022444983.1,uncharacterized LOC111108898,4387
NC_035787.1,24647361,24664316,24647361,24664316,111108899,XM_022444984.1,uncharacterized LOC111108899,16955
NC_035787.1,24700534,24740019,24700534,24740019,111108900,XM_022444985.1,uncharacterized LOC111108900,39485
NC_035787.1,25717537,25719948,25717537,25719948,111108906,XM_022444990.1,uncharacterized LOC111108906,2411
NC_035787.1,25728497,25732437,25728497,25732437,111108907,XM_022444991.1,uncharacterized LOC111108907,3940
NC_035787.1,25901171,25901692,25901171,25901692,111108908,XM_022444992.1,uncharacterized LOC111108908,521
NC_035787.1,26594614,26621331,26594614,26621331,111108910,XM_022444994.1,uncharacterized LOC111108910,26717
NC_035787.1,26879808,26913055,26879808,26913055,111108913,XM_022444998.1,uncharacterized LOC111108913,33247
NC_035787.1,27157912,27167978,27157912,27167978,111108914,XM_022444999.1,uncharacterized LOC111108914,10066
NC_035787.1,27283289,27284539,27283289,27284539,111108916,XM_022445001.1,uncharacterized LOC111108916,1250
NC_035787.1,27666738,27668859,27666738,27668859,111108923,XM_022445009.1,uncharacterized LOC111108923,2121
NC_035787.1,27668571,27669782,27668571,27669782,111108924,XM_022445011.1,uncharacterized LOC111108924,1211
NC_035787.1,27974963,27979370,27974963,27979370,111108925,XM_022445012.1,uncharacterized LOC111108925,4407
NC_035787.1,28463286,28468252,28463286,28468252,111108927,XM_022445014.1,uncharacterized LOC111108927,4966
NC_035787.1,28645904,28648728,28645904,28648728,111108928,XM_022445015.1,uncharacterized LOC111108928,2824
NC_035787.1,29280751,29284821,29280751,29284821,111108930,XM_022445017.1,uncharacterized LOC111108930,4070
NC_035787.1,29324777,29337481,29324777,29337481,111108932,XM_022445018.1,uncharacterized LOC111108932,12704
NC_035787.1,29489890,29492894,29489890,29492894,111108933,XM_022445019.1,uncharacterized LOC111108933,3004
NC_035787.1,30077259,30080218,30077259,30080218,111108936,XM_022445022.1,uncharacterized LOC111108936,2959
NC_035787.1,30130708,30139296,30130708,30139296,111108937,XM_022445024.1,uncharacterized LOC111108937,8588
NC_035787.1,31348397,31352885,31348397,31352885,111108940,XM_022445028.1,uncharacterized LOC111108940,4488
NC_035787.1,32757109,32759435,32757109,32759435,111108956,XM_022445045.1,uncharacterized LOC111108956,2326
NC_035787.1,32777786,32781604,32777786,32781604,111108958,XM_022445047.1,uncharacterized LOC111108958,3818
NC_035787.1,32844412,32850444,32844412,32850444,111108959,XM_022445048.1,uncharacterized LOC111108959,6032
NC_035787.1,32863315,32894435,32863315,32894435,111108961,XM_022445050.1,uncharacterized LOC111108961,31120
NC_035787.1,33025805,33029503,33025805,33029503,111108966,XM_022445055.1,uncharacterized LOC111108966,3698
NC_035787.1,33086487,33090143,33086487,33090143,111108967,XM_022445056.1,uncharacterized LOC111108967,3656
NC_035787.1,33137242,33137876,33137242,33137876,111108968,XM_022445057.1,uncharacterized LOC111108968,634
NC_035787.1,33138373,33138984,33138373,33138984,111108969,XM_022445058.1,uncharacterized LOC111108969,611
NC_035787.1,33354855,33355766,33354855,33355766,111108970,XM_022445059.1,uncharacterized LOC111108970,911
NC_035787.1,33640116,33655711,33640116,33655711,111108971,XM_022445060.1,uncharacterized LOC111108971,15595
NC_035780.1,63219244,63225256,63219511,63225256,111108973,XM_022445072.1,uncharacterized LOC111108973,5745
NC_035780.1,63219244,63225256,63219244,63225256,111108973,XM_022445065.1,uncharacterized LOC111108973,6012
NC_035787.1,34336388,34339703,34336388,34339703,111108974,XM_022445062.1,uncharacterized LOC111108974,3315
NC_035787.1,34381863,34387397,34381863,34387397,111108975,XM_022445063.1,uncharacterized LOC111108975,5534
NC_035787.1,34584722,34587305,34584722,34587305,111108976,XM_022445064.1,uncharacterized LOC111108976,2583
NC_035787.1,34588900,34589469,34588900,34589469,111108977,XM_022445066.1,uncharacterized LOC111108977,569
NC_035787.1,34642627,34644323,34642627,34644323,111108978,XM_022445067.1,uncharacterized LOC111108978,1696
NC_035787.1,34815632,34817313,34815632,34817313,111108979,XM_022445068.1,uncharacterized LOC111108979,1681
NC_035787.1,35215915,35217035,35215915,35217035,111108982,XM_022445070.1,uncharacterized LOC111108982,1120
NC_035787.1,35213519,35224089,35213519,35224089,111108983,XM_022445071.1,uncharacterized LOC111108983,10570
NC_035787.1,35439449,35440556,35439449,35440556,111108984,XM_022445073.1,uncharacterized LOC111108984,1107
NC_035787.1,35492362,35494576,35492362,35494576,111108985,XM_022445074.1,uncharacterized LOC111108985,2214
NC_035787.1,35531652,35534419,35531652,35534419,111108986,XM_022445075.1,uncharacterized LOC111108986,2767
NC_035787.1,36067771,36068902,36067771,36068902,111108988,XM_022445077.1,uncharacterized LOC111108988,1131
NC_035787.1,36450301,36451437,36450301,36451437,111108993,XM_022445080.1,uncharacterized LOC111108993,1136
NC_035787.1,36508514,36509549,36508514,36509549,111108995,XM_022445083.1,uncharacterized LOC111108995,1035
NC_035787.1,36515857,36517947,36515857,36517947,111108996,XM_022445084.1,uncharacterized LOC111108996,2090
NC_035787.1,36543094,36544272,36543094,36544272,111108998,XM_022445086.1,uncharacterized LOC111108998,1178
NC_035780.1,27709561,27711685,27709561,27711685,111109002,XM_022445094.1,uncharacterized LOC111109002,2124
NC_035787.1,36995831,36998762,36995831,36998762,111109004,XM_022445091.1,uncharacterized LOC111109004,2931
NC_035787.1,37039912,37041654,37039912,37041654,111109005,XM_022445092.1,uncharacterized LOC111109005,1742
NC_035787.1,37199759,37202799,37199759,37202799,111109007,XM_022445096.1,uncharacterized LOC111109007,3040
NC_035787.1,37211441,37213011,37211441,37213011,111109008,XM_022445097.1,uncharacterized LOC111109008,1570
NC_035787.1,37485421,37485951,37485421,37485951,111109010,XM_022445099.1,uncharacterized LOC111109010,530
NC_035787.1,37510471,37511630,37510471,37511630,111109011,XM_022445100.1,uncharacterized LOC111109011,1159
NC_035787.1,37930674,37932272,37930674,37932272,111109014,XM_022445102.1,uncharacterized LOC111109014,1598
NC_035787.1,37962147,37973724,37962147,37973724,111109015,XM_022445103.1,uncharacterized LOC111109015,11577
NC_035787.1,38024184,38027273,38024184,38027273,111109016,XM_022445104.1,uncharacterized LOC111109016,3089
NC_035787.1,38413942,38415048,38413942,38415048,111109017,XM_022445106.1,uncharacterized LOC111109017,1106
NC_035787.1,38420472,38421580,38420472,38421580,111109018,XM_022445107.1,uncharacterized LOC111109018,1108
NC_035787.1,38537737,38556932,38537737,38556932,111109020,XM_022445109.1,uncharacterized LOC111109020,19195
NC_035787.1,39286935,39289661,39286935,39289661,111109022,XM_022445112.1,uncharacterized LOC111109022,2726
NC_035787.1,39292038,39297784,39292038,39297784,111109023,XM_022445113.1,uncharacterized LOC111109023,5746
NC_035787.1,39455556,39461582,39455556,39461582,111109024,XM_022445114.1,uncharacterized LOC111109024,6026
NC_035787.1,39760815,39816734,39760815,39816734,111109026,XM_022445115.1,uncharacterized LOC111109026,55919
NC_035780.1,25924450,25935088,25924450,25935087,111109028,XM_022445120.1,uncharacterized LOC111109028,10637
NC_035780.1,25924450,25935088,25927018,25935088,111109028,XM_022445126.1,uncharacterized LOC111109028,8070
NC_035787.1,40050744,40054703,40050744,40054703,111109029,XM_022445117.1,uncharacterized LOC111109029,3959
NC_035787.1,40091030,40093612,40091030,40093612,111109030,XM_022445118.1,uncharacterized LOC111109030,2582
NC_035787.1,40108517,40114080,40108517,40114080,111109031,XM_022445119.1,uncharacterized LOC111109031,5563
NC_035787.1,40149419,40172824,40149419,40172824,111109032,XM_022445121.1,uncharacterized LOC111109032,23405
NC_035787.1,40289407,40290616,40289407,40290616,111109033,XM_022445122.1,uncharacterized LOC111109033,1209
NC_035787.1,40330157,40335312,40330157,40335312,111109034,XM_022445123.1,uncharacterized LOC111109034,5155
NC_035787.1,40349271,40355951,40349271,40355951,111109035,XM_022445124.1,uncharacterized LOC111109035,6680
NC_035787.1,40610427,40616218,40610427,40616218,111109036,XM_022445125.1,uncharacterized LOC111109036,5791
NC_035787.1,40692799,40710033,40692799,40710033,111109037,XM_022445127.1,uncharacterized LOC111109037,17234
NC_035787.1,40919502,40920575,40919502,40920575,111109041,XM_022445130.1,uncharacterized LOC111109041,1073
NC_035780.1,25940902,25949004,25941619,25949004,111109043,XM_022445140.1,uncharacterized LOC111109043,7385
NC_035780.1,25940902,25949004,25940902,25949004,111109043,XM_022445134.1,uncharacterized LOC111109043,8102
NC_035787.1,41142062,41150666,41142062,41150666,111109045,XM_022445132.1,uncharacterized LOC111109045,8604
NC_035787.1,41589614,41617596,41589614,41617596,111109046,XM_022445133.1,uncharacterized LOC111109046,27982
NC_035787.1,41633416,41633922,41633416,41633922,111109047,XM_022445135.1,uncharacterized LOC111109047,506
NC_035787.1,41660498,41682927,41660498,41682927,111109048,XM_022445136.1,uncharacterized LOC111109048,22429
NC_035787.1,41704655,41706221,41704655,41706221,111109049,XM_022445137.1,uncharacterized LOC111109049,1566
NC_035787.1,41810933,41813546,41810933,41813546,111109050,XM_022445138.1,uncharacterized LOC111109050,2613
NC_035787.1,41888875,41893252,41888875,41893252,111109051,XM_022445139.1,uncharacterized LOC111109051,4377
NC_035787.1,42098776,42103901,42098776,42103901,111109052,XM_022445141.1,uncharacterized LOC111109052,5125
NC_035787.1,42129142,42172962,42129142,42172962,111109053,XM_022445142.1,uncharacterized LOC111109053,43820
NC_035787.1,42197176,42246912,42197176,42246912,111109054,XM_022445143.1,uncharacterized LOC111109054,49736
NC_035787.1,42374684,42432494,42374684,42432494,111109055,XM_022445144.1,uncharacterized LOC111109055,57810
NC_035787.1,42561407,42562576,42561407,42562576,111109056,XM_022445145.1,uncharacterized LOC111109056,1169
NC_035787.1,42562717,42563175,42562717,42563175,111109057,XM_022445146.1,uncharacterized LOC111109057,458
NC_035787.1,42566163,42567332,42566163,42567332,111109058,XM_022445147.1,uncharacterized LOC111109058,1169
NC_035787.1,42567473,42569125,42567473,42569125,111109059,XM_022445149.1,uncharacterized LOC111109059,1652
NC_035787.1,42622580,42671860,42622580,42671860,111109060,XM_022445150.1,uncharacterized LOC111109060,49280
NC_035787.1,42876097,42920744,42876097,42920744,111109061,XM_022445151.1,uncharacterized LOC111109061,44647
NC_035787.1,42946975,42948691,42946975,42948691,111109062,XM_022445152.1,uncharacterized LOC111109062,1716
NC_035787.1,42948770,42952054,42948770,42952054,111109063,XM_022445153.1,uncharacterized LOC111109063,3284
NC_035787.1,42963217,42967849,42963217,42967849,111109064,XM_022445154.1,uncharacterized LOC111109064,4632
NC_035787.1,43411139,43414245,43411139,43414245,111109068,XM_022445157.1,uncharacterized LOC111109068,3106
NC_035787.1,43532361,43541068,43532361,43541068,111109072,XM_022445161.1,uncharacterized LOC111109072,8707
NC_035787.1,43637673,43641085,43637673,43641085,111109074,XM_022445162.1,uncharacterized LOC111109074,3412
NC_035787.1,43800759,43801553,43800759,43801553,111109077,XM_022445165.1,uncharacterized LOC111109077,794
NC_035787.1,44265252,44269368,44265252,44269368,111109078,XM_022445166.1,uncharacterized LOC111109078,4116
NC_035787.1,44300722,44304946,44300722,44304946,111109080,XM_022445168.1,uncharacterized LOC111109080,4224
NC_035787.1,44483897,44487521,44483897,44487521,111109082,XM_022445170.1,uncharacterized LOC111109082,3624
NC_035780.1,59293676,59314969,59293676,59314969,111109086,XM_022445176.1,uncharacterized LOC111109086,21293
NC_035787.1,44859506,44862248,44859506,44862248,111109087,XM_022445174.1,uncharacterized LOC111109087,2742
NC_035787.1,45126370,45127826,45126370,45127826,111109089,XM_022445177.1,uncharacterized LOC111109089,1456
NC_035787.1,45188326,45188775,45188326,45188775,111109090,XM_022445178.1,uncharacterized LOC111109090,449
NC_035787.1,45188942,45190453,45188942,45190453,111109091,XM_022445179.1,uncharacterized LOC111109091,1511
NC_035787.1,45257594,45258747,45257594,45258747,111109092,XM_022445180.1,uncharacterized LOC111109092,1153
NC_035787.1,45288867,45290395,45288867,45290395,111109094,XM_022445182.1,uncharacterized LOC111109094,1528
NC_035787.1,45300256,45301356,45300256,45301356,111109096,XM_022445183.1,uncharacterized LOC111109096,1100
NC_035787.1,45403061,45408625,45403061,45408625,111109097,XM_022445184.1,uncharacterized LOC111109097,5564
NC_035787.1,45750451,45770059,45750451,45770059,111109098,XM_022445185.1,uncharacterized LOC111109098,19608
NC_035787.1,45906570,45908696,45906570,45908696,111109101,XM_022445189.1,uncharacterized LOC111109101,2126
NC_035787.1,45995545,45996168,45995545,45996168,111109102,XM_022445190.1,uncharacterized LOC111109102,623
NC_035787.1,46032279,46051204,46032279,46051204,111109103,XM_022445191.1,uncharacterized LOC111109103,18925
NC_035780.1,27103050,27117889,27103050,27113773,111109105,XM_022445199.1,uncharacterized LOC111109105,10723
NC_035780.1,27103050,27117889,27103050,27114542,111109105,XM_022445206.1,uncharacterized LOC111109105,11492
NC_035780.1,27103050,27117889,27103070,27117889,111109105,XM_022445213.1,uncharacterized LOC111109105,14819
NC_035780.1,27103050,27117889,27103050,27110080,111109105,XM_022445194.1,uncharacterized LOC111109105,7030
NC_035787.1,46161275,46164259,46161275,46164259,111109106,XM_022445192.1,uncharacterized LOC111109106,2984
NC_035787.1,46596963,46597568,46596963,46597568,111109107,XM_022445193.1,uncharacterized LOC111109107,605
NC_035787.1,46775300,46776613,46775300,46776613,111109109,XM_022445196.1,uncharacterized LOC111109109,1313
NC_035787.1,46778622,46789588,46778622,46789588,111109110,XM_022445197.1,uncharacterized LOC111109110,10966
NC_035787.1,47039391,47041172,47039391,47041172,111109111,XM_022445198.1,uncharacterized LOC111109111,1781
NC_035787.1,47070310,47070705,47070310,47070705,111109113,XM_022445201.1,uncharacterized LOC111109113,395
NC_035787.1,47219704,47228362,47219704,47228362,111109116,XM_022445204.1,uncharacterized LOC111109116,8658
NC_035787.1,47289437,47297766,47289437,47297766,111109117,XM_022445205.1,uncharacterized LOC111109117,8329
NC_035787.1,47299119,47301557,47299119,47301557,111109118,XM_022445207.1,uncharacterized LOC111109118,2438
NC_035787.1,47302605,47314091,47302605,47314091,111109119,XM_022445208.1,uncharacterized LOC111109119,11486
NC_035787.1,47314599,47316781,47314599,47316781,111109120,XM_022445209.1,uncharacterized LOC111109120,2182
NC_035787.1,47318663,47320046,47318663,47320046,111109121,XM_022445210.1,uncharacterized LOC111109121,1383
NC_035787.1,47774228,47777024,47774228,47777024,111109124,XM_022445212.1,uncharacterized LOC111109124,2796
NC_035787.1,48421332,48426386,48421332,48426386,111109126,XM_022445215.1,uncharacterized LOC111109126,5054
NC_035787.1,48428192,48434897,48428192,48434897,111109127,XM_022445216.1,uncharacterized LOC111109127,6705
NC_035780.1,26971999,26982994,26972015,26982994,111109132,XM_022446316.1,uncharacterized LOC111109132,10979
NC_035780.1,26971999,26982994,26971999,26982994,111109132,XM_022445560.1,uncharacterized LOC111109132,10995
NC_035787.1,49517690,49522750,49517690,49522750,111109138,XM_022445225.1,uncharacterized LOC111109138,5060
NC_035787.1,49562803,49563455,49562803,49563455,111109139,XM_022445226.1,uncharacterized LOC111109139,652
NC_035787.1,49748151,49749740,49748151,49749740,111109141,XM_022445227.1,uncharacterized LOC111109141,1589
NC_035787.1,49751114,49752544,49751114,49752544,111109142,XM_022445228.1,uncharacterized LOC111109142,1430
NC_035787.1,49760880,49766868,49760880,49766868,111109143,XM_022445229.1,uncharacterized LOC111109143,5988
NC_035787.1,49878523,49887735,49878523,49887735,111109145,XM_022445230.1,uncharacterized LOC111109145,9212
NC_035787.1,49892632,49893486,49892632,49893486,111109146,XM_022445231.1,uncharacterized LOC111109146,854
NC_035787.1,49918669,49939378,49918669,49939378,111109147,XM_022445232.1,uncharacterized LOC111109147,20709
NC_035787.1,49997986,50001793,49997986,50001793,111109148,XM_022445233.1,uncharacterized LOC111109148,3807
NC_035787.1,50015930,50022430,50015930,50022430,111109149,XM_022445234.1,uncharacterized LOC111109149,6500
NC_035787.1,50482045,50483652,50482045,50483652,111109150,XM_022445235.1,uncharacterized LOC111109150,1607
NC_035787.1,50483825,50485320,50483825,50485320,111109151,XM_022445236.1,uncharacterized LOC111109151,1495
NC_035787.1,51179229,51180938,51179229,51180938,111109157,XM_022445241.1,uncharacterized LOC111109157,1709
NC_035787.1,51701815,51713037,51701815,51713037,111109159,XM_022445243.1,uncharacterized LOC111109159,11222
NC_035787.1,51868120,51870884,51868120,51870884,111109161,XM_022445244.1,uncharacterized LOC111109161,2764
NC_035787.1,52385424,52388169,52385424,52388169,111109164,XM_022445246.1,uncharacterized LOC111109164,2745
NC_035787.1,52574369,52575205,52574369,52575205,111109166,XM_022445248.1,uncharacterized LOC111109166,836
NC_035787.1,52608523,52610722,52608523,52610722,111109168,XM_022445250.1,uncharacterized LOC111109168,2199
NC_035780.1,11927862,11940876,11928190,11940876,111109174,XM_022445265.1,uncharacterized LOC111109174,12686
NC_035780.1,11927862,11940876,11927862,11940876,111109174,XM_022445258.1,uncharacterized LOC111109174,13014
NC_035787.1,53618122,53619039,53618122,53619039,111109175,XM_022445256.1,uncharacterized LOC111109175,917
NC_035787.1,53688516,53761216,53688516,53761216,111109176,XM_022445257.1,uncharacterized LOC111109176,72700
NC_035787.1,53772278,53801805,53772278,53801805,111109177,XM_022445259.1,uncharacterized LOC111109177,29527
NC_035787.1,53817805,53844466,53817805,53844466,111109178,XM_022445260.1,uncharacterized LOC111109178,26661
NC_035787.1,53999389,54010504,53999389,54010504,111109179,XM_022445261.1,uncharacterized LOC111109179,11115
NC_035787.1,54377873,54379818,54377873,54379818,111109183,XM_022445266.1,uncharacterized LOC111109183,1945
NC_035787.1,54544092,54547246,54544092,54547246,111109184,XM_022445267.1,uncharacterized LOC111109184,3154
NC_035787.1,54665792,54685910,54665792,54685910,111109188,XM_022445271.1,uncharacterized LOC111109188,20118
NC_035787.1,54723451,54728307,54723451,54728307,111109189,XM_022445272.1,uncharacterized LOC111109189,4856
NC_035780.1,43129946,43131761,43129946,43131761,111109190,XM_022445276.1,uncharacterized LOC111109190,1815
NC_035787.1,54761416,54762256,54761416,54762256,111109192,XM_022445274.1,uncharacterized LOC111109192,840
NC_035787.1,54834697,54845875,54834697,54845875,111109193,XM_022445275.1,uncharacterized LOC111109193,11178
NC_035787.1,55221350,55222986,55221350,55222986,111109196,XM_022445279.1,uncharacterized LOC111109196,1636
NC_035787.1,55231462,55241938,55231462,55241938,111109197,XM_022445280.1,uncharacterized LOC111109197,10476
NC_035787.1,55575651,55578558,55575651,55578558,111109200,XM_022445283.1,uncharacterized LOC111109200,2907
NC_035787.1,55584364,55585567,55584364,55585567,111109202,XM_022445285.1,uncharacterized LOC111109202,1203
NC_035787.1,55604897,55606237,55604897,55606237,111109203,XM_022445286.1,uncharacterized LOC111109203,1340
NC_035787.1,55700409,55700807,55700409,55700807,111109205,XM_022445289.1,uncharacterized LOC111109205,398
NC_035787.1,56159207,56162744,56159207,56162744,111109209,XM_022445293.1,uncharacterized LOC111109209,3537
NC_035787.1,56455911,56457560,56455911,56457560,111109210,XM_022445294.1,uncharacterized LOC111109210,1649
NC_035787.1,56741145,56751721,56741145,56751721,111109212,XM_022445297.1,uncharacterized LOC111109212,10576
NC_035787.1,56880524,56885434,56880524,56885434,111109213,XM_022445298.1,uncharacterized LOC111109213,4910
NC_035787.1,56996638,57001101,56996638,57001101,111109214,XM_022445299.1,uncharacterized LOC111109214,4463
NC_035787.1,57019890,57023855,57019890,57023855,111109217,XM_022445302.1,uncharacterized LOC111109217,3965
NC_035787.1,57027171,57030024,57027171,57030024,111109219,XM_022445303.1,uncharacterized LOC111109219,2853
NC_035787.1,57062049,57062645,57062049,57062645,111109220,XM_022445304.1,uncharacterized LOC111109220,596
NC_035787.1,57116333,57117036,57116333,57117036,111109223,XM_022445306.1,uncharacterized LOC111109223,703
NC_035787.1,57164453,57168418,57164453,57168418,111109224,XM_022445307.1,uncharacterized LOC111109224,3965
NC_035787.1,57652248,57658311,57652248,57658311,111109229,XM_022445312.1,uncharacterized LOC111109229,6063
NC_035787.1,57685767,57686438,57685767,57686438,111109230,XM_022445313.1,uncharacterized LOC111109230,671
NC_035787.1,57690213,57692510,57690213,57692510,111109231,XM_022445314.1,uncharacterized LOC111109231,2297
NC_035787.1,58205533,58207664,58205533,58207664,111109238,XM_022445321.1,uncharacterized LOC111109238,2131
NC_035787.1,58345486,58347406,58345486,58347406,111109239,XM_022445322.1,uncharacterized LOC111109239,1920
NC_035787.1,58387955,58398579,58387955,58398579,111109240,XM_022445323.1,uncharacterized LOC111109240,10624
NC_035787.1,58543524,58547157,58543524,58547157,111109241,XM_022445324.1,uncharacterized LOC111109241,3633
NC_035787.1,58701318,58712550,58701318,58712550,111109245,XM_022445327.1,uncharacterized LOC111109245,11232
NC_035787.1,58858879,58859583,58858879,58859583,111109246,XM_022445328.1,uncharacterized LOC111109246,704
NC_035787.1,59073503,59075505,59073503,59075505,111109248,XM_022445331.1,uncharacterized LOC111109248,2002
NC_035787.1,59550853,59553787,59550853,59553787,111109249,XM_022445332.1,uncharacterized LOC111109249,2934
NC_035787.1,59567521,59669740,59567521,59669740,111109250,XM_022445333.1,uncharacterized LOC111109250,102219
NC_035787.1,59684165,59685187,59684165,59685187,111109251,XM_022445334.1,uncharacterized LOC111109251,1022
NC_035780.1,56571059,56573269,56571059,56573269,111109253,XM_022445339.1,uncharacterized LOC111109253,2210
NC_035787.1,61241514,61243553,61241514,61243553,111109259,XM_022445342.1,uncharacterized LOC111109259,2039
NC_035787.1,61243633,61244463,61243633,61244463,111109260,XM_022445343.1,uncharacterized LOC111109260,830
NC_035787.1,61474563,61488961,61474563,61488961,111109261,XM_022445344.1,uncharacterized LOC111109261,14398
NC_035780.1,12870986,12876196,12871117,12876196,111109263,XM_022445355.1,uncharacterized LOC111109263,5079
NC_035780.1,12870986,12876196,12870986,12876196,111109263,XM_022445349.1,uncharacterized LOC111109263,5210
NC_035787.1,62498465,62499001,62498465,62499001,111109269,XM_022445352.1,uncharacterized LOC111109269,536
NC_035787.1,62624334,62641005,62624334,62641005,111109271,XM_022445353.1,uncharacterized LOC111109271,16671
NC_035787.1,62678414,62684926,62678414,62684926,111109272,XM_022445354.1,uncharacterized LOC111109272,6512
NC_035787.1,63593389,63595024,63593389,63595024,111109276,XM_022445359.1,uncharacterized LOC111109276,1635
NC_035787.1,63728885,63732064,63728885,63732064,111109277,XM_022445360.1,uncharacterized LOC111109277,3179
NC_035787.1,63775011,63775642,63775011,63775642,111109278,XM_022445361.1,uncharacterized LOC111109278,631
NC_035780.1,11656126,11659695,11656126,11659695,111109279,XM_022445365.1,uncharacterized LOC111109279,3569
NC_035787.1,63858094,63858783,63858094,63858783,111109282,XM_022445364.1,uncharacterized LOC111109282,689
NC_035787.1,4613372,4617641,4613372,4617641,111109285,XM_022445367.1,uncharacterized LOC111109285,4269
NC_035787.1,64263075,64268198,64263075,64268198,111109288,XM_022445370.1,uncharacterized LOC111109288,5123
NC_035787.1,64529343,64532580,64529343,64532580,111109293,XM_022445373.1,uncharacterized LOC111109293,3237
NC_035787.1,64586327,64588261,64586327,64588261,111109294,XM_022445375.1,uncharacterized LOC111109294,1934
NC_035787.1,64938466,64939766,64938466,64939766,111109296,XM_022445377.1,uncharacterized LOC111109296,1300
NC_035780.1,55503739,55510028,55503739,55510028,111109301,XM_022445385.1,uncharacterized LOC111109301,6289
NC_035787.1,65645008,65646677,65645008,65646677,111109304,XM_022445384.1,uncharacterized LOC111109304,1669
NC_035787.1,65654749,65655372,65654749,65655372,111109305,XM_022445386.1,uncharacterized LOC111109305,623
NC_035787.1,65750404,65759333,65750404,65759333,111109306,XM_022445387.1,uncharacterized LOC111109306,8929
NC_035787.1,65911437,65935138,65911437,65935138,111109309,XM_022445390.1,uncharacterized LOC111109309,23701
NC_035787.1,65969892,65970833,65969892,65970833,111109310,XM_022445391.1,uncharacterized LOC111109310,941
NC_035780.1,55510279,55517891,55510279,55517891,111109311,XM_022445395.1,uncharacterized LOC111109311,7612
NC_035787.1,66710629,66716215,66710629,66716215,111109315,XM_022445396.1,uncharacterized LOC111109315,5586
NC_035787.1,66878551,66884191,66878551,66884191,111109317,XM_022445398.1,uncharacterized LOC111109317,5640
NC_035787.1,66975910,66976935,66975910,66976935,111109318,XM_022445399.1,uncharacterized LOC111109318,1025
NC_035787.1,67079920,67081188,67079920,67081188,111109319,XM_022445400.1,uncharacterized LOC111109319,1268
NC_035780.1,7970408,7975154,7970408,7975153,111109321,XM_022445404.1,uncharacterized LOC111109321,4745
NC_035780.1,7970408,7975154,7970408,7975154,111109321,XM_022445410.1,uncharacterized LOC111109321,4746
NC_035787.1,67120443,67122116,67120443,67122116,111109322,XM_022445402.1,uncharacterized LOC111109322,1673
NC_035787.1,67125691,67126314,67125691,67126314,111109323,XM_022445403.1,uncharacterized LOC111109323,623
NC_035787.1,67627298,67632393,67627298,67632393,111109328,XM_022445409.1,uncharacterized LOC111109328,5095
NC_035787.1,67832670,67833194,67832670,67833194,111109330,XM_022445412.1,uncharacterized LOC111109330,524
NC_035787.1,68450816,68458490,68450816,68458490,111109333,XM_022445416.1,uncharacterized LOC111109333,7674
NC_035787.1,68660458,68663130,68660458,68663130,111109334,XM_022445417.1,uncharacterized LOC111109334,2672
NC_035787.1,70499839,70500930,70499839,70500930,111109346,XM_022445426.1,uncharacterized LOC111109346,1091
NC_035787.1,70604147,70608266,70604147,70608266,111109348,XM_022445429.1,uncharacterized LOC111109348,4119
NC_035787.1,70897445,70899923,70897445,70899923,111109355,XM_022445433.1,uncharacterized LOC111109355,2478
NC_035787.1,70977040,70980655,70977040,70980655,111109356,XM_022445435.1,uncharacterized LOC111109356,3615
NC_035787.1,72157739,72160089,72157739,72160089,111109359,XM_022445438.1,uncharacterized LOC111109359,2350
NC_035787.1,74107790,74139222,74107790,74139222,111109368,XM_022445446.1,uncharacterized LOC111109368,31432
NC_035787.1,74325729,74326887,74325729,74326887,111109371,XM_022445448.1,uncharacterized LOC111109371,1158
NC_035787.1,74352546,74356019,74352546,74356019,111109372,XM_022445449.1,uncharacterized LOC111109372,3473
NC_035787.1,74722852,74730526,74722852,74730526,111109380,XM_022445459.1,uncharacterized LOC111109380,7674
NC_035787.1,74736709,74739510,74736709,74739510,111109381,XM_022445460.1,uncharacterized LOC111109381,2801
NC_035787.1,75232968,75238867,75232968,75238867,111109385,XM_022445464.1,uncharacterized LOC111109385,5899
NC_035787.1,75246584,75254225,75246584,75254225,111109386,XM_022445465.1,uncharacterized LOC111109386,7641
NC_035787.1,75347906,75353878,75347906,75353878,111109388,XM_022445468.1,uncharacterized LOC111109388,5972
NC_035787.1,75469822,75470709,75469822,75470709,111109389,XM_022445469.1,uncharacterized LOC111109389,887
NC_035787.1,75602002,75609193,75602002,75609193,111109391,XM_022445471.1,uncharacterized LOC111109391,7191
NC_035787.1,75836833,75838607,75836833,75838607,111109393,XM_022445472.1,uncharacterized LOC111109393,1774
NC_035787.1,75850240,75857305,75850240,75857305,111109394,XM_022445473.1,uncharacterized LOC111109394,7065
NC_035787.1,75865941,75881963,75865941,75881963,111109395,XM_022445475.1,uncharacterized LOC111109395,16022
NC_035787.1,75914571,75915513,75914571,75915513,111109396,XM_022445476.1,uncharacterized LOC111109396,942
NC_035780.1,8672409,8679479,8672409,8679479,111109398,XM_022445519.1,uncharacterized LOC111109398,7070
NC_035787.1,20897822,20903745,20897822,20903745,111109400,XM_022445480.1,uncharacterized LOC111109400,5923
NC_035787.1,9399435,9402585,9399435,9402584,111109401,XM_022445481.1,uncharacterized LOC111109401,3149
NC_035787.1,9399435,9402585,9399435,9402585,111109401,XM_022445482.1,uncharacterized LOC111109401,3150
NC_035787.1,21995149,22036804,21995149,22020824,111109404,XM_022445489.1,uncharacterized LOC111109404,25675
NC_035787.1,21995149,22036804,21995149,22033668,111109404,XM_022445486.1,uncharacterized LOC111109404,38519
NC_035787.1,21995149,22036804,21995149,22033673,111109404,XM_022445490.1,uncharacterized LOC111109404,38524
NC_035787.1,21995149,22036804,21995149,22036799,111109404,XM_022445484.1,uncharacterized LOC111109404,41650
NC_035787.1,21995149,22036804,21995149,22036804,111109404,XM_022445487.1,uncharacterized LOC111109404,41655
NC_035787.1,21384100,21406987,21384100,21406331,111109405,XM_022445492.1,uncharacterized LOC111109405,22231
NC_035787.1,21384100,21406987,21384100,21406987,111109405,XM_022445491.1,uncharacterized LOC111109405,22887
NC_035787.1,21398417,21404125,21398417,21404125,111109406,XM_022445493.1,uncharacterized LOC111109406,5708
NC_035787.1,12777621,12782246,12777621,12782246,111109407,XM_022445495.1,uncharacterized LOC111109407,4625
NC_035787.1,12770262,12791624,12771228,12791624,111109408,XM_022445496.1,uncharacterized LOC111109408,20396
NC_035787.1,12770262,12791624,12770262,12791624,111109408,XM_022445497.1,uncharacterized LOC111109408,21362
NC_035787.1,12988620,12999873,12988620,12999873,111109409,XM_022445498.1,uncharacterized LOC111109409,11253
NC_035780.1,36080927,36097268,36080930,36097268,111109410,XM_022445511.1,uncharacterized LOC111109410,16338
NC_035780.1,36080927,36097268,36080927,36097268,111109410,XM_022445501.1,uncharacterized LOC111109410,16341
NC_035787.1,12889656,12900332,12889656,12900332,111109411,XM_022445500.1,uncharacterized LOC111109411,10676
NC_035787.1,12926980,12941204,12926980,12941204,111109413,XM_022445502.1,uncharacterized LOC111109413,14224
NC_035787.1,12979990,12985733,12979990,12985733,111109416,XM_022445512.1,uncharacterized LOC111109416,5743
NC_035787.1,12915236,12923608,12916779,12923608,111109417,XM_022445513.1,uncharacterized LOC111109417,6829
NC_035787.1,12915236,12923608,12915236,12923608,111109417,XM_022445514.1,uncharacterized LOC111109417,8372
NC_035787.1,12808724,12809900,12808724,12809900,111109420,XM_022445520.1,uncharacterized LOC111109420,1176
NC_035780.1,46147236,46151787,46147236,46151787,111109421,XM_022445523.1,uncharacterized LOC111109421,4551
NC_035787.1,56076591,56098301,56076690,56098292,111109424,XM_022445521.1,uncharacterized LOC111109424,21602
NC_035787.1,56076591,56098301,56076687,56098301,111109424,XM_022445525.1,uncharacterized LOC111109424,21614
NC_035787.1,56076591,56098301,56076608,56098292,111109424,XM_022445522.1,uncharacterized LOC111109424,21684
NC_035787.1,56076591,56098301,56076591,56098292,111109424,XM_022445524.1,uncharacterized LOC111109424,21701
NC_035787.1,71851751,71860832,71851751,71860832,111109428,XM_022445529.1,uncharacterized LOC111109428,9081
NC_035780.1,53253351,53260635,53253351,53260635,111109430,XM_022445535.1,uncharacterized LOC111109430,7284
NC_035787.1,15098990,15108579,15098990,15108579,111109431,XM_022445532.1,uncharacterized LOC111109431,9589
NC_035787.1,53221325,53222432,53221325,53222425,111109435,XM_022445542.1,uncharacterized LOC111109435,1100
NC_035787.1,53221325,53222432,53221325,53222432,111109435,XM_022445543.1,uncharacterized LOC111109435,1107
NC_035787.1,15285745,15289539,15285745,15289539,111109443,XM_022445551.1,uncharacterized LOC111109443,3794
NC_035787.1,67923325,67933796,67923325,67933796,111109445,XM_022445554.1,uncharacterized LOC111109445,10471
NC_035787.1,67917546,67922558,67917546,67922558,111109446,XM_022445555.1,uncharacterized LOC111109446,5012
NC_035787.1,16710302,16713218,16710302,16713218,111109448,XM_022445558.1,uncharacterized LOC111109448,2916
NC_035787.1,9363831,9365585,9363831,9365585,111109450,XM_022445563.1,uncharacterized LOC111109450,1754
NC_035787.1,10762316,10775891,10763555,10775878,111109455,XM_022445567.1,uncharacterized LOC111109455,12323
NC_035787.1,10762316,10775891,10763557,10775891,111109455,XM_022445566.1,uncharacterized LOC111109455,12334
NC_035787.1,10762316,10775891,10762316,10775891,111109455,XM_022445569.1,uncharacterized LOC111109455,13575
NC_035787.1,13091777,13115541,13104975,13115541,111109456,XM_022445571.1,uncharacterized LOC111109456,10566
NC_035787.1,13091777,13115541,13091777,13115541,111109456,XM_022445573.1,uncharacterized LOC111109456,23764
NC_035787.1,13098006,13099306,13098006,13099306,111109457,XM_022445574.1,uncharacterized LOC111109457,1300
NC_035787.1,18551773,18564171,18551773,18564171,111109458,XM_022445575.1,uncharacterized LOC111109458,12398
NC_035780.1,30581339,30605095,30581339,30605095,111109459,XM_022445580.1,uncharacterized LOC111109459,23756
NC_035787.1,46887352,46889373,46887352,46889373,111109460,XM_022445577.1,uncharacterized LOC111109460,2021
NC_035787.1,14287079,14292875,14287079,14292875,111109463,XM_022445581.1,uncharacterized LOC111109463,5796
NC_035787.1,56370252,56405548,56384621,56405548,111109465,XM_022445583.1,uncharacterized LOC111109465,20927
NC_035787.1,56370252,56405548,56378110,56405548,111109465,XM_022445585.1,uncharacterized LOC111109465,27438
NC_035787.1,56370252,56405548,56371495,56405548,111109465,XM_022445587.1,uncharacterized LOC111109465,34053
NC_035787.1,56370252,56405548,56370252,56405548,111109465,XM_022445586.1,uncharacterized LOC111109465,35296
NC_035787.1,56370252,56405548,56398433,56405548,111109465,XM_022445584.1,uncharacterized LOC111109465,7115
NC_035780.1,9360834,9362819,9360834,9362819,111109466,XM_022445594.1,uncharacterized LOC111109466,1985
NC_035787.1,50508203,50513453,50508388,50513453,111109467,XM_022445591.1,uncharacterized LOC111109467,5065
NC_035787.1,50508203,50513453,50508203,50513453,111109467,XM_022445592.1,uncharacterized LOC111109467,5250
NC_035787.1,11930017,11935594,11930206,11935594,111109468,XM_022445595.1,uncharacterized LOC111109468,5388
NC_035787.1,11930017,11935594,11930017,11935594,111109468,XM_022445593.1,uncharacterized LOC111109468,5577
NC_035780.1,9364226,9370196,9364932,9370134,111109473,XM_022445619.1,uncharacterized LOC111109473,5202
NC_035780.1,9364226,9370196,9364932,9370196,111109473,XM_022445607.1,uncharacterized LOC111109473,5264
NC_035780.1,9364226,9370196,9364226,9370196,111109473,XM_022445613.1,uncharacterized LOC111109473,5970
NC_035787.1,25566188,25571325,25566188,25571325,111109476,XM_022445608.1,uncharacterized LOC111109476,5137
NC_035787.1,54910555,54913528,54910555,54913528,111109478,XM_022445611.1,uncharacterized LOC111109478,2973
NC_035787.1,62026109,62027869,62026109,62027869,111109479,XM_022445612.1,uncharacterized LOC111109479,1760
NC_035787.1,27511679,27543204,27516486,27543204,111109484,XM_022445617.1,uncharacterized LOC111109484,26718
NC_035787.1,27511679,27543204,27511684,27543204,111109484,XM_022445618.1,uncharacterized LOC111109484,31520
NC_035787.1,9043029,9047041,9043029,9047041,111109485,XM_022445620.1,uncharacterized LOC111109485,4012
NC_035787.1,31467375,31473203,31467375,31473203,111109486,XM_022445621.1,uncharacterized LOC111109486,5828
NC_035787.1,56930736,56932169,56930736,56932169,111109488,XM_022445626.1,uncharacterized LOC111109488,1433
NC_035787.1,56927552,56930712,56927552,56930712,111109489,XM_022445627.1,uncharacterized LOC111109489,3160
NC_035780.1,9371256,9376735,9371256,9376735,111109490,XM_022445629.1,uncharacterized LOC111109490,5479
NC_035787.1,56943491,56949436,56943491,56949436,111109491,XM_022445628.1,uncharacterized LOC111109491,5945
NC_035787.1,47685624,47731333,47685624,47696463,111109495,XM_022445633.1,uncharacterized LOC111109495,10839
NC_035787.1,47685624,47731333,47696629,47731333,111109495,XM_022445634.1,uncharacterized LOC111109495,34704
NC_035787.1,47685624,47731333,47691357,47731333,111109495,XM_022445636.1,uncharacterized LOC111109495,39976
NC_035787.1,47685624,47731333,47691321,47731333,111109495,XM_022445635.1,uncharacterized LOC111109495,40012
NC_035787.1,47685624,47731333,47685624,47731255,111109495,XM_022445632.1,uncharacterized LOC111109495,45631
NC_035787.1,47685624,47731333,47685624,47731333,111109495,XM_022445631.1,uncharacterized LOC111109495,45709
NC_035787.1,47731277,47738621,47731277,47738621,111109496,XM_022445637.1,uncharacterized LOC111109496,7344
NC_035780.1,26349133,26360712,26349133,26360712,111109497,XM_022445652.1,uncharacterized LOC111109497,11579
NC_035787.1,27329935,27347377,27329936,27343688,111109498,XM_022445641.1,uncharacterized LOC111109498,13752
NC_035787.1,27329935,27347377,27329935,27343688,111109498,XM_022445639.1,uncharacterized LOC111109498,13753
NC_035787.1,27329935,27347377,27329936,27347376,111109498,XM_022445642.1,uncharacterized LOC111109498,17440
NC_035787.1,27329935,27347377,27329935,27347377,111109498,XM_022445640.1,uncharacterized LOC111109498,17442
NC_035787.1,27349439,27354907,27349439,27354907,111109499,XM_022445644.1,uncharacterized LOC111109499,5468
NC_035787.1,46890214,46902486,46890214,46902486,111109506,XM_022445654.1,uncharacterized LOC111109506,12272
NC_035787.1,9384972,9388458,9384972,9388458,111109507,XM_022445655.1,uncharacterized LOC111109507,3486
NC_035787.1,9388637,9394228,9389884,9394228,111109508,XM_022445656.1,uncharacterized LOC111109508,4344
NC_035787.1,9388637,9394228,9388637,9394228,111109508,XM_022445657.1,uncharacterized LOC111109508,5591
NC_035787.1,39427944,39432366,39427944,39432366,111109514,XM_022445666.1,uncharacterized LOC111109514,4422
NC_035780.1,8320999,8326294,8320999,8325679,111109516,XM_022445681.1,uncharacterized LOC111109516,4680
NC_035780.1,8320999,8326294,8321149,8326294,111109516,XM_022445672.1,uncharacterized LOC111109516,5145
NC_035787.1,27997693,28002312,27997693,28002308,111109517,XM_022445669.1,uncharacterized LOC111109517,4615
NC_035787.1,27997693,28002312,27997693,28002312,111109517,XM_022445670.1,uncharacterized LOC111109517,4619
NC_035787.1,74826137,74829901,74826137,74829901,111109519,XM_022445673.1,uncharacterized LOC111109519,3764
NC_035787.1,58843104,58845791,58843104,58845791,111109521,XM_022445675.1,uncharacterized LOC111109521,2687
NC_035787.1,5231279,5267281,5231279,5267281,111109522,XM_022445676.1,uncharacterized LOC111109522,36002
NC_035787.1,5288842,5319203,5288842,5319203,111109523,XM_022445680.1,uncharacterized LOC111109523,30361
NC_035787.1,73151050,73184547,73151050,73184544,111109526,XM_022445687.1,uncharacterized LOC111109526,33494
NC_035787.1,73151050,73184547,73151050,73184547,111109526,XM_022445688.1,uncharacterized LOC111109526,33497
NC_035787.1,73202204,73217501,73202204,73217501,111109527,XM_022445693.1,uncharacterized LOC111109527,15297
NC_035787.1,73190192,73191819,73190192,73191819,111109528,XM_022445695.1,uncharacterized LOC111109528,1627
NC_035787.1,73193706,73196032,73194113,73196032,111109529,XM_022445696.1,uncharacterized LOC111109529,1919
NC_035787.1,13322387,13332180,13322387,13332180,111109532,XM_022445698.1,uncharacterized LOC111109532,9793
NC_035787.1,55858445,55866337,55858445,55866337,111109533,XM_022445699.1,uncharacterized LOC111109533,7892
NC_035787.1,72673796,72680754,72673796,72680754,111109535,XM_022445701.1,uncharacterized LOC111109535,6958
NC_035787.1,35541716,35544398,35541716,35544398,111109536,XM_022445702.1,uncharacterized LOC111109536,2682
NC_035787.1,53897727,53915909,53897727,53912441,111109537,XM_022445704.1,uncharacterized LOC111109537,14714
NC_035787.1,53897727,53915909,53897727,53915909,111109537,XM_022445703.1,uncharacterized LOC111109537,18182
NC_035787.1,34369639,34376965,34369639,34374742,111109543,XM_022445711.1,uncharacterized LOC111109543,5103
NC_035787.1,34369639,34376965,34369639,34374743,111109543,XM_022445710.1,uncharacterized LOC111109543,5104
NC_035787.1,34369639,34376965,34369639,34376965,111109543,XM_022445709.1,uncharacterized LOC111109543,7326
NC_035780.1,37275698,37282286,37275698,37278976,111109546,XM_022445717.1,uncharacterized LOC111109546,3278
NC_035780.1,37275698,37282286,37275698,37282286,111109546,XM_022445725.1,uncharacterized LOC111109546,6588
NC_035787.1,22484230,22496959,22485179,22496959,111109547,XM_022445714.1,uncharacterized LOC111109547,11780
NC_035787.1,22484230,22496959,22484230,22496959,111109547,XM_022445715.1,uncharacterized LOC111109547,12729
NC_035787.1,54105094,54110762,54105094,54110762,111109548,XM_022445716.1,uncharacterized LOC111109548,5668
NC_035787.1,42745450,42751485,42745450,42751485,111109549,XM_022445718.1,uncharacterized LOC111109549,6035
NC_035787.1,59087936,59101122,59087936,59101122,111109551,XM_022445719.1,uncharacterized LOC111109551,13186
NC_035787.1,13031822,13046133,13031822,13043380,111109554,XM_022445723.1,uncharacterized LOC111109554,11558
NC_035787.1,13031822,13046133,13031822,13046133,111109554,XM_022445722.1,uncharacterized LOC111109554,14311
NC_035787.1,29655667,29658259,29655667,29658259,111109556,XM_022445726.1,uncharacterized LOC111109556,2592
NC_035787.1,52742364,52743679,52742364,52743679,111109558,XM_022445729.1,uncharacterized LOC111109558,1315
NC_035787.1,38124576,38136615,38124576,38136615,111109560,XM_022445732.1,uncharacterized LOC111109560,12039
NC_035787.1,34644250,34648457,34644250,34648457,111109563,XM_022445739.1,uncharacterized LOC111109563,4207
NC_035787.1,52983609,53000452,52983609,53000452,111109567,XM_022445743.1,uncharacterized LOC111109567,16843
NC_035780.1,14397977,14400490,14397977,14400490,111109571,XM_022445749.1,uncharacterized LOC111109571,2513
NC_035787.1,53061017,53067383,53061017,53062801,111109572,XM_022445746.1,uncharacterized LOC111109572,1784
NC_035787.1,53061017,53067383,53061017,53067383,111109572,XM_022445747.1,uncharacterized LOC111109572,6366
NC_035787.1,35557837,35561772,35557837,35561772,111109573,XM_022445748.1,uncharacterized LOC111109573,3935
NC_035787.1,25349397,25368839,25349397,25368839,111109579,XM_022445756.1,uncharacterized LOC111109579,19442
NC_035787.1,22890519,22895528,22890519,22895528,111109584,XM_022445762.1,uncharacterized LOC111109584,5009
NC_035787.1,17639229,17656217,17644358,17656217,111109585,XM_022445765.1,uncharacterized LOC111109585,11859
NC_035787.1,17639229,17656217,17639229,17656217,111109585,XM_022445764.1,uncharacterized LOC111109585,16988
NC_035787.1,17639229,17656217,17652008,17656217,111109585,XM_022445763.1,uncharacterized LOC111109585,4209
NC_035787.1,24294533,24298142,24294533,24298142,111109587,XM_022445768.1,uncharacterized LOC111109587,3609
NC_035787.1,59056261,59059505,59056261,59059505,111109588,XM_022445769.1,uncharacterized LOC111109588,3244
NC_035787.1,24306208,24309384,24306208,24309384,111109593,XM_022445782.1,uncharacterized LOC111109593,3176
NC_035787.1,949547,953755,949547,953755,111109594,XM_022445783.1,uncharacterized LOC111109594,4208
NC_035787.1,24062844,24066244,24062844,24066244,111109596,XM_022445784.1,uncharacterized LOC111109596,3400
NC_035787.1,29723379,29726504,29723379,29726504,111109597,XM_022445790.1,uncharacterized LOC111109597,3125
NC_035787.1,4794673,4796527,4794673,4796527,111109598,XM_022445791.1,uncharacterized LOC111109598,1854
NC_035787.1,25071161,25084069,25071161,25084069,111109600,XM_022445792.1,uncharacterized LOC111109600,12908
NC_035787.1,35548406,35553825,35551492,35553825,111109604,XM_022445796.1,uncharacterized LOC111109604,2333
NC_035787.1,53923289,53925774,53923289,53925774,111109607,XM_022445799.1,uncharacterized LOC111109607,2485
NC_035787.1,34359394,34362285,34359394,34362285,111109609,XM_022445801.1,uncharacterized LOC111109609,2891
NC_035787.1,35537537,35539807,35537537,35539807,111109613,XM_022445806.1,uncharacterized LOC111109613,2270
NC_035787.1,4282872,4292868,4282872,4292868,111109614,XM_022445807.1,uncharacterized LOC111109614,9996
NC_035787.1,4264606,4269158,4264606,4269158,111109615,XM_022445808.1,uncharacterized LOC111109615,4552
NC_035787.1,22235109,22248779,22235109,22248779,111109617,XM_022445811.1,uncharacterized LOC111109617,13670
NC_035787.1,24298415,24302982,24298415,24302982,111109619,XM_022445814.1,uncharacterized LOC111109619,4567
NC_035787.1,22249259,22252288,22249259,22252288,111109621,XM_022445816.1,uncharacterized LOC111109621,3029
NC_035787.1,11516006,11531391,11516006,11531391,111109624,XM_022445820.1,uncharacterized LOC111109624,15385
NC_035787.1,2213934,2217934,2213934,2217934,111109625,XM_022445821.1,uncharacterized LOC111109625,4000
NC_035787.1,64061917,64064223,64061917,64064223,111109626,XM_022445822.1,uncharacterized LOC111109626,2306
NC_035787.1,4687373,4697842,4687381,4697842,111109630,XM_022445830.1,uncharacterized LOC111109630,10461
NC_035787.1,4687373,4697842,4687373,4697842,111109630,XM_022445828.1,uncharacterized LOC111109630,10469
NC_035787.1,48448913,48452020,48448913,48452020,111109631,XM_022445833.1,uncharacterized LOC111109631,3107
NC_035787.1,48446385,48448904,48446385,48448904,111109632,XM_022445834.1,uncharacterized LOC111109632,2519
NC_035787.1,29850965,29853090,29850965,29853090,111109635,XM_022445840.1,uncharacterized LOC111109635,2125
NC_035780.1,48480560,48502855,48480560,48502855,111109641,XM_022445849.1,uncharacterized LOC111109641,22295
NC_035780.1,48480560,48502855,48480560,48486040,111109641,XM_022445858.1,uncharacterized LOC111109641,5480
NC_035787.1,30908038,30928810,30908038,30928810,111109644,XM_022445848.1,uncharacterized LOC111109644,20772
NC_035787.1,24366908,24371738,24366908,24371738,111109653,XM_022445863.1,uncharacterized LOC111109653,4830
NC_035787.1,74797005,74799485,74797005,74799485,111109654,XM_022445864.1,uncharacterized LOC111109654,2480
NC_035787.1,58992208,59000569,58992307,59000569,111109663,XM_022445875.1,uncharacterized LOC111109663,8262
NC_035787.1,58992208,59000569,58992208,59000569,111109663,XM_022445874.1,uncharacterized LOC111109663,8361
NC_035787.1,64828267,64833815,64828267,64830135,111109664,XM_022445878.1,uncharacterized LOC111109664,1868
NC_035787.1,64828267,64833815,64828267,64831356,111109664,XM_022445877.1,uncharacterized LOC111109664,3089
NC_035787.1,15370608,15380096,15370608,15380096,111109669,XM_022445883.1,uncharacterized LOC111109669,9488
NC_035787.1,23485256,23489492,23485256,23489492,111109670,XM_022445884.1,uncharacterized LOC111109670,4236
NC_035787.1,23513494,23523192,23513494,23523192,111109672,XM_022445889.1,uncharacterized LOC111109672,9698
NC_035787.1,56424350,56441703,56424350,56439498,111109675,XM_022445892.1,uncharacterized LOC111109675,15148
NC_035787.1,56424350,56441703,56424350,56441703,111109675,XM_022445891.1,uncharacterized LOC111109675,17353
NC_035787.1,16112779,16114656,16112779,16114656,111109676,XM_022445893.1,uncharacterized LOC111109676,1877
NC_035787.1,16699195,16703129,16699195,16703129,111109681,XM_022445899.1,uncharacterized LOC111109681,3934
NC_035787.1,40214363,40227927,40214363,40227927,111109682,XM_022445900.1,uncharacterized LOC111109682,13564
NC_035787.1,1007676,1011746,1007676,1011746,111109683,XM_022445901.1,uncharacterized LOC111109683,4070
NC_035780.1,11128836,11135322,11128836,11135322,111109684,XM_022445905.1,uncharacterized LOC111109684,6486
NC_035787.1,69002187,69014238,69002187,69014238,111109686,XM_022445903.1,uncharacterized LOC111109686,12051
NC_035787.1,19223903,19243534,19223903,19243534,111109687,XM_022445904.1,uncharacterized LOC111109687,19631
NC_035787.1,52122491,52129072,52122491,52129072,111109690,XM_022445908.1,uncharacterized LOC111109690,6581
NC_035787.1,58506741,58513232,58506741,58513232,111109692,XM_022445911.1,uncharacterized LOC111109692,6491
NC_035787.1,74153763,74177765,74153763,74177765,111109695,XM_022445916.1,uncharacterized LOC111109695,24002
NC_035787.1,45314076,45318412,45314076,45318412,111109696,XM_022445917.1,uncharacterized LOC111109696,4336
NC_035787.1,22077309,22079430,22077309,22079430,111109697,XM_022445918.1,uncharacterized LOC111109697,2121
NC_035787.1,36057728,36059883,36057728,36059883,111109702,XM_022445924.1,uncharacterized LOC111109702,2155
NC_035787.1,38307775,38335937,38307775,38335937,111109704,XM_022445926.1,uncharacterized LOC111109704,28162
NC_035787.1,16573701,16578332,16574815,16578332,111109711,XM_022445932.1,uncharacterized LOC111109711,3517
NC_035787.1,16573701,16578332,16573701,16578332,111109711,XM_022445933.1,uncharacterized LOC111109711,4631
NC_035787.1,49950544,49952869,49950544,49952869,111109712,XM_022445934.1,uncharacterized LOC111109712,2325
NC_035787.1,49370360,49375688,49370360,49375688,111109713,XM_022445935.1,uncharacterized LOC111109713,5328
NC_035787.1,49334080,49338883,49334080,49338883,111109714,XM_022445936.1,uncharacterized LOC111109714,4803
NC_035787.1,49366810,49368997,49366810,49368997,111109716,XM_022445938.1,uncharacterized LOC111109716,2187
NC_035787.1,24243327,24253615,24243327,24253417,111109721,XM_022445942.1,uncharacterized LOC111109721,10090
NC_035787.1,24243327,24253615,24243328,24253615,111109721,XM_022445941.1,uncharacterized LOC111109721,10287
NC_035787.1,389049,391089,389049,390943,111109723,XM_022445945.1,uncharacterized LOC111109723,1894
NC_035787.1,389049,391089,389049,391003,111109723,XM_022445946.1,uncharacterized LOC111109723,1954
NC_035787.1,389049,391089,389049,391089,111109723,XM_022445944.1,uncharacterized LOC111109723,2040
NC_035787.1,25409102,25436822,25409102,25436822,111109724,XM_022445947.1,uncharacterized LOC111109724,27720
NC_035787.1,64772703,64776211,64772703,64776211,111109727,XM_022445950.1,uncharacterized LOC111109727,3508
NC_035787.1,60206146,60213780,60206146,60213780,111109729,XM_022445953.1,uncharacterized LOC111109729,7634
NC_035787.1,9485038,9492865,9485038,9492865,111109731,XM_022445955.1,uncharacterized LOC111109731,7827
NC_035787.1,17192965,17198811,17192965,17198479,111109735,XM_022445958.1,uncharacterized LOC111109735,5514
NC_035787.1,17192965,17198811,17192965,17198811,111109735,XM_022445959.1,uncharacterized LOC111109735,5846
NC_035787.1,794762,803706,794762,798111,111109741,XM_022445965.1,uncharacterized LOC111109741,3349
NC_035787.1,794762,803706,794762,803706,111109741,XM_022445966.1,uncharacterized LOC111109741,8944
NC_035787.1,49779107,49783067,49779107,49783067,111109742,XM_022445967.1,uncharacterized LOC111109742,3960
NC_035780.1,2169940,2198004,2169940,2198004,111109745,XM_022445972.1,uncharacterized LOC111109745,28064
NC_035787.1,9087852,9093252,9087852,9093233,111109746,XM_022445970.1,uncharacterized LOC111109746,5381
NC_035787.1,9087852,9093252,9087852,9093252,111109746,XM_022445969.1,uncharacterized LOC111109746,5400
NC_035780.1,2071890,2139231,2071890,2139231,111109754,XM_022445986.1,uncharacterized LOC111109754,67341
NC_035787.1,6437486,6440149,6437486,6440149,111109757,XM_022445988.1,uncharacterized LOC111109757,2663
NC_035787.1,37983411,37985272,37983411,37985272,111109758,XM_022445989.1,uncharacterized LOC111109758,1861
NC_035780.1,46017855,46022609,46019490,46022609,111109769,XM_022446003.1,uncharacterized LOC111109769,3119
NC_035780.1,46017855,46022609,46017855,46022609,111109769,XM_022446011.1,uncharacterized LOC111109769,4754
NC_035787.1,75177811,75191492,75177811,75191492,111109772,XM_022446004.1,uncharacterized LOC111109772,13681
NC_035787.1,10677906,10680206,10677906,10680206,111109774,XM_022446006.1,uncharacterized LOC111109774,2300
NC_035787.1,39936543,39938669,39936543,39938669,111109776,XM_022446008.1,uncharacterized LOC111109776,2126
NC_035787.1,9145756,9150968,9145756,9150968,111109777,XM_022446009.1,uncharacterized LOC111109777,5212
NC_035787.1,3222222,3224018,3222222,3224018,111109781,XM_022446014.1,uncharacterized LOC111109781,1796
NC_035787.1,38282154,38284287,38282154,38284287,111109785,XM_022446019.1,uncharacterized LOC111109785,2133
NC_035787.1,11461892,11471203,11461892,11471203,111109787,XM_022446023.1,uncharacterized LOC111109787,9311
NC_035787.1,58517241,58523719,58517243,58523719,111109788,XM_022446025.1,uncharacterized LOC111109788,6476
NC_035787.1,58517241,58523719,58517241,58523719,111109788,XM_022446024.1,uncharacterized LOC111109788,6478
NC_035787.1,8127687,8130697,8127687,8130697,111109790,XM_022446026.1,uncharacterized LOC111109790,3010
NC_035787.1,26842444,26852030,26842444,26852030,111109795,XM_022446030.1,uncharacterized LOC111109795,9586
NC_035787.1,24987486,24990779,24987486,24990779,111109798,XM_022446034.1,uncharacterized LOC111109798,3293
NC_035787.1,20131771,20137605,20131771,20137605,111109799,XM_022446035.1,uncharacterized LOC111109799,5834
NC_035787.1,49290369,49300641,49290369,49300641,111109800,XM_022446036.1,uncharacterized LOC111109800,10272
NC_035787.1,56038433,56046395,56038433,56046395,111109801,XM_022446037.1,uncharacterized LOC111109801,7962
NC_035787.1,349644,355163,349644,355163,111109810,XM_022446049.1,uncharacterized LOC111109810,5519
NC_035787.1,36750225,36758190,36750225,36758190,111109811,XM_022446050.1,uncharacterized LOC111109811,7965
NC_035787.1,11961370,11963280,11961370,11963280,111109816,XM_022446057.1,uncharacterized LOC111109816,1910
NC_035787.1,71715664,71725513,71715664,71725513,111109820,XM_022446060.1,uncharacterized LOC111109820,9849
NC_035787.1,70510307,70511476,70510307,70511476,111109824,XM_022446065.1,uncharacterized LOC111109824,1169
NC_035787.1,10186387,10188667,10186387,10188667,111109825,XM_022446066.1,uncharacterized LOC111109825,2280
NC_035787.1,47972429,47974387,47972429,47974387,111109826,XM_022446068.1,uncharacterized LOC111109826,1958
NC_035787.1,38303049,38305327,38303049,38305327,111109828,XM_022446070.1,uncharacterized LOC111109828,2278
NC_035787.1,32770889,32774448,32770889,32774448,111109835,XM_022446084.1,uncharacterized LOC111109835,3559
NC_035787.1,61440826,61443209,61440826,61443209,111109837,XM_022446086.1,uncharacterized LOC111109837,2383
NC_035787.1,72977977,72986918,72977977,72985988,111109840,XM_022446088.1,uncharacterized LOC111109840,8011
NC_035787.1,72977977,72986918,72977977,72986918,111109840,XM_022446087.1,uncharacterized LOC111109840,8941
NC_035787.1,13657942,13690420,13657942,13690420,111109841,XM_022446089.1,uncharacterized LOC111109841,32478
NC_035787.1,72208159,72208860,72208159,72208860,111109842,XM_022446091.1,uncharacterized LOC111109842,701
NC_035787.1,46802041,46816323,46802041,46816323,111109843,XM_022446092.1,uncharacterized LOC111109843,14282
NC_035787.1,50401207,50404777,50401207,50404777,111109846,XM_022446097.1,uncharacterized LOC111109846,3570
NC_035787.1,61871900,61888498,61871900,61888498,111109847,XM_022446098.1,uncharacterized LOC111109847,16598
NC_035787.1,36160796,36170210,36160796,36170210,111109851,XM_022446100.1,uncharacterized LOC111109851,9414
NC_035787.1,33345139,33353751,33350675,33353751,111109855,XM_022446107.1,uncharacterized LOC111109855,3076
NC_035787.1,33345139,33353751,33345139,33353751,111109855,XM_022446106.1,uncharacterized LOC111109855,8612
NC_035787.1,72251653,72265111,72251653,72265111,111109857,XM_022446108.1,uncharacterized LOC111109857,13458
NC_035787.1,68833093,68838336,68833093,68838336,111109863,XM_022446116.1,uncharacterized LOC111109863,5243
NC_035787.1,4668873,4670353,4668873,4670353,111109866,XM_022446118.1,uncharacterized LOC111109866,1480
NC_035787.1,25743003,25751376,25748713,25751376,111109868,XM_022446120.1,uncharacterized LOC111109868,2663
NC_035787.1,25743003,25751376,25743003,25751376,111109868,XM_022446123.1,uncharacterized LOC111109868,8373
NC_035787.1,11500765,11508722,11500765,11508016,111109869,XM_022446124.1,uncharacterized LOC111109869,7251
NC_035787.1,11500765,11508722,11500765,11508194,111109869,XM_022446125.1,uncharacterized LOC111109869,7429
NC_035787.1,11500765,11508722,11500765,11508722,111109869,XM_022446126.1,uncharacterized LOC111109869,7957
NC_035787.1,22983399,22990377,22983399,22990377,111109870,XM_022446127.1,uncharacterized LOC111109870,6978
NC_035780.1,44572173,44574973,44572265,44574973,111109873,XM_022446139.1,uncharacterized LOC111109873,2708
NC_035780.1,44572173,44574973,44572173,44574973,111109873,XM_022446131.1,uncharacterized LOC111109873,2800
NC_035787.1,18716681,18718792,18716681,18718792,111109875,XM_022446130.1,uncharacterized LOC111109875,2111
NC_035787.1,44473458,44479386,44473458,44479386,111109879,XM_022446134.1,uncharacterized LOC111109879,5928
NC_035787.1,7824874,7827977,7824874,7827977,111109880,XM_022446136.1,uncharacterized LOC111109880,3103
NC_035787.1,7836326,7838987,7836326,7838987,111109881,XM_022446137.1,uncharacterized LOC111109881,2661
NC_035787.1,12047908,12050689,12047908,12050689,111109882,XM_022446138.1,uncharacterized LOC111109882,2781
NC_035787.1,27360904,27368120,27360904,27368120,111109883,XM_022446140.1,uncharacterized LOC111109883,7216
NC_035787.1,46457447,46466802,46457447,46466802,111109891,XM_022446157.1,uncharacterized LOC111109891,9355
NC_035787.1,46484176,46495645,46484176,46495645,111109892,XM_022446158.1,uncharacterized LOC111109892,11469
NC_035787.1,68254359,68293590,68254359,68286756,111109898,XM_022446159.1,uncharacterized LOC111109898,32397
NC_035787.1,68254359,68293590,68254359,68293590,111109898,XM_022446160.1,uncharacterized LOC111109898,39231
NC_035787.1,27572618,27578807,27572618,27578807,111109900,XM_022446166.1,uncharacterized LOC111109900,6189
NC_035787.1,49305448,49307357,49305448,49307357,111109903,XM_022446169.1,uncharacterized LOC111109903,1909
NC_035787.1,34351266,34353284,34351266,34353284,111109906,XM_022446172.1,uncharacterized LOC111109906,2018
NC_035787.1,54975315,54977338,54975315,54977338,111109912,XM_022446176.1,uncharacterized LOC111109912,2023
NC_035787.1,34238328,34240309,34238328,34240309,111109913,XM_022446177.1,uncharacterized LOC111109913,1981
NC_035787.1,40253782,40267151,40253791,40267151,111109914,XM_022446180.1,uncharacterized LOC111109914,13360
NC_035787.1,40253782,40267151,40253782,40267151,111109914,XM_022446179.1,uncharacterized LOC111109914,13369
NC_035780.1,53306595,53308801,53306595,53308801,111109915,XM_022446181.1,uncharacterized LOC111109915,2206
NC_035787.1,35894152,35898045,35894152,35898044,111109918,XM_022446183.1,uncharacterized LOC111109918,3892
NC_035787.1,35894152,35898045,35894152,35898045,111109918,XM_022446184.1,uncharacterized LOC111109918,3893
NC_035787.1,29835428,29838676,29835428,29838676,111109921,XM_022446188.1,uncharacterized LOC111109921,3248
NC_035780.1,53321291,53323773,53321291,53323773,111109923,XM_022446193.1,uncharacterized LOC111109923,2482
NC_035787.1,31649,35300,31649,35300,111109927,XM_022446195.1,uncharacterized LOC111109927,3651
NC_035787.1,47409025,47410672,47409025,47410672,111109928,XM_022446196.1,uncharacterized LOC111109928,1647
NC_035787.1,54554302,54558620,54554302,54558620,111109929,XM_022446197.1,uncharacterized LOC111109929,4318
NC_035787.1,18808144,18816912,18808144,18816912,111109930,XM_022446198.1,uncharacterized LOC111109930,8768
NC_035787.1,32483214,32496349,32483214,32493567,111109932,XM_022446200.1,uncharacterized LOC111109932,10353
NC_035787.1,32483214,32496349,32483214,32496349,111109932,XM_022446201.1,uncharacterized LOC111109932,13135
NC_035780.1,53294805,53296779,53294805,53296779,111109933,XM_022446204.1,uncharacterized LOC111109933,1974
NC_035787.1,62525092,62526838,62525092,62526838,111109935,XM_022446203.1,uncharacterized LOC111109935,1746
NC_035787.1,8066792,8069906,8066792,8068186,111109937,XM_022446206.1,uncharacterized LOC111109937,1394
NC_035787.1,19710103,19719994,19710103,19719994,111109938,XM_022446207.1,uncharacterized LOC111109938,9891
NC_035787.1,11648461,11652850,11648731,11652850,111109940,XM_022446208.1,uncharacterized LOC111109940,4119
NC_035787.1,11648461,11652850,11648461,11652850,111109940,XM_022446209.1,uncharacterized LOC111109940,4389
NC_035780.1,35503596,35511952,35509401,35511952,111109942,XM_022446215.1,uncharacterized LOC111109942,2551
NC_035780.1,35503596,35511952,35503596,35511952,111109942,XM_022446223.1,uncharacterized LOC111109942,8356
NC_035787.1,11874148,11878405,11874148,11878405,111109944,XM_022446213.1,uncharacterized LOC111109944,4257
NC_035787.1,49969006,49971836,49969006,49971836,111109946,XM_022446216.1,uncharacterized LOC111109946,2830
NC_035787.1,7023299,7036662,7026773,7030691,111109947,XM_022446219.1,uncharacterized LOC111109947,3918
NC_035787.1,7023299,7036662,7026773,7035079,111109947,XM_022446218.1,uncharacterized LOC111109947,8306
NC_035787.1,7023299,7036662,7026773,7036662,111109947,XM_022446217.1,uncharacterized LOC111109947,9889
NC_035787.1,7007517,7021838,7007517,7021838,111109948,XM_022446220.1,uncharacterized LOC111109948,14321
NC_035787.1,7007517,7021838,7007518,7012817,111109948,XM_022446221.1,uncharacterized LOC111109948,5299
NC_035787.1,7013739,7021018,7013782,7019324,111109949,XM_022446227.1,uncharacterized LOC111109949,5542
NC_035787.1,7013739,7021018,7013778,7019324,111109949,XM_022446224.1,uncharacterized LOC111109949,5546
NC_035787.1,7013739,7021018,7013766,7019324,111109949,XM_022446222.1,uncharacterized LOC111109949,5558
NC_035787.1,7013739,7021018,7013762,7019324,111109949,XM_022446226.1,uncharacterized LOC111109949,5562
NC_035787.1,7013739,7021018,7013756,7019324,111109949,XM_022446225.1,uncharacterized LOC111109949,5568
NC_035787.1,7013739,7021018,7013761,7021018,111109949,XM_022446228.1,uncharacterized LOC111109949,7257
NC_035787.1,7003864,7007510,7003864,7007510,111109950,XM_022446229.1,uncharacterized LOC111109950,3646
NC_035787.1,10666288,10669070,10666288,10669070,111109951,XM_022446230.1,uncharacterized LOC111109951,2782
NC_035787.1,48273711,48279910,48273711,48279910,111109952,XM_022446231.1,uncharacterized LOC111109952,6199
NC_035780.1,26129243,26141718,26129243,26141718,111109953,XM_022446243.1,uncharacterized LOC111109953,12475
NC_035780.1,26129243,26141718,26129243,26137188,111109953,XM_022446236.1,uncharacterized LOC111109953,7945
NC_035787.1,24969291,24975581,24969291,24975581,111109954,XM_022446232.1,uncharacterized LOC111109954,6290
NC_035787.1,21108321,21111893,21108321,21111893,111109957,XM_022446237.1,uncharacterized LOC111109957,3572
NC_035787.1,36810554,36821120,36810554,36821120,111109958,XM_022446238.1,uncharacterized LOC111109958,10566
NC_035787.1,22454592,22458292,22454593,22458256,111109965,XM_022446249.1,uncharacterized LOC111109965,3663
NC_035787.1,22454592,22458292,22454592,22458292,111109965,XM_022446250.1,uncharacterized LOC111109965,3700
NC_035787.1,30935925,30943118,30935925,30943118,111109976,XM_022446267.1,uncharacterized LOC111109976,7193
NC_035787.1,59411318,59420290,59411318,59420290,111109977,XM_022446268.1,uncharacterized LOC111109977,8972
NC_035787.1,24224437,24228104,24224437,24228104,111109978,XM_022446269.1,uncharacterized LOC111109978,3667
NC_035787.1,13626250,13628933,13626250,13628933,111109980,XM_022446270.1,uncharacterized LOC111109980,2683
NC_035787.1,13629060,13632350,13629160,13632047,111109981,XM_022446272.1,uncharacterized LOC111109981,2887
NC_035787.1,13629060,13632350,13629431,13632350,111109981,XM_022446273.1,uncharacterized LOC111109981,2919
NC_035787.1,13629060,13632350,13629164,13632350,111109981,XM_022446271.1,uncharacterized LOC111109981,3186
NC_035780.1,18476762,18490767,18476762,18490767,111109985,XM_022446317.1,uncharacterized LOC111109985,14005
NC_035787.1,23709181,23713860,23709181,23713860,111109987,XM_022446278.1,uncharacterized LOC111109987,4679
NC_035787.1,23729103,23734604,23729103,23734604,111109988,XM_022446280.1,uncharacterized LOC111109988,5501
NC_035787.1,69732092,69733919,69732092,69733919,111109997,XM_022446299.1,uncharacterized LOC111109997,1827
NC_035787.1,69325143,69329036,69325143,69329036,111109998,XM_022446300.1,uncharacterized LOC111109998,3893
NC_035787.1,33431990,33439536,33433009,33439536,111110001,XM_022446303.1,uncharacterized LOC111110001,6527
NC_035787.1,33431990,33439536,33431990,33439536,111110001,XM_022446302.1,uncharacterized LOC111110001,7546
NC_035780.1,11337038,11363358,11337038,11363358,111110003,XM_022446308.1,uncharacterized LOC111110003,26320
NC_035787.1,24589277,24600960,24589277,24600960,111110005,XM_022446306.1,uncharacterized LOC111110005,11683
NC_035787.1,54561789,54567375,54561789,54567375,111110010,XM_022446312.1,uncharacterized LOC111110010,5586
NC_035787.1,55142753,55150515,55142753,55150515,111110011,XM_022446313.1,uncharacterized LOC111110011,7762
NC_035787.1,45245026,45248070,45245026,45248070,111110012,XM_022446315.1,uncharacterized LOC111110012,3044
NC_035780.1,11375117,11430212,11416856,11430212,111110014,XM_022446346.1,uncharacterized LOC111110014,13356
NC_035780.1,11375117,11430212,11416855,11430212,111110014,XM_022446337.1,uncharacterized LOC111110014,13357
NC_035780.1,11375117,11430212,11375117,11430212,111110014,XM_022446321.1,uncharacterized LOC111110014,55095
NC_035787.1,17125838,17131532,17125838,17131532,111110015,XM_022446318.1,uncharacterized LOC111110015,5694
NC_035787.1,9500214,9508017,9500851,9508017,111110018,XM_022446324.1,uncharacterized LOC111110018,7166
NC_035787.1,9500214,9508017,9500214,9508017,111110018,XM_022446325.1,uncharacterized LOC111110018,7803
NC_035787.1,62571847,62580801,62571847,62580801,111110019,XM_022446326.1,uncharacterized LOC111110019,8954
NC_035787.1,17617162,17619404,17617162,17619404,111110020,XM_022446327.1,uncharacterized LOC111110020,2242
NC_035787.1,14821639,14840129,14821639,14839941,111110021,XM_022446331.1,uncharacterized LOC111110021,18302
NC_035787.1,14821639,14840129,14821639,14840101,111110021,XM_022446329.1,uncharacterized LOC111110021,18462
NC_035787.1,14821639,14840129,14821640,14840129,111110021,XM_022446333.1,uncharacterized LOC111110021,18489
NC_035787.1,14821639,14840129,14821639,14840129,111110021,XM_022446328.1,uncharacterized LOC111110021,18490
NC_035787.1,7703945,7705259,7703945,7705259,111110023,XM_022446335.1,uncharacterized LOC111110023,1314
NC_035787.1,17612594,17616656,17613589,17616656,111110024,XM_022446336.1,uncharacterized LOC111110024,3067
NC_035787.1,17612594,17616656,17612594,17616656,111110024,XM_022446338.1,uncharacterized LOC111110024,4062
NC_035787.1,17113975,17118988,17113975,17118988,111110035,XM_022446362.1,uncharacterized LOC111110035,5013
NC_035787.1,47476894,47477860,47476894,47477860,111110036,XM_022446363.1,uncharacterized LOC111110036,966
NC_035787.1,46054159,46071498,46058221,46071498,111110038,XM_022446368.1,uncharacterized LOC111110038,13277
NC_035787.1,46054159,46071498,46054161,46071498,111110038,XM_022446367.1,uncharacterized LOC111110038,17337
NC_035787.1,46054159,46071498,46054159,46071498,111110038,XM_022446366.1,uncharacterized LOC111110038,17339
NC_035787.1,27939664,27944660,27939664,27944660,111110040,XM_022446369.1,uncharacterized LOC111110040,4996
NC_035787.1,27957485,27972535,27957485,27972535,111110044,XM_022446376.1,uncharacterized LOC111110044,15050
NC_035787.1,20052250,20090621,20052250,20090621,111110046,XM_022446379.1,uncharacterized LOC111110046,38371
NC_035787.1,67781075,67786756,67781075,67786756,111110049,XM_022446380.1,uncharacterized LOC111110049,5681
NC_035787.1,34742616,34748168,34742617,34747389,111110051,XM_022446382.1,uncharacterized LOC111110051,4772
NC_035787.1,34742616,34748168,34742616,34748168,111110051,XM_022446384.1,uncharacterized LOC111110051,5552
NC_035787.1,34741675,34745067,34741675,34745067,111110052,XM_022446385.1,uncharacterized LOC111110052,3392
NC_035787.1,42677363,42682284,42677363,42682284,111110054,XM_022446388.1,uncharacterized LOC111110054,4921
NC_035780.1,11326734,11328417,11326734,11328417,111110056,XM_022446393.1,uncharacterized LOC111110056,1683
NC_035787.1,49122194,49125184,49122194,49125184,111110059,XM_022446392.1,uncharacterized LOC111110059,2990
NC_035787.1,48971012,48974353,48971012,48974353,111110060,XM_022446394.1,uncharacterized LOC111110060,3341
NC_035787.1,1847230,1850899,1847230,1850899,111110061,XM_022446395.1,uncharacterized LOC111110061,3669
NC_035787.1,49040099,49043979,49040099,49043979,111110062,XM_022446396.1,uncharacterized LOC111110062,3880
NC_035787.1,49011661,49014546,49011661,49014546,111110064,XM_022446397.1,uncharacterized LOC111110064,2885
NC_035787.1,49087508,49091296,49087508,49091296,111110065,XM_022446398.1,uncharacterized LOC111110065,3788
NC_035787.1,49061771,49066801,49061771,49066801,111110066,XM_022446399.1,uncharacterized LOC111110066,5030
NC_035787.1,49151023,49155289,49151023,49155289,111110067,XM_022446400.1,uncharacterized LOC111110067,4266
NC_035780.1,11363793,11365717,11363793,11365717,111110068,XM_022446403.1,uncharacterized LOC111110068,1924
NC_035787.1,48905925,48930528,48905925,48930528,111110069,XM_022446402.1,uncharacterized LOC111110069,24603
NC_035787.1,48905925,48930528,48927916,48930528,111110069,XM_022446401.1,uncharacterized LOC111110069,2612
NC_035787.1,68123668,68159611,68123668,68159611,111110071,XM_022446404.1,uncharacterized LOC111110071,35943
NC_035787.1,25437564,25457196,25437564,25457196,111110074,XM_022446410.1,uncharacterized LOC111110074,19632
NC_035787.1,32515951,32519653,32515951,32519653,111110075,XM_022446411.1,uncharacterized LOC111110075,3702
NC_035787.1,54691533,54695995,54691533,54695995,111110079,XM_022446413.1,uncharacterized LOC111110079,4462
NC_035787.1,72567935,72576924,72567935,72576924,111110081,XM_022446415.1,uncharacterized LOC111110081,8989
NC_035787.1,19724601,19735920,19724610,19735920,111110093,XM_022446445.1,uncharacterized LOC111110093,11310
NC_035787.1,19724601,19735920,19724601,19735915,111110093,XM_022446443.1,uncharacterized LOC111110093,11314
NC_035787.1,19724601,19735920,19724603,19728143,111110093,XM_022446444.1,uncharacterized LOC111110093,3540
NC_035787.1,19724601,19735920,19730792,19735920,111110093,XM_022446448.1,uncharacterized LOC111110093,5128
NC_035787.1,63181791,63184456,63181791,63184456,111110096,XM_022446452.1,uncharacterized LOC111110096,2665
NC_035787.1,34103816,34107658,34103816,34105959,111110107,XM_022446468.1,uncharacterized LOC111110107,2143
NC_035787.1,34103816,34107658,34105063,34107658,111110107,XM_022446467.1,uncharacterized LOC111110107,2595
NC_035787.1,50353744,50354699,50353744,50354699,111110116,XM_022446476.1,uncharacterized LOC111110116,955
NC_035787.1,9415812,9419191,9415812,9419191,111110118,XM_022446479.1,uncharacterized LOC111110118,3379
NC_035787.1,11063239,11066692,11063239,11066659,111110119,XM_022446482.1,uncharacterized LOC111110119,3420
NC_035787.1,11063239,11066692,11063239,11066692,111110119,XM_022446481.1,uncharacterized LOC111110119,3453
NC_035787.1,4224946,4247686,4224946,4247686,111110120,XM_022446484.1,uncharacterized LOC111110120,22740
NC_035787.1,4224946,4247686,4224946,4233523,111110120,XM_022446483.1,uncharacterized LOC111110120,8577
NC_035787.1,2401594,2419384,2401594,2419384,111110123,XM_022446488.1,uncharacterized LOC111110123,17790
NC_035787.1,37311776,37313924,37311776,37313924,111110126,XM_022446493.1,uncharacterized LOC111110126,2148
NC_035787.1,38113882,38118330,38113882,38118330,111110130,XM_022446501.1,uncharacterized LOC111110130,4448
NC_035780.1,4168100,4178564,4168101,4178564,111110131,XM_022446505.1,uncharacterized LOC111110131,10463
NC_035780.1,4168100,4178564,4168100,4178564,111110131,XM_022446513.1,uncharacterized LOC111110131,10464
NC_035780.1,4168100,4178564,4168100,4172986,111110131,XM_022446522.1,uncharacterized LOC111110131,4886
NC_035787.1,56350982,56356870,56351018,56356870,111110133,XM_022446504.1,uncharacterized LOC111110133,5852
NC_035787.1,56350982,56356870,56350982,56356870,111110133,XM_022446503.1,uncharacterized LOC111110133,5888
NC_035787.1,30166652,30167999,30166652,30167999,111110134,XM_022446506.1,uncharacterized LOC111110134,1347
NC_035787.1,10809322,10812265,10809322,10812175,111110136,XM_022446509.1,uncharacterized LOC111110136,2853
NC_035787.1,10809322,10812265,10809322,10812265,111110136,XM_022446510.1,uncharacterized LOC111110136,2943
NC_035787.1,58961046,58967743,58961046,58967743,111110137,XM_022446511.1,uncharacterized LOC111110137,6697
NC_035787.1,33401106,33404828,33401106,33404828,111110138,XM_022446512.1,uncharacterized LOC111110138,3722
NC_035787.1,14531678,14539175,14531678,14539175,111110141,XM_022446515.1,uncharacterized LOC111110141,7497
NC_035787.1,39895320,39900060,39895330,39899441,111110142,XM_022446520.1,uncharacterized LOC111110142,4111
NC_035787.1,39895320,39900060,39895320,39899757,111110142,XM_022446518.1,uncharacterized LOC111110142,4437
NC_035787.1,39895320,39900060,39895320,39899759,111110142,XM_022446517.1,uncharacterized LOC111110142,4439
NC_035787.1,39895320,39900060,39895330,39900060,111110142,XM_022446521.1,uncharacterized LOC111110142,4730
NC_035787.1,39895320,39900060,39895320,39900058,111110142,XM_022446519.1,uncharacterized LOC111110142,4738
NC_035787.1,9615044,9631691,9619645,9631691,111110144,XM_022446526.1,uncharacterized LOC111110144,12046
NC_035787.1,9615044,9631691,9619367,9631691,111110144,XM_022446528.1,uncharacterized LOC111110144,12324
NC_035787.1,9615044,9631691,9615044,9631691,111110144,XM_022446527.1,uncharacterized LOC111110144,16647
NC_035787.1,2226449,2237286,2226464,2237286,111110148,XM_022446531.1,uncharacterized LOC111110148,10822
NC_035787.1,2226449,2237286,2226449,2237286,111110148,XM_022446530.1,uncharacterized LOC111110148,10837
NC_035787.1,2226449,2237286,2226464,2234055,111110148,XM_022446534.1,uncharacterized LOC111110148,7591
NC_035787.1,2226449,2237286,2226464,2236026,111110148,XM_022446532.1,uncharacterized LOC111110148,9562
NC_035787.1,2226449,2237286,2226464,2236039,111110148,XM_022446533.1,uncharacterized LOC111110148,9575
NC_035787.1,32556084,32561070,32556084,32560052,111110149,XM_022446536.1,uncharacterized LOC111110149,3968
NC_035787.1,32556084,32561070,32556084,32561070,111110149,XM_022446535.1,uncharacterized LOC111110149,4986
NC_035787.1,14623623,14625743,14623623,14625743,111110151,XM_022446538.1,uncharacterized LOC111110151,2120
NC_035780.1,4408651,4429034,4408651,4429034,111110154,XM_022446545.1,uncharacterized LOC111110154,20383
NC_035787.1,27224320,27228450,27224320,27228450,111110155,XM_022446541.1,uncharacterized LOC111110155,4130
NC_035787.1,35883105,35888173,35883105,35888173,111110157,XM_022446546.1,uncharacterized LOC111110157,5068
NC_035787.1,54700141,54706498,54700141,54706498,111110160,XM_022446549.1,uncharacterized LOC111110160,6357
NC_035780.1,63374726,63378188,63374726,63378188,111110162,XM_022446555.1,uncharacterized LOC111110162,3462
NC_035787.1,57498627,57504974,57498627,57504974,111110163,XM_022446552.1,uncharacterized LOC111110163,6347
NC_035787.1,42836105,42843634,42836105,42843634,111110166,XM_022446556.1,uncharacterized LOC111110166,7529
NC_035787.1,36327286,36332534,36327286,36332534,111110168,XM_022446558.1,uncharacterized LOC111110168,5248
NC_035787.1,18791568,18800125,18796171,18800125,111110171,XM_022446563.1,uncharacterized LOC111110171,3954
NC_035787.1,18791568,18800125,18795986,18800125,111110171,XM_022446562.1,uncharacterized LOC111110171,4139
NC_035787.1,18791568,18800125,18791568,18800125,111110171,XM_022446561.1,uncharacterized LOC111110171,8557
NC_035787.1,24830792,24842789,24830792,24842789,111110174,XM_022446565.1,uncharacterized LOC111110174,11997
NC_035787.1,61968840,61973349,61968840,61973349,111110175,XM_022446566.1,uncharacterized LOC111110175,4509
NC_035780.1,27319640,27320797,27319640,27320797,111110178,XM_022446574.1,uncharacterized LOC111110178,1157
NC_035787.1,45940431,45945568,45940431,45945568,111110182,XM_022446576.1,uncharacterized LOC111110182,5137
NC_035787.1,56451999,56454290,56451999,56454290,111110183,XM_022446577.1,uncharacterized LOC111110183,2291
NC_035780.1,24880938,24883592,24880938,24883592,111110188,XM_022446584.1,uncharacterized LOC111110188,2654
NC_035787.1,16569525,16573304,16569525,16573304,111110189,XM_022446581.1,uncharacterized LOC111110189,3779
NC_035787.1,49402072,49409085,49402072,49409085,111110191,XM_022446583.1,uncharacterized LOC111110191,7013
NC_035780.1,18370929,18382636,18370929,18382636,111110197,XM_022446629.1,uncharacterized LOC111110197,11707
NC_035780.1,9842283,9850935,9842283,9850935,111110198,XM_022446595.1,uncharacterized LOC111110198,8652
NC_035787.1,22810287,22828678,22813220,22828678,111110199,XM_022446591.1,uncharacterized LOC111110199,15458
NC_035787.1,22810287,22828678,22810287,22828678,111110199,XM_022446592.1,uncharacterized LOC111110199,18391
NC_035787.1,24348730,24352089,24348730,24352089,111110203,XM_022446599.1,uncharacterized LOC111110203,3359
NC_035787.1,53630550,53632344,53630550,53632344,111110206,XM_022446603.1,uncharacterized LOC111110206,1794
NC_035787.1,48260216,48261119,48260216,48261119,111110208,XM_022446604.1,uncharacterized LOC111110208,903
NC_035787.1,70506965,70508306,70506965,70508306,111110210,XM_022446605.1,uncharacterized LOC111110210,1341
NC_035787.1,50307075,50308157,50307075,50308157,111110212,XM_022446608.1,uncharacterized LOC111110212,1082
NC_035787.1,25921590,25925043,25921590,25925043,111110213,XM_022446609.1,uncharacterized LOC111110213,3453
NC_035780.1,60191540,60193464,60191540,60193464,111110217,XM_022446618.1,uncharacterized LOC111110217,1924
NC_035787.1,24770013,24808846,24770013,24808846,111110221,XM_022446621.1,uncharacterized LOC111110221,38833
NC_035787.1,620989,638156,620989,638156,111110226,XM_022446626.1,uncharacterized LOC111110226,17167
NC_035787.1,72387164,72389250,72387164,72389250,111110227,XM_022446627.1,uncharacterized LOC111110227,2086
NC_035787.1,59401665,59408034,59406169,59408034,111110228,XM_022446631.1,uncharacterized LOC111110228,1865
NC_035787.1,59401665,59408034,59401665,59408034,111110228,XM_022446628.1,uncharacterized LOC111110228,6369
NC_035787.1,8357041,8360756,8357041,8360756,111110232,XM_022446636.1,uncharacterized LOC111110232,3715
NC_035787.1,9967947,9973637,9967947,9973637,111110233,XM_022446637.1,uncharacterized LOC111110233,5690
NC_035787.1,32633610,32635874,32633610,32635874,111110234,XM_022446638.1,uncharacterized LOC111110234,2264
NC_035787.1,7037614,7038873,7037614,7038873,111110236,XM_022446639.1,uncharacterized LOC111110236,1259
NC_035787.1,16823212,16828017,16823212,16828017,111110237,XM_022446640.1,uncharacterized LOC111110237,4805
NC_035787.1,21610285,21615870,21610294,21615870,111110238,XM_022446643.1,uncharacterized LOC111110238,5576
NC_035787.1,21610285,21615870,21610292,21615870,111110238,XM_022446642.1,uncharacterized LOC111110238,5578
NC_035787.1,21610285,21615870,21610287,21615870,111110238,XM_022446644.1,uncharacterized LOC111110238,5583
NC_035787.1,21610285,21615870,21610285,21615870,111110238,XM_022446645.1,uncharacterized LOC111110238,5585
NC_035787.1,21599951,21606020,21599951,21604780,111110239,XM_022446648.1,uncharacterized LOC111110239,4829
NC_035787.1,21599951,21606020,21599951,21606020,111110239,XM_022446647.1,uncharacterized LOC111110239,6069
NC_035787.1,70042120,70048934,70044114,70048934,111110243,XM_022446649.1,uncharacterized LOC111110243,4820
NC_035787.1,70042120,70048934,70042120,70048934,111110243,XM_022446650.1,uncharacterized LOC111110243,6814
NC_035787.1,4148010,4171426,4159973,4171426,111110244,XM_022446652.1,uncharacterized LOC111110244,11453
NC_035787.1,4148010,4171426,4157911,4171426,111110244,XM_022446657.1,uncharacterized LOC111110244,13515
NC_035787.1,4148010,4171426,4152560,4171426,111110244,XM_022446654.1,uncharacterized LOC111110244,18866
NC_035787.1,4148010,4171426,4148703,4171426,111110244,XM_022446656.1,uncharacterized LOC111110244,22723
NC_035787.1,4148010,4171426,4148010,4171426,111110244,XM_022446653.1,uncharacterized LOC111110244,23416
NC_035787.1,4148010,4171426,4166862,4171426,111110244,XM_022446651.1,uncharacterized LOC111110244,4564
NC_035787.1,4148010,4171426,4165546,4171426,111110244,XM_022446658.1,uncharacterized LOC111110244,5880
NC_035787.1,4148010,4171426,4165192,4171426,111110244,XM_022446655.1,uncharacterized LOC111110244,6234
NC_035787.1,54325380,54331704,54325380,54331704,111110248,XM_022446660.1,uncharacterized LOC111110248,6324
NC_035787.1,48084598,48091026,48084598,48091026,111110249,XM_022446662.1,uncharacterized LOC111110249,6428
NC_035787.1,48049020,48067002,48049022,48066784,111110250,XM_022446669.1,uncharacterized LOC111110250,17762
NC_035787.1,48049020,48067002,48049021,48066939,111110250,XM_022446666.1,uncharacterized LOC111110250,17918
NC_035787.1,48049020,48067002,48049020,48066943,111110250,XM_022446668.1,uncharacterized LOC111110250,17923
NC_035787.1,48049020,48067002,48049021,48066955,111110250,XM_022446664.1,uncharacterized LOC111110250,17934
NC_035787.1,48049020,48067002,48049021,48066998,111110250,XM_022446665.1,uncharacterized LOC111110250,17977
NC_035787.1,48049020,48067002,48049020,48067002,111110250,XM_022446667.1,uncharacterized LOC111110250,17982
NC_035787.1,48049020,48067002,48049021,48056753,111110250,XM_022446663.1,uncharacterized LOC111110250,7732
NC_035780.1,12371948,12382604,12371948,12382604,111110251,XM_022446670.1,uncharacterized LOC111110251,10656
NC_035787.1,48069300,48077885,48069300,48077885,111110252,XM_022446671.1,uncharacterized LOC111110252,8585
NC_035787.1,48096137,48106103,48096137,48106103,111110253,XM_022446672.1,uncharacterized LOC111110253,9966
NC_035787.1,25840012,25841649,25840012,25841649,111110259,XM_022446679.1,uncharacterized LOC111110259,1637
NC_035787.1,39646489,39651600,39646835,39651600,111110260,XM_022446681.1,uncharacterized LOC111110260,4765
NC_035787.1,39646489,39651600,39646489,39651600,111110260,XM_022446680.1,uncharacterized LOC111110260,5111
NC_035787.1,32507485,32515092,32507485,32515092,111110261,XM_022446682.1,uncharacterized LOC111110261,7607
NC_035787.1,22774756,22781114,22774756,22781114,111110262,XM_022446683.1,uncharacterized LOC111110262,6358
NC_035787.1,34140192,34142650,34140192,34142650,111110268,XM_022446689.1,uncharacterized LOC111110268,2458
NC_035787.1,14375747,14378124,14375747,14378124,111110269,XM_022446690.1,uncharacterized LOC111110269,2377
NC_035787.1,14336623,14340719,14336623,14340719,111110270,XM_022446691.1,uncharacterized LOC111110270,4096
NC_035787.1,14350156,14352694,14350156,14352694,111110271,XM_022446693.1,uncharacterized LOC111110271,2538
NC_035787.1,14344303,14346382,14344304,14346382,111110272,XM_022446695.1,uncharacterized LOC111110272,2078
NC_035787.1,14344303,14346382,14344303,14346382,111110272,XM_022446694.1,uncharacterized LOC111110272,2079
NC_035787.1,14357752,14369480,14357752,14369480,111110276,XM_022446700.1,uncharacterized LOC111110276,11728
NC_035787.1,4195074,4204728,4195074,4204728,111110278,XM_022446701.1,uncharacterized LOC111110278,9654
NC_035780.1,18497586,18504690,18497586,18504690,111110282,XM_022446746.1,uncharacterized LOC111110282,7104
NC_035787.1,57217983,57228207,57217983,57228207,111110284,XM_022446708.1,uncharacterized LOC111110284,10224
NC_035787.1,56889014,56891753,56889047,56891753,111110285,XM_022446710.1,uncharacterized LOC111110285,2706
NC_035787.1,56889014,56891753,56889014,56891753,111110285,XM_022446709.1,uncharacterized LOC111110285,2739
NC_035787.1,57505169,57513558,57505169,57513558,111110287,XM_022446713.1,uncharacterized LOC111110287,8389
NC_035787.1,27132767,27143010,27132767,27143010,111110289,XM_022446715.1,uncharacterized LOC111110289,10243
NC_035787.1,27069104,27086506,27072514,27086506,111110290,XM_022446716.1,uncharacterized LOC111110290,13992
NC_035787.1,16998868,17000902,16998868,17000902,111110294,XM_022446719.1,uncharacterized LOC111110294,2034
NC_035787.1,73406080,73412429,73406080,73412415,111110296,XM_022446725.1,uncharacterized LOC111110296,6335
NC_035787.1,73406080,73412429,73406080,73412429,111110296,XM_022446726.1,uncharacterized LOC111110296,6349
NC_035787.1,11362170,11379623,11362170,11375414,111110299,XM_022446736.1,uncharacterized LOC111110299,13244
NC_035787.1,11362170,11379623,11362170,11379623,111110299,XM_022446734.1,uncharacterized LOC111110299,17453
NC_035787.1,10120410,10133879,10120420,10133879,111110303,XM_022446739.1,uncharacterized LOC111110303,13459
NC_035787.1,10120410,10133879,10120410,10133879,111110303,XM_022446738.1,uncharacterized LOC111110303,13469
NC_035787.1,35867468,35871961,35867468,35871961,111110305,XM_022446741.1,uncharacterized LOC111110305,4493
NC_035787.1,13283877,13287703,13283877,13287703,111110306,XM_022446743.1,uncharacterized LOC111110306,3826
NC_035787.1,34463589,34469070,34463589,34469070,111110309,XM_022446747.1,uncharacterized LOC111110309,5481
NC_035780.1,44742285,44750709,44742285,44750708,111110319,XM_022446768.1,uncharacterized LOC111110319,8423
NC_035780.1,44742285,44750709,44742285,44750709,111110319,XM_022446776.1,uncharacterized LOC111110319,8424
NC_035787.1,35852792,35854349,35852792,35854349,111110320,XM_022446765.1,uncharacterized LOC111110320,1557
NC_035787.1,36567837,36586323,36567837,36586323,111110322,XM_022446770.1,uncharacterized LOC111110322,18486
NC_035787.1,2586131,2611093,2586131,2611093,111110323,XM_022446771.1,uncharacterized LOC111110323,24962
NC_035787.1,2579365,2586125,2580932,2586125,111110324,XM_022446773.1,uncharacterized LOC111110324,5193
NC_035787.1,2579365,2586125,2579365,2586125,111110324,XM_022446772.1,uncharacterized LOC111110324,6760
NC_035787.1,55112423,55118682,55112423,55118682,111110328,XM_022446779.1,uncharacterized LOC111110328,6259
NC_035787.1,10988559,10990651,10988559,10990651,111110333,XM_022446785.1,uncharacterized LOC111110333,2092
NC_035787.1,10991792,10996072,10993085,10996072,111110335,XM_022446787.1,uncharacterized LOC111110335,2987
NC_035787.1,10991792,10996072,10991792,10996072,111110335,XM_022446789.1,uncharacterized LOC111110335,4280
NC_035787.1,11025972,11028125,11025972,11028125,111110336,XM_022446790.1,uncharacterized LOC111110336,2153
NC_035787.1,13162594,13169632,13163579,13169632,111110337,XM_022446791.1,uncharacterized LOC111110337,6053
NC_035787.1,13162594,13169632,13162594,13169632,111110337,XM_022446792.1,uncharacterized LOC111110337,7038
NC_035787.1,8878920,8881201,8878920,8881201,111110338,XM_022446793.1,uncharacterized LOC111110338,2281
NC_035787.1,8232864,8235634,8232864,8235634,111110339,XM_022446794.1,uncharacterized LOC111110339,2770
NC_035787.1,62128138,62130547,62128138,62130547,111110340,XM_022446795.1,uncharacterized LOC111110340,2409
NC_035787.1,70125365,70127476,70125365,70127476,111110343,XM_022446797.1,uncharacterized LOC111110343,2111
NC_035787.1,33405695,33414499,33405695,33414499,111110344,XM_022446798.1,uncharacterized LOC111110344,8804
NC_035787.1,24046995,24054473,24046995,24054473,111110345,XM_022446800.1,uncharacterized LOC111110345,7478
NC_035780.1,53142114,53161468,53142114,53161468,111110348,XM_022446814.1,uncharacterized LOC111110348,19354
NC_035787.1,55588104,55598723,55588104,55598723,111110349,XM_022446821.1,uncharacterized LOC111110349,10619
NC_035787.1,55588104,55598723,55596084,55598723,111110349,XM_022446820.1,uncharacterized LOC111110349,2639
NC_035787.1,745349,780778,768723,780778,111110352,XM_022446823.1,uncharacterized LOC111110352,12055
NC_035787.1,745349,780778,761627,780778,111110352,XM_022446827.1,uncharacterized LOC111110352,19151
NC_035787.1,745349,780778,756938,780778,111110352,XM_022446825.1,uncharacterized LOC111110352,23840
NC_035787.1,745349,780778,745349,780778,111110352,XM_022446824.1,uncharacterized LOC111110352,35429
NC_035787.1,745349,780778,774177,780778,111110352,XM_022446828.1,uncharacterized LOC111110352,6601
NC_035787.1,745349,780778,773904,780778,111110352,XM_022446826.1,uncharacterized LOC111110352,6874
NC_035780.1,18272617,18285183,18272617,18285183,111110355,XM_022446945.1,uncharacterized LOC111110355,12566
NC_035787.1,54416223,54420190,54416223,54420190,111110356,XM_022446831.1,uncharacterized LOC111110356,3967
NC_035787.1,54420503,54424539,54420503,54424539,111110357,XM_022446832.1,uncharacterized LOC111110357,4036
NC_035787.1,49395290,49398628,49395290,49398628,111110361,XM_022446835.1,uncharacterized LOC111110361,3338
NC_035787.1,70893889,70896493,70893889,70896493,111110365,XM_022446840.1,uncharacterized LOC111110365,2604
NC_035787.1,55609139,55617122,55609139,55617122,111110366,XM_022446841.1,uncharacterized LOC111110366,7983
NC_035787.1,15247297,15253957,15247297,15253957,111110369,XM_022446845.1,uncharacterized LOC111110369,6660
NC_035780.1,43149087,43156291,43149087,43156291,111110370,XM_022446850.1,uncharacterized LOC111110370,7204
NC_035787.1,74811461,74821996,74811461,74821982,111110371,XM_022446847.1,uncharacterized LOC111110371,10521
NC_035787.1,74811461,74821996,74811462,74821996,111110371,XM_022446846.1,uncharacterized LOC111110371,10534
NC_035787.1,74811461,74821996,74812918,74821982,111110371,XM_022446849.1,uncharacterized LOC111110371,9064
NC_035787.1,74811461,74821996,74812781,74821982,111110371,XM_022446848.1,uncharacterized LOC111110371,9201
NC_035787.1,47149662,47156087,47149662,47156087,111110373,XM_022446852.1,uncharacterized LOC111110373,6425
NC_035787.1,35862611,35865897,35862611,35865897,111110374,XM_022446853.1,uncharacterized LOC111110374,3286
NC_035780.1,27713543,27717601,27713543,27717601,111110378,XM_022446861.1,uncharacterized LOC111110378,4058
NC_035787.1,22351469,22356710,22351469,22356710,111110379,XM_022446858.1,uncharacterized LOC111110379,5241
NC_035787.1,74204317,74206242,74204317,74206242,111110382,XM_022446862.1,uncharacterized LOC111110382,1925
NC_035787.1,12093753,12095387,12093792,12095387,111110383,XM_022446863.1,uncharacterized LOC111110383,1595
NC_035787.1,12093753,12095387,12093753,12095387,111110383,XM_022446864.1,uncharacterized LOC111110383,1634
NC_035787.1,26771337,26784590,26771337,26784590,111110384,XM_022446865.1,uncharacterized LOC111110384,13253
NC_035787.1,35750489,35754259,35750489,35754244,111110386,XM_022446867.1,uncharacterized LOC111110386,3755
NC_035787.1,35750489,35754259,35750489,35754259,111110386,XM_022446868.1,uncharacterized LOC111110386,3770
NC_035780.1,44264321,44304566,44264321,44304566,111110388,XM_022446873.1,uncharacterized LOC111110388,40245
NC_035787.1,72170694,72190170,72170694,72190158,111110393,XM_022446877.1,uncharacterized LOC111110393,19464
NC_035787.1,72170694,72190170,72170694,72190162,111110393,XM_022446876.1,uncharacterized LOC111110393,19468
NC_035787.1,72170694,72190170,72170694,72190170,111110393,XM_022446874.1,uncharacterized LOC111110393,19476
NC_035787.1,32683846,32694343,32683846,32694230,111110394,XM_022446878.1,uncharacterized LOC111110394,10384
NC_035787.1,32683846,32694343,32683846,32694343,111110394,XM_022446879.1,uncharacterized LOC111110394,10497
NC_035787.1,32683846,32694343,32684232,32694230,111110394,XM_022446880.1,uncharacterized LOC111110394,9998
NC_035787.1,27827913,27834872,27827918,27834872,111110395,XM_022446881.1,uncharacterized LOC111110395,6954
NC_035787.1,27827913,27834872,27827913,27834872,111110395,XM_022446882.1,uncharacterized LOC111110395,6959
NC_035787.1,1554165,1564843,1554165,1564843,111110397,XM_022446883.1,uncharacterized LOC111110397,10678
NC_035787.1,55079799,55107330,55079799,55107330,111110398,XM_022446885.1,uncharacterized LOC111110398,27531
NC_035787.1,55079799,55107330,55101831,55107290,111110398,XM_022446887.1,uncharacterized LOC111110398,5459
NC_035787.1,55079799,55107330,55098351,55107325,111110398,XM_022446884.1,uncharacterized LOC111110398,8974
NC_035787.1,55062303,55092661,55070689,55092661,111110399,XM_022446890.1,uncharacterized LOC111110399,21972
NC_035787.1,55062303,55092661,55062303,55092638,111110399,XM_022446889.1,uncharacterized LOC111110399,30335
NC_035787.1,55062303,55092661,55062303,55068373,111110399,XM_022446888.1,uncharacterized LOC111110399,6070
NC_035787.1,45092721,45116235,45092721,45116235,111110400,XM_022446891.1,uncharacterized LOC111110400,23514
NC_035787.1,67373786,67380045,67373786,67380045,111110404,XM_022446895.1,uncharacterized LOC111110404,6259
NC_035787.1,75356732,75360143,75356732,75360143,111110405,XM_022446896.1,uncharacterized LOC111110405,3411
NC_035787.1,49984072,49994644,49984072,49994644,111110406,XM_022446897.1,uncharacterized LOC111110406,10572
NC_035787.1,32730355,32732239,32730355,32732239,111110408,XM_022446900.1,uncharacterized LOC111110408,1884
NC_035780.1,28020937,28024590,28020937,28024590,111110410,XM_022446904.1,uncharacterized LOC111110410,3653
NC_035787.1,24666031,24671695,24666031,24671695,111110411,XM_022446902.1,uncharacterized LOC111110411,5664
NC_035787.1,5894540,5895298,5894540,5895298,111110412,XM_022446905.1,uncharacterized LOC111110412,758
NC_035787.1,73526848,73535596,73526848,73535596,111110414,XM_022446908.1,uncharacterized LOC111110414,8748
NC_035787.1,26055200,26080129,26076855,26080129,111110423,XM_022446922.1,uncharacterized LOC111110423,3274
NC_035787.1,26055200,26080129,26055200,26059219,111110423,XM_022446921.1,uncharacterized LOC111110423,4019
NC_035787.1,15133943,15137852,15133943,15137852,111110428,XM_022446926.1,uncharacterized LOC111110428,3909
NC_035787.1,17206324,17210827,17206324,17210827,111110429,XM_022446927.1,uncharacterized LOC111110429,4503
NC_035787.1,29662344,29671223,29662344,29671223,111110430,XM_022446928.1,uncharacterized LOC111110430,8879
NC_035787.1,19603660,19607120,19603660,19607120,111110432,XM_022446931.1,uncharacterized LOC111110432,3460
NC_035787.1,69227396,69230043,69227396,69230043,111110434,XM_022446933.1,uncharacterized LOC111110434,2647
NC_035787.1,62099990,62101729,62099990,62101729,111110439,XM_022446938.1,uncharacterized LOC111110439,1739
NC_035787.1,29804819,29813718,29804819,29805926,111110440,XM_022446939.1,uncharacterized LOC111110440,1107
NC_035787.1,29804819,29813718,29804819,29813718,111110440,XM_022446940.1,uncharacterized LOC111110440,8899
NC_035780.1,50649134,50660082,50649134,50660082,111110444,XM_022446950.1,uncharacterized LOC111110444,10948
NC_035787.1,7119736,7122806,7119736,7122806,111110446,XM_022446949.1,uncharacterized LOC111110446,3070
NC_035787.1,49777312,49778596,49777312,49778596,111110451,XM_022446954.1,uncharacterized LOC111110451,1284
NC_035787.1,50518954,50522136,50518954,50522136,111110455,XM_022446958.1,uncharacterized LOC111110455,3182
NC_035787.1,74502742,74510632,74502742,74510632,111110456,XM_022446959.1,uncharacterized LOC111110456,7890
NC_035787.1,9871666,9874523,9871705,9874523,111110465,XM_022446969.1,uncharacterized LOC111110465,2818
NC_035787.1,9871666,9874523,9871666,9874523,111110465,XM_022446968.1,uncharacterized LOC111110465,2857
NC_035787.1,18755248,18758375,18755248,18758375,111110466,XM_022446970.1,uncharacterized LOC111110466,3127
NC_035787.1,63297390,63302330,63297390,63302330,111110470,XM_022446974.1,uncharacterized LOC111110470,4940
NC_035787.1,18931522,18933560,18931522,18933560,111110473,XM_022446976.1,uncharacterized LOC111110473,2038
NC_035780.1,37106530,37121637,37106530,37121637,111110475,XM_022446983.1,uncharacterized LOC111110475,15107
NC_035787.1,35008083,35072614,35008083,35072614,111110476,XM_022446978.1,uncharacterized LOC111110476,64531
NC_035787.1,35297109,35383376,35306836,35383366,111110477,XM_022446986.1,uncharacterized LOC111110477,76530
NC_035787.1,35297109,35383376,35306836,35383376,111110477,XM_022446992.1,uncharacterized LOC111110477,76540
NC_035787.1,35297109,35383376,35306078,35383365,111110477,XM_022446989.1,uncharacterized LOC111110477,77287
NC_035787.1,35297109,35383376,35297109,35383365,111110477,XM_022446991.1,uncharacterized LOC111110477,86256
NC_035780.1,44631193,44660303,44635882,44660303,111110478,XM_022447011.1,uncharacterized LOC111110478,24421
NC_035780.1,44631193,44660303,44631195,44660303,111110478,XM_022447003.1,uncharacterized LOC111110478,29108
NC_035780.1,44631193,44660303,44631193,44660303,111110478,XM_022446996.1,uncharacterized LOC111110478,29110
NC_035787.1,35124113,35174356,35124113,35174356,111110479,XM_022446993.1,uncharacterized LOC111110479,50243
NC_035787.1,23759308,23764856,23759308,23764856,111110484,XM_022446998.1,uncharacterized LOC111110484,5548
NC_035787.1,23055774,23063272,23055774,23063272,111110491,XM_022447006.1,uncharacterized LOC111110491,7498
NC_035787.1,10681879,10685559,10681879,10685559,111110492,XM_022447007.1,uncharacterized LOC111110492,3680
NC_035787.1,32760619,32763802,32760619,32763802,111110496,XM_022447021.1,uncharacterized LOC111110496,3183
NC_035787.1,64592845,64603557,64592845,64603557,111110499,XM_022447022.1,uncharacterized LOC111110499,10712
NC_035780.1,18573566,18580129,18574564,18580129,111110501,XM_022447292.1,uncharacterized LOC111110501,5565
NC_035780.1,18573566,18580129,18574541,18580129,111110501,XM_022447363.1,uncharacterized LOC111110501,5588
NC_035780.1,18573566,18580129,18573821,18580129,111110501,XM_022447064.1,uncharacterized LOC111110501,6308
NC_035780.1,18573566,18580129,18573566,18580129,111110501,XM_022447138.1,uncharacterized LOC111110501,6563
NC_035780.1,46045462,46065547,46045462,46065376,111110504,XM_022447040.1,uncharacterized LOC111110504,19914
NC_035780.1,46045462,46065547,46045462,46065547,111110504,XM_022447031.1,uncharacterized LOC111110504,20085
NC_035787.1,18881950,18886454,18881950,18886454,111110508,XM_022447038.1,uncharacterized LOC111110508,4504
NC_035787.1,14752736,14762466,14753393,14762466,111110509,XM_022447041.1,uncharacterized LOC111110509,9073
NC_035787.1,14752736,14762466,14752778,14762466,111110509,XM_022447042.1,uncharacterized LOC111110509,9688
NC_035787.1,14752736,14762466,14752736,14762466,111110509,XM_022447039.1,uncharacterized LOC111110509,9730
NC_035787.1,10672129,10673744,10672129,10673744,111110511,XM_022447043.1,uncharacterized LOC111110511,1615
NC_035787.1,57844327,57847981,57844327,57847981,111110514,XM_022447045.1,uncharacterized LOC111110514,3654
NC_035787.1,45866515,45875350,45866515,45875350,111110516,XM_022447046.1,uncharacterized LOC111110516,8835
NC_035787.1,68178799,68240319,68178799,68229656,111110518,XM_022447057.1,uncharacterized LOC111110518,50857
NC_035787.1,68178799,68240319,68178799,68240319,111110518,XM_022447058.1,uncharacterized LOC111110518,61520
NC_035787.1,68188009,68195419,68188009,68195419,111110519,XM_022447059.1,uncharacterized LOC111110519,7410
NC_035787.1,52050974,52059712,52050974,52059536,111110524,XM_022447068.1,uncharacterized LOC111110524,8562
NC_035787.1,52050974,52059712,52050974,52059554,111110524,XM_022447069.1,uncharacterized LOC111110524,8580
NC_035787.1,52050974,52059712,52050974,52059712,111110524,XM_022447070.1,uncharacterized LOC111110524,8738
NC_035787.1,21758461,21797464,21758461,21797464,111110525,XM_022447071.1,uncharacterized LOC111110525,39003
NC_035787.1,10074287,10077228,10074287,10077228,111110535,XM_022447076.1,uncharacterized LOC111110535,2941
NC_035780.1,45362293,45365699,45362293,45365496,111110538,XM_022447089.1,uncharacterized LOC111110538,3203
NC_035780.1,45362293,45365699,45362293,45365699,111110538,XM_022447081.1,uncharacterized LOC111110538,3406
NC_035787.1,73997590,74015655,73997590,74015655,111110539,XM_022447077.1,uncharacterized LOC111110539,18065
NC_035787.1,52831970,52837666,52831970,52837547,111110540,XM_022447082.1,uncharacterized LOC111110540,5577
NC_035787.1,52831970,52837666,52831970,52837666,111110540,XM_022447080.1,uncharacterized LOC111110540,5696
NC_035787.1,52827895,52846637,52827895,52846637,111110541,XM_022447083.1,uncharacterized LOC111110541,18742
NC_035787.1,24273946,24290446,24273946,24290446,111110543,XM_022447087.1,uncharacterized LOC111110543,16500
NC_035787.1,19186603,19187722,19186603,19187722,111110546,XM_022447095.1,uncharacterized LOC111110546,1119
NC_035787.1,18746131,18748394,18746131,18748394,111110549,XM_022447098.1,uncharacterized LOC111110549,2263
NC_035787.1,9435415,9439527,9435415,9438509,111110556,XM_022447106.1,uncharacterized LOC111110556,3094
NC_035787.1,9435415,9439527,9435415,9439527,111110556,XM_022447105.1,uncharacterized LOC111110556,4112
NC_035787.1,49316243,49320323,49316243,49320323,111110559,XM_022447111.1,uncharacterized LOC111110559,4080
NC_035787.1,1753078,1795612,1753078,1795612,111110560,XM_022447112.1,uncharacterized LOC111110560,42534
NC_035787.1,1767433,1775775,1774589,1775775,111110561,XM_022447113.1,uncharacterized LOC111110561,1186
NC_035787.1,1767433,1775775,1767433,1775775,111110561,XM_022447114.1,uncharacterized LOC111110561,8342
NC_035787.1,1767433,1775775,1774928,1775775,111110561,XM_022447115.1,uncharacterized LOC111110561,847
NC_035787.1,1787287,1788036,1787287,1788036,111110562,XM_022447116.1,uncharacterized LOC111110562,749
NC_035787.1,818998,821475,818998,821475,111110563,XM_022447117.1,uncharacterized LOC111110563,2477
NC_035787.1,35889196,35890617,35889196,35890617,111110564,XM_022447119.1,uncharacterized LOC111110564,1421
NC_035787.1,65631038,65637726,65631038,65637726,111110566,XM_022447120.1,uncharacterized LOC111110566,6688
NC_035780.1,11632812,11634728,11632812,11634728,111110574,XM_022447133.1,uncharacterized LOC111110574,1916
NC_035787.1,65726933,65727946,65726933,65727946,111110575,XM_022447130.1,uncharacterized LOC111110575,1013
NC_035787.1,54166485,54170136,54166485,54170136,111110576,XM_022447131.1,uncharacterized LOC111110576,3651
NC_035787.1,38650713,38749778,38650713,38749778,111110585,XM_022447148.1,uncharacterized LOC111110585,99065
NC_035787.1,72687152,72766487,72687152,72766487,111110586,XM_022447150.1,uncharacterized LOC111110586,79335
NC_035787.1,3307117,3321518,3307117,3321518,111110587,XM_022447151.1,uncharacterized LOC111110587,14401
NC_035787.1,54962800,54965171,54962800,54965171,111110594,XM_022447156.1,uncharacterized LOC111110594,2371
NC_035787.1,32696733,32707106,32696733,32707089,111110595,XM_022447159.1,uncharacterized LOC111110595,10356
NC_035787.1,32696733,32707106,32696733,32707106,111110595,XM_022447157.1,uncharacterized LOC111110595,10373
NC_035787.1,57827448,57834665,57827448,57834665,111110597,XM_022447161.1,uncharacterized LOC111110597,7217
NC_035787.1,1546710,1550025,1546710,1550025,111110598,XM_022447162.1,uncharacterized LOC111110598,3315
NC_035787.1,22404029,22409021,22404029,22409021,111110599,XM_022447163.1,uncharacterized LOC111110599,4992
NC_035787.1,46171821,46175040,46171821,46175040,111110607,XM_022447174.1,uncharacterized LOC111110607,3219
NC_035780.1,64751640,64754392,64751640,64754392,111110610,XM_022447183.1,uncharacterized LOC111110610,2752
NC_035787.1,48109261,48114935,48109261,48114935,111110611,XM_022447180.1,uncharacterized LOC111110611,5674
NC_035787.1,38292713,38301141,38298002,38301141,111110612,XM_022447181.1,uncharacterized LOC111110612,3139
NC_035787.1,38292713,38301141,38292713,38301141,111110612,XM_022447182.1,uncharacterized LOC111110612,8428
NC_035787.1,54980695,55019163,55003642,55019163,111110615,XM_022447187.1,uncharacterized LOC111110615,15521
NC_035787.1,54980695,55019163,54980695,55019090,111110615,XM_022447186.1,uncharacterized LOC111110615,38395
NC_035787.1,54980695,55019163,54980695,54990422,111110615,XM_022447185.1,uncharacterized LOC111110615,9727
NC_035787.1,54992221,54999094,54992221,54999094,111110616,XM_022447188.1,uncharacterized LOC111110616,6873
NC_035787.1,18443308,18445158,18443308,18445158,111110618,XM_022447190.1,uncharacterized LOC111110618,1850
NC_035787.1,45014044,45017457,45014044,45017457,111110621,XM_022447192.1,uncharacterized LOC111110621,3413
NC_035787.1,39588297,39592660,39589139,39592660,111110625,XM_022447198.1,uncharacterized LOC111110625,3521
NC_035787.1,39588297,39592660,39588297,39592660,111110625,XM_022447199.1,uncharacterized LOC111110625,4363
NC_035787.1,49460279,49467294,49460279,49467294,111110626,XM_022447200.1,uncharacterized LOC111110626,7015
NC_035787.1,50495475,50499869,50495475,50499869,111110629,XM_022447203.1,uncharacterized LOC111110629,4394
NC_035787.1,65618569,65624770,65622792,65624485,111110640,XM_022447222.1,uncharacterized LOC111110640,1693
NC_035787.1,65618569,65624770,65622792,65624486,111110640,XM_022447224.1,uncharacterized LOC111110640,1694
NC_035787.1,65618569,65624770,65622792,65624770,111110640,XM_022447225.1,uncharacterized LOC111110640,1978
NC_035787.1,65618569,65624770,65618569,65624486,111110640,XM_022447223.1,uncharacterized LOC111110640,5917
NC_035787.1,10804833,10808490,10804833,10808490,111110641,XM_022447228.1,uncharacterized LOC111110641,3657
NC_035787.1,2543688,2577968,2543688,2559512,111110642,XM_022447231.1,uncharacterized LOC111110642,15824
NC_035787.1,2543688,2577968,2543688,2562366,111110642,XM_022447230.1,uncharacterized LOC111110642,18678
NC_035787.1,2543688,2577968,2543688,2576251,111110642,XM_022447232.1,uncharacterized LOC111110642,32563
NC_035787.1,2543688,2577968,2543688,2576253,111110642,XM_022447229.1,uncharacterized LOC111110642,32565
NC_035787.1,2543688,2577968,2543688,2577968,111110642,XM_022447233.1,uncharacterized LOC111110642,34280
NC_035787.1,63189916,63192579,63189916,63192579,111110643,XM_022447234.1,uncharacterized LOC111110643,2663
NC_035787.1,63197802,63201490,63197802,63201490,111110644,XM_022447235.1,uncharacterized LOC111110644,3688
NC_035787.1,3204360,3208491,3204360,3208491,111110646,XM_022447238.1,uncharacterized LOC111110646,4131
NC_035787.1,18827446,18833069,18827446,18833069,111110651,XM_022447242.1,uncharacterized LOC111110651,5623
NC_035787.1,54819293,54832331,54819293,54832331,111110652,XM_022447244.1,uncharacterized LOC111110652,13038
NC_035787.1,54785196,54790785,54785196,54790785,111110654,XM_022447246.1,uncharacterized LOC111110654,5589
NC_035787.1,4306400,4308485,4306400,4308485,111110655,XM_022447247.1,uncharacterized LOC111110655,2085
NC_035787.1,17861649,17879740,17861649,17879740,111110661,XM_022447257.1,uncharacterized LOC111110661,18091
NC_035787.1,27813269,27816325,27813269,27816325,111110662,XM_022447259.1,uncharacterized LOC111110662,3056
NC_035787.1,27800892,27808742,27800892,27808742,111110663,XM_022447260.1,uncharacterized LOC111110663,7850
NC_035787.1,49416305,49423426,49416305,49422200,111110666,XM_022447262.1,uncharacterized LOC111110666,5895
NC_035787.1,49416305,49423426,49416305,49423426,111110666,XM_022447263.1,uncharacterized LOC111110666,7121
NC_035787.1,75292941,75320582,75318183,75320582,111110670,XM_022447266.1,uncharacterized LOC111110670,2399
NC_035787.1,75292941,75320582,75292941,75320582,111110670,XM_022447267.1,uncharacterized LOC111110670,27641
NC_035787.1,16048653,16065752,16050026,16065752,111110671,XM_022447270.1,uncharacterized LOC111110671,15726
NC_035787.1,16048653,16065752,16050024,16065752,111110671,XM_022447268.1,uncharacterized LOC111110671,15728
NC_035787.1,16048653,16065752,16050023,16065752,111110671,XM_022447269.1,uncharacterized LOC111110671,15729
NC_035787.1,16048653,16065752,16049084,16065752,111110671,XM_022447271.1,uncharacterized LOC111110671,16668
NC_035787.1,16048653,16065752,16048653,16065752,111110671,XM_022447272.1,uncharacterized LOC111110671,17099
NC_035787.1,23784960,23794133,23784961,23794133,111110674,XM_022447276.1,uncharacterized LOC111110674,9172
NC_035787.1,23784960,23794133,23784960,23794133,111110674,XM_022447275.1,uncharacterized LOC111110674,9173
NC_035787.1,24983148,24987326,24983148,24986445,111110675,XM_022447279.1,uncharacterized LOC111110675,3297
NC_035787.1,24983148,24987326,24983148,24987326,111110675,XM_022447280.1,uncharacterized LOC111110675,4178
NC_035787.1,46155325,46161243,46155325,46161243,111110676,XM_022447281.1,uncharacterized LOC111110676,5918
NC_035787.1,38948100,38953881,38948100,38953881,111110679,XM_022447283.1,uncharacterized LOC111110679,5781
NC_035787.1,74274838,74294774,74274838,74294774,111110680,XM_022447284.1,uncharacterized LOC111110680,19936
NC_035787.1,74381200,74398361,74381200,74398361,111110686,XM_022447289.1,uncharacterized LOC111110686,17161
NC_035787.1,74398397,74404415,74398397,74404415,111110687,XM_022447290.1,uncharacterized LOC111110687,6018
NC_035780.1,25131697,25145462,25131697,25145462,111110699,XM_022447293.1,uncharacterized LOC111110699,13765
NC_035788.1,984549,986131,984549,986131,111110713,XM_022447298.1,uncharacterized LOC111110713,1582
NC_035788.1,65212646,65226339,65212646,65226339,111110715,XM_022447301.1,uncharacterized LOC111110715,13693
NC_035788.1,17482639,17492577,17482639,17490243,111110716,XM_022447305.1,uncharacterized LOC111110716,7604
NC_035788.1,17482639,17492577,17482639,17492577,111110716,XM_022447307.1,uncharacterized LOC111110716,9938
NC_035780.1,54741435,54744161,54741435,54744161,111110719,XM_022447314.1,uncharacterized LOC111110719,2726
NC_035788.1,63083807,63093561,63086619,63093561,111110720,XM_022447312.1,uncharacterized LOC111110720,6942
NC_035788.1,63083807,63093561,63086349,63093561,111110720,XM_022447313.1,uncharacterized LOC111110720,7212
NC_035788.1,63083807,63093561,63083807,63093561,111110720,XM_022447311.1,uncharacterized LOC111110720,9754
NC_035788.1,93234085,93246142,93234085,93246142,111110725,XM_022447319.1,uncharacterized LOC111110725,12057
NC_035788.1,103121549,103126415,103121549,103126415,111110732,XM_022447323.1,uncharacterized LOC111110732,4866
NC_035788.1,4003855,4006510,4003855,4006510,111110734,XM_022447326.1,uncharacterized LOC111110734,2655
NC_035788.1,840610,842032,840610,842032,111110735,XM_022447327.1,uncharacterized LOC111110735,1422
NC_035788.1,15354338,15366313,15354338,15366313,111110738,XM_022447331.1,uncharacterized LOC111110738,11975
NC_035788.1,15354338,15366313,15354338,15358673,111110738,XM_022447332.1,uncharacterized LOC111110738,4335
NC_035788.1,15354338,15366313,15354338,15359533,111110738,XM_022447330.1,uncharacterized LOC111110738,5195
NC_035788.1,94785363,94789742,94785363,94789742,111110742,XM_022447342.1,uncharacterized LOC111110742,4379
NC_035788.1,90234690,90246878,90236597,90246878,111110743,XM_022447344.1,uncharacterized LOC111110743,10281
NC_035788.1,90234690,90246878,90234690,90246878,111110743,XM_022447345.1,uncharacterized LOC111110743,12188
NC_035788.1,90234690,90246878,90243369,90246878,111110743,XM_022447343.1,uncharacterized LOC111110743,3509
NC_035788.1,4784870,4799291,4784870,4799291,111110748,XM_022447353.1,uncharacterized LOC111110748,14421
NC_035788.1,4784870,4799291,4789638,4799291,111110748,XM_022447354.1,uncharacterized LOC111110748,9653
NC_035780.1,52537987,52555947,52554504,52555947,111110749,XM_022447359.1,uncharacterized LOC111110749,1443
NC_035780.1,52537987,52555947,52537987,52555947,111110749,XM_022447368.1,uncharacterized LOC111110749,17960
NC_035788.1,61713544,61738938,61713544,61738938,111110752,XM_022447366.1,uncharacterized LOC111110752,25394
NC_035788.1,93765678,93768578,93765678,93768578,111110755,XM_022447369.1,uncharacterized LOC111110755,2900
NC_035788.1,26699583,26728297,26716047,26728297,111110756,XM_022447373.1,uncharacterized LOC111110756,12250
NC_035788.1,26699583,26728297,26699589,26712103,111110756,XM_022447370.1,uncharacterized LOC111110756,12514
NC_035788.1,26699583,26728297,26699583,26728285,111110756,XM_022447371.1,uncharacterized LOC111110756,28702
NC_035780.1,28711439,28715417,28711439,28715417,111110766,XM_022447382.1,uncharacterized LOC111110766,3978
NC_035788.1,55159169,55160592,55159169,55160592,111110772,XM_022447384.1,uncharacterized LOC111110772,1423
NC_035788.1,54431997,54437627,54431997,54437627,111110774,XM_022447385.1,uncharacterized LOC111110774,5630
NC_035788.1,2484715,2486986,2484715,2486986,111110779,XM_022447389.1,uncharacterized LOC111110779,2271
NC_035788.1,70284220,70316486,70284220,70316486,111110781,XM_022447391.1,uncharacterized LOC111110781,32266
NC_035788.1,70245699,70280503,70245699,70269213,111110782,XM_022447394.1,uncharacterized LOC111110782,23514
NC_035788.1,70245699,70280503,70245699,70280454,111110782,XM_022447393.1,uncharacterized LOC111110782,34755
NC_035788.1,70245699,70280503,70245699,70280503,111110782,XM_022447392.1,uncharacterized LOC111110782,34804
NC_035780.1,3507345,3512512,3507345,3512512,111110783,XM_022447405.1,uncharacterized LOC111110783,5167
NC_035788.1,70318063,70331277,70318063,70331277,111110784,XM_022447395.1,uncharacterized LOC111110784,13214
NC_035788.1,70318063,70331277,70318064,70326683,111110784,XM_022447398.1,uncharacterized LOC111110784,8619
NC_035788.1,70318063,70331277,70318064,70326700,111110784,XM_022447396.1,uncharacterized LOC111110784,8636
NC_035788.1,70156693,70166183,70156693,70166183,111110792,XM_022447407.1,uncharacterized LOC111110792,9490
NC_035788.1,2927073,2931528,2927073,2931528,111110797,XM_022447411.1,uncharacterized LOC111110797,4455
NC_035788.1,17152123,17153976,17152123,17153976,111110800,XM_022447412.1,uncharacterized LOC111110800,1853
NC_035788.1,17230556,17232505,17230556,17232505,111110801,XM_022447413.1,uncharacterized LOC111110801,1949
NC_035788.1,63019986,63023552,63019986,63023550,111110802,XM_022447415.1,uncharacterized LOC111110802,3564
NC_035788.1,63019986,63023552,63019986,63023552,111110802,XM_022447416.1,uncharacterized LOC111110802,3566
NC_035788.1,32871815,32872424,32871815,32872424,111110805,XM_022447418.1,uncharacterized LOC111110805,609
NC_035788.1,19791859,19795549,19791859,19795549,111110806,XM_022447419.1,uncharacterized LOC111110806,3690
NC_035788.1,75115772,75117757,75116007,75117757,111110813,XM_022447430.1,uncharacterized LOC111110813,1750
NC_035788.1,75115772,75117757,75115772,75117757,111110813,XM_022447429.1,uncharacterized LOC111110813,1985
NC_035780.1,18764932,18770805,18765199,18770805,111110814,XM_022447544.1,uncharacterized LOC111110814,5606
NC_035780.1,18764932,18770805,18764932,18770805,111110814,XM_022447615.1,uncharacterized LOC111110814,5873
NC_035788.1,69434236,69444052,69434236,69444052,111110815,XM_022447431.1,uncharacterized LOC111110815,9816
NC_035788.1,69630160,69631561,69630160,69631561,111110818,XM_022447443.1,uncharacterized LOC111110818,1401
NC_035788.1,19126051,19138840,19126051,19138437,111110820,XM_022447445.1,uncharacterized LOC111110820,12386
NC_035788.1,19126051,19138840,19126051,19138840,111110820,XM_022447447.1,uncharacterized LOC111110820,12789
NC_035788.1,19126051,19138840,19126051,19134543,111110820,XM_022447448.1,uncharacterized LOC111110820,8492
NC_035788.1,19126051,19138840,19126051,19135977,111110820,XM_022447446.1,uncharacterized LOC111110820,9926
NC_035788.1,2705713,2712767,2705713,2712767,111110827,XM_022447457.1,uncharacterized LOC111110827,7054
NC_035788.1,79229,84381,79229,84381,111110829,XM_022447459.1,uncharacterized LOC111110829,5152
NC_035788.1,74163119,74171483,74163119,74171483,111110830,XM_022447460.1,uncharacterized LOC111110830,8364
NC_035788.1,11422278,11427813,11422278,11427813,111110832,XM_022447463.1,uncharacterized LOC111110832,5535
NC_035788.1,95044853,95054651,95049431,95054651,111110833,XM_022447465.1,uncharacterized LOC111110833,5220
NC_035788.1,95044853,95054651,95044853,95054651,111110833,XM_022447464.1,uncharacterized LOC111110833,9798
NC_035788.1,59741249,59767674,59741249,59767674,111110842,XM_022447476.1,uncharacterized LOC111110842,26425
NC_035788.1,54449374,54453195,54449374,54453195,111110845,XM_022447481.1,uncharacterized LOC111110845,3821
NC_035788.1,75053895,75061111,75053895,75061111,111110846,XM_022447482.1,uncharacterized LOC111110846,7216
NC_035788.1,47792312,47804371,47792312,47804371,111110849,XM_022447484.1,uncharacterized LOC111110849,12059
NC_035788.1,94267840,94283598,94267841,94283220,111110851,XM_022447487.1,uncharacterized LOC111110851,15379
NC_035788.1,94267840,94283598,94267840,94283220,111110851,XM_022447486.1,uncharacterized LOC111110851,15380
NC_035788.1,94247904,94268388,94247904,94268388,111110852,XM_022447488.1,uncharacterized LOC111110852,20484
NC_035788.1,34908152,34939153,34925144,34939153,111110857,XM_022447494.1,uncharacterized LOC111110857,14009
NC_035788.1,34908152,34939153,34908218,34939153,111110857,XM_022447493.1,uncharacterized LOC111110857,30935
NC_035788.1,54003670,54027303,54003671,54025818,111110858,XM_022447496.1,uncharacterized LOC111110858,22147
NC_035788.1,54003670,54027303,54003671,54026099,111110858,XM_022447495.1,uncharacterized LOC111110858,22428
NC_035788.1,54003670,54027303,54003670,54026099,111110858,XM_022447498.1,uncharacterized LOC111110858,22429
NC_035788.1,54003670,54027303,54003673,54027303,111110858,XM_022447497.1,uncharacterized LOC111110858,23630
NC_035780.1,3766207,3769475,3766207,3769475,111110859,XM_022447500.1,uncharacterized LOC111110859,3268
NC_035788.1,1548870,1582232,1548877,1582232,111110876,XM_022447528.1,uncharacterized LOC111110876,33355
NC_035788.1,1548870,1582232,1548870,1582232,111110876,XM_022447527.1,uncharacterized LOC111110876,33362
NC_035780.1,10608318,10610231,10608318,10610231,111110877,XM_022447532.1,uncharacterized LOC111110877,1913
NC_035788.1,13179057,13187764,13179057,13187764,111110878,XM_022447529.1,uncharacterized LOC111110878,8707
NC_035788.1,73233958,73241941,73234059,73241941,111110881,XM_022447538.1,uncharacterized LOC111110881,7882
NC_035788.1,73233958,73241941,73233959,73241941,111110881,XM_022447536.1,uncharacterized LOC111110881,7982
NC_035788.1,73233958,73241941,73233958,73241941,111110881,XM_022447537.1,uncharacterized LOC111110881,7983
NC_035788.1,53566781,53648440,53566781,53615730,111110883,XM_022447540.1,uncharacterized LOC111110883,48949
NC_035788.1,53566781,53648440,53566781,53648440,111110883,XM_022447539.1,uncharacterized LOC111110883,81659
NC_035788.1,2338350,2340581,2338350,2340581,111110885,XM_022447541.1,uncharacterized LOC111110885,2231
NC_035788.1,15186437,15195081,15186437,15195081,111110887,XM_022447546.1,uncharacterized LOC111110887,8644
NC_035788.1,68321803,68328815,68321803,68328815,111110892,XM_022447554.1,uncharacterized LOC111110892,7012
NC_035788.1,68338609,68341849,68338609,68341849,111110893,XM_022447555.1,uncharacterized LOC111110893,3240
NC_035788.1,3466611,3472552,3466611,3470365,111110896,XM_022447557.1,uncharacterized LOC111110896,3754
NC_035788.1,3466611,3472552,3466611,3470824,111110896,XM_022447559.1,uncharacterized LOC111110896,4213
NC_035788.1,3466611,3472552,3466611,3472132,111110896,XM_022447558.1,uncharacterized LOC111110896,5521
NC_035788.1,8973476,8975041,8973476,8975041,111110899,XM_022447562.1,uncharacterized LOC111110899,1565
NC_035788.1,18068644,18069818,18068644,18069818,111110901,XM_022447563.1,uncharacterized LOC111110901,1174
NC_035788.1,75160443,75178489,75160444,75178489,111110906,XM_022447571.1,uncharacterized LOC111110906,18045
NC_035788.1,75160443,75178489,75160443,75178489,111110906,XM_022447570.1,uncharacterized LOC111110906,18046
NC_035788.1,17734077,17747543,17734078,17747543,111110908,XM_022447573.1,uncharacterized LOC111110908,13465
NC_035788.1,17734077,17747543,17734077,17747543,111110908,XM_022447574.1,uncharacterized LOC111110908,13466
NC_035788.1,85401141,85402519,85401141,85402519,111110909,XM_022447575.1,uncharacterized LOC111110909,1378
NC_035788.1,48042162,48077043,48043946,48077043,111110910,XM_022447580.1,uncharacterized LOC111110910,33097
NC_035788.1,48042162,48077043,48042172,48077043,111110910,XM_022447576.1,uncharacterized LOC111110910,34871
NC_035788.1,48042162,48077043,48042171,48077043,111110910,XM_022447579.1,uncharacterized LOC111110910,34872
NC_035788.1,48042162,48077043,48042162,48077043,111110910,XM_022447577.1,uncharacterized LOC111110910,34881
NC_035788.1,53121514,53128330,53121514,53128330,111110912,XM_022447581.1,uncharacterized LOC111110912,6816
NC_035788.1,99310715,99316654,99310715,99316654,111110914,XM_022447583.1,uncharacterized LOC111110914,5939
NC_035788.1,99304588,99307358,99304588,99307358,111110915,XM_022447584.1,uncharacterized LOC111110915,2770
NC_035788.1,99327458,99328802,99327458,99328802,111110916,XM_022447585.1,uncharacterized LOC111110916,1344
NC_035780.1,43656928,43676723,43656929,43676723,111110917,XM_022447592.1,uncharacterized LOC111110917,19794
NC_035780.1,43656928,43676723,43656928,43676723,111110917,XM_022447587.1,uncharacterized LOC111110917,19795
NC_035788.1,53918592,53920501,53918592,53920501,111110921,XM_022447588.1,uncharacterized LOC111110921,1909
NC_035788.1,32899358,32951810,32940070,32951810,111110929,XM_022447593.1,uncharacterized LOC111110929,11740
NC_035788.1,32899358,32951810,32901235,32951810,111110929,XM_022447595.1,uncharacterized LOC111110929,50575
NC_035788.1,32899358,32951810,32899358,32951810,111110929,XM_022447594.1,uncharacterized LOC111110929,52452
NC_035788.1,5990069,5992552,5990069,5992552,111110938,XM_022447600.1,uncharacterized LOC111110938,2483
NC_035788.1,67733473,67744289,67733473,67744289,111110939,XM_022447601.1,uncharacterized LOC111110939,10816
NC_035788.1,103558988,103567208,103558988,103567208,111110941,XM_022447603.1,uncharacterized LOC111110941,8220
NC_035788.1,70054334,70059381,70054337,70059381,111110942,XM_022447609.1,uncharacterized LOC111110942,5044
NC_035788.1,70054334,70059381,70054336,70059381,111110942,XM_022447604.1,uncharacterized LOC111110942,5045
NC_035788.1,70054334,70059381,70054335,70059381,111110942,XM_022447606.1,uncharacterized LOC111110942,5046
NC_035788.1,70054334,70059381,70054334,70059381,111110942,XM_022447607.1,uncharacterized LOC111110942,5047
NC_035788.1,83201828,83206158,83201828,83206158,111110944,XM_022447611.1,uncharacterized LOC111110944,4330
NC_035788.1,3814220,3818141,3814476,3818141,111110947,XM_022447624.1,uncharacterized LOC111110947,3665
NC_035788.1,3814220,3818141,3814220,3818141,111110947,XM_022447625.1,uncharacterized LOC111110947,3921
NC_035788.1,2701805,2703814,2701805,2703814,111110948,XM_022447627.1,uncharacterized LOC111110948,2009
NC_035788.1,42494746,42505958,42494746,42497909,111110957,XM_022447641.1,uncharacterized LOC111110957,3163
NC_035788.1,42494746,42505958,42496227,42505958,111110957,XM_022447639.1,uncharacterized LOC111110957,9731
NC_035788.1,56126465,56151557,56130103,56151557,111110961,XM_022447643.1,uncharacterized LOC111110961,21454
NC_035788.1,56126465,56151557,56126465,56151557,111110961,XM_022447644.1,uncharacterized LOC111110961,25092
NC_035788.1,36167875,36174733,36167875,36174733,111110962,XM_022447647.1,uncharacterized LOC111110962,6858
NC_035788.1,83000192,83004129,83000192,83004129,111110970,XM_022447651.1,uncharacterized LOC111110970,3937
NC_035788.1,78729239,78732672,78729239,78732672,111110972,XM_022447654.1,uncharacterized LOC111110972,3433
NC_035788.1,57779487,57789956,57779487,57789956,111110974,XM_022447655.1,uncharacterized LOC111110974,10469
NC_035788.1,22027919,22033870,22028097,22033870,111110980,XM_022447674.1,uncharacterized LOC111110980,5773
NC_035788.1,22027919,22033870,22027919,22033870,111110980,XM_022447673.1,uncharacterized LOC111110980,5951
NC_035788.1,22520541,22524091,22520541,22524091,111110981,XM_022447676.1,uncharacterized LOC111110981,3550
NC_035788.1,4094290,4111522,4095648,4111522,111110984,XM_022447680.1,uncharacterized LOC111110984,15874
NC_035788.1,4094290,4111522,4094290,4111522,111110984,XM_022447679.1,uncharacterized LOC111110984,17232
NC_035788.1,74631507,74652700,74638298,74652700,111110988,XM_022447688.1,uncharacterized LOC111110988,14402
NC_035788.1,74631507,74652700,74631507,74652700,111110988,XM_022447687.1,uncharacterized LOC111110988,21193
NC_035780.1,46168156,46172317,46169915,46172317,111110990,XM_022447700.1,uncharacterized LOC111110990,2402
NC_035780.1,46168156,46172317,46168156,46172317,111110990,XM_022447690.1,uncharacterized LOC111110990,4161
NC_035788.1,45225750,45234059,45225750,45234059,111110994,XM_022447691.1,uncharacterized LOC111110994,8309
NC_035780.1,18675875,18682187,18675875,18682187,111110995,XM_022447735.1,uncharacterized LOC111110995,6312
NC_035788.1,50209884,50233410,50209884,50232294,111110996,XM_022447692.1,uncharacterized LOC111110996,22410
NC_035788.1,50209884,50233410,50209884,50233410,111110996,XM_022447693.1,uncharacterized LOC111110996,23526
NC_035788.1,94519202,94531294,94519202,94531294,111110998,XM_022447720.1,uncharacterized LOC111110998,12092
NC_035788.1,94540274,94567870,94540274,94567870,111110999,XM_022447722.1,uncharacterized LOC111110999,27596
NC_035788.1,94540274,94567870,94540274,94543819,111110999,XM_022447721.1,uncharacterized LOC111110999,3545
NC_035788.1,94557112,94563113,94557112,94563113,111111002,XM_022447724.1,uncharacterized LOC111111002,6001
NC_035788.1,30553864,30575035,30553864,30575035,111111005,XM_022447729.1,uncharacterized LOC111111005,21171
NC_035788.1,17473826,17482066,17473826,17482066,111111006,XM_022447730.1,uncharacterized LOC111111006,8240
NC_035788.1,24414223,24415678,24414223,24415678,111111008,XM_022447732.1,uncharacterized LOC111111008,1455
NC_035788.1,35622280,35625636,35622280,35625636,111111009,XM_022447733.1,uncharacterized LOC111111009,3356
NC_035788.1,35664106,35668257,35664106,35668257,111111010,XM_022447734.1,uncharacterized LOC111111010,4151
NC_035788.1,35652819,35657004,35652819,35657004,111111011,XM_022447736.1,uncharacterized LOC111111011,4185
NC_035788.1,35638928,35641548,35638928,35641548,111111012,XM_022447737.1,uncharacterized LOC111111012,2620
NC_035788.1,18962917,18974958,18962917,18974955,111111017,XM_022447745.1,uncharacterized LOC111111017,12038
NC_035788.1,18962917,18974958,18962917,18974956,111111017,XM_022447746.1,uncharacterized LOC111111017,12039
NC_035788.1,18962917,18974958,18962917,18974958,111111017,XM_022447744.1,uncharacterized LOC111111017,12041
NC_035788.1,61360960,61364952,61360960,61364952,111111018,XM_022447748.1,uncharacterized LOC111111018,3992
NC_035788.1,17913516,17930696,17919142,17930696,111111019,XM_022447751.1,uncharacterized LOC111111019,11554
NC_035788.1,17913516,17930696,17913518,17930696,111111019,XM_022447750.1,uncharacterized LOC111111019,17178
NC_035788.1,17913516,17930696,17913516,17930696,111111019,XM_022447749.1,uncharacterized LOC111111019,17180
NC_035788.1,17913516,17930696,17921238,17930696,111111019,XM_022447752.1,uncharacterized LOC111111019,9458
NC_035788.1,73156725,73170626,73156725,73170626,111111021,XM_022447753.1,uncharacterized LOC111111021,13901
NC_035788.1,43192311,43247119,43192311,43236606,111111023,XM_022447754.1,uncharacterized LOC111111023,44295
NC_035788.1,43192311,43247119,43192311,43247119,111111023,XM_022447755.1,uncharacterized LOC111111023,54808
NC_035788.1,62776776,62808952,62779618,62808952,111111025,XM_022447761.1,uncharacterized LOC111111025,29334
NC_035788.1,62776776,62808952,62776776,62808952,111111025,XM_022447759.1,uncharacterized LOC111111025,32176
NC_035788.1,62795244,62797396,62795244,62797396,111111026,XM_022447762.1,uncharacterized LOC111111026,2152
NC_035788.1,103136619,103138566,103136619,103138566,111111032,XM_022447771.1,uncharacterized LOC111111032,1947
NC_035788.1,80885755,80887548,80885755,80887548,111111040,XM_022447778.1,uncharacterized LOC111111040,1793
NC_035788.1,47599340,47600359,47599340,47600359,111111042,XM_022447780.1,uncharacterized LOC111111042,1019
NC_035788.1,15138165,15148044,15138165,15148044,111111044,XM_022447781.1,uncharacterized LOC111111044,9879
NC_035788.1,98793542,98818222,98804879,98818222,111111047,XM_022447785.1,uncharacterized LOC111111047,13343
NC_035788.1,98793542,98818222,98793542,98818222,111111047,XM_022447784.1,uncharacterized LOC111111047,24680
NC_035788.1,95097887,95107170,95097887,95107170,111111055,XM_022447797.1,uncharacterized LOC111111055,9283
NC_035788.1,17751840,17764013,17751840,17764013,111111056,XM_022447799.1,uncharacterized LOC111111056,12173
NC_035788.1,13243170,13249652,13243170,13249652,111111062,XM_022447822.1,uncharacterized LOC111111062,6482
NC_035788.1,66456523,66460392,66456523,66460392,111111063,XM_022447824.1,uncharacterized LOC111111063,3869
NC_035788.1,2305421,2311181,2305421,2311181,111111065,XM_022447825.1,uncharacterized LOC111111065,5760
NC_035788.1,2310609,2312633,2310609,2312633,111111066,XM_022447826.1,uncharacterized LOC111111066,2024
NC_035788.1,21916163,21920319,21916174,21920319,111111068,XM_022447827.1,uncharacterized LOC111111068,4145
NC_035788.1,21916163,21920319,21916163,21920319,111111068,XM_022447828.1,uncharacterized LOC111111068,4156
NC_035788.1,6007220,6019684,6007220,6018995,111111070,XM_022447832.1,uncharacterized LOC111111070,11775
NC_035788.1,6007220,6019684,6007220,6019684,111111070,XM_022447831.1,uncharacterized LOC111111070,12464
NC_035788.1,67792304,67800415,67792304,67800415,111111071,XM_022447833.1,uncharacterized LOC111111071,8111
NC_035788.1,72917161,72924515,72917161,72924341,111111072,XM_022447834.1,uncharacterized LOC111111072,7180
NC_035788.1,20065900,20072027,20065900,20072027,111111074,XM_022447836.1,uncharacterized LOC111111074,6127
NC_035788.1,63340569,63345575,63340569,63345575,111111084,XM_022447850.1,uncharacterized LOC111111084,5006
NC_035788.1,84034121,84038279,84034121,84038279,111111086,XM_022447854.1,uncharacterized LOC111111086,4158
NC_035788.1,84032939,84038358,84032939,84038358,111111087,XM_022447855.1,uncharacterized LOC111111087,5419
NC_035788.1,85436759,85437586,85436759,85437586,111111089,XM_022447857.1,uncharacterized LOC111111089,827
NC_035788.1,8848804,8853555,8848804,8851923,111111090,XM_022447858.1,uncharacterized LOC111111090,3119
NC_035788.1,8848804,8853555,8848804,8853555,111111090,XM_022447859.1,uncharacterized LOC111111090,4751
NC_035788.1,63594263,63600167,63594263,63600167,111111097,XM_022447869.1,uncharacterized LOC111111097,5904
NC_035788.1,63559944,63564890,63559944,63564890,111111098,XM_022447871.1,uncharacterized LOC111111098,4946
NC_035788.1,63625524,63638389,63625524,63638389,111111099,XM_022447872.1,uncharacterized LOC111111099,12865
NC_035788.1,63625524,63638389,63631104,63638389,111111099,XM_022447874.1,uncharacterized LOC111111099,7285
NC_035788.1,63581199,63588686,63581199,63588686,111111100,XM_022447876.1,uncharacterized LOC111111100,7487
NC_035788.1,63608433,63616176,63608433,63612987,111111101,XM_022447879.1,uncharacterized LOC111111101,4554
NC_035788.1,63608433,63616176,63608433,63616176,111111101,XM_022447877.1,uncharacterized LOC111111101,7743
NC_035788.1,63654534,63660887,63654534,63660887,111111102,XM_022447881.1,uncharacterized LOC111111102,6353
NC_035788.1,8331300,8333320,8331300,8333320,111111105,XM_022447883.1,uncharacterized LOC111111105,2020
NC_035788.1,61080170,61128735,61080170,61126106,111111109,XM_022447892.1,uncharacterized LOC111111109,45936
NC_035788.1,61080170,61128735,61080170,61128735,111111109,XM_022447887.1,uncharacterized LOC111111109,48565
NC_035788.1,55226590,55259754,55226590,55259754,111111113,XM_022447895.1,uncharacterized LOC111111113,33164
NC_035788.1,34841355,34846996,34841391,34846996,111111114,XM_022447896.1,uncharacterized LOC111111114,5605
NC_035788.1,34841355,34846996,34841355,34846996,111111114,XM_022447897.1,uncharacterized LOC111111114,5641
NC_035788.1,17565878,17604629,17565878,17604628,111111118,XM_022447902.1,uncharacterized LOC111111118,38750
NC_035788.1,17565878,17604629,17565878,17604629,111111118,XM_022447903.1,uncharacterized LOC111111118,38751
NC_035788.1,93960153,93966816,93963968,93966816,111111119,XM_022447907.1,uncharacterized LOC111111119,2848
NC_035788.1,93960153,93966816,93963830,93966816,111111119,XM_022447908.1,uncharacterized LOC111111119,2986
NC_035788.1,93960153,93966816,93962595,93966816,111111119,XM_022447906.1,uncharacterized LOC111111119,4221
NC_035788.1,93960153,93966816,93962593,93966816,111111119,XM_022447904.1,uncharacterized LOC111111119,4223
NC_035788.1,93960153,93966816,93960153,93966816,111111119,XM_022447905.1,uncharacterized LOC111111119,6663
NC_035788.1,66452038,66455900,66452038,66455252,111111120,XM_022447909.1,uncharacterized LOC111111120,3214
NC_035788.1,66452038,66455900,66452038,66455900,111111120,XM_022447910.1,uncharacterized LOC111111120,3862
NC_035780.1,57306042,57307972,57306042,57307972,111111130,XM_022447937.1,uncharacterized LOC111111130,1930
NC_035788.1,13607643,13618843,13607643,13618303,111111135,XM_022447944.1,uncharacterized LOC111111135,10660
NC_035788.1,13607643,13618843,13607643,13618843,111111135,XM_022447945.1,uncharacterized LOC111111135,11200
NC_035788.1,88201347,88205599,88201347,88205599,111111142,XM_022447948.1,uncharacterized LOC111111142,4252
NC_035788.1,92885098,92891026,92885098,92891026,111111144,XM_022447952.1,uncharacterized LOC111111144,5928
NC_035788.1,31841688,31844855,31841688,31844855,111111148,XM_022447955.1,uncharacterized LOC111111148,3167
NC_035788.1,20971241,20972307,20971241,20972307,111111151,XM_022447957.1,uncharacterized LOC111111151,1066
NC_035788.1,73725482,73732851,73725482,73732851,111111153,XM_022447959.1,uncharacterized LOC111111153,7369
NC_035788.1,66114327,66116824,66114327,66116824,111111154,XM_022447962.1,uncharacterized LOC111111154,2497
NC_035788.1,65324956,65331054,65324956,65331054,111111155,XM_022447964.1,uncharacterized LOC111111155,6098
NC_035788.1,97483170,97485047,97483170,97485047,111111158,XM_022447974.1,uncharacterized LOC111111158,1877
NC_035780.1,20472694,20477418,20472694,20477418,111111162,XM_022447982.1,uncharacterized LOC111111162,4724
NC_035788.1,94749380,94767866,94757712,94767866,111111163,XM_022447980.1,uncharacterized LOC111111163,10154
NC_035788.1,94749380,94767866,94749380,94767866,111111163,XM_022447979.1,uncharacterized LOC111111163,18486
NC_035788.1,16400993,16403039,16400993,16403039,111111166,XM_022447984.1,uncharacterized LOC111111166,2046
NC_035788.1,36877457,36887591,36877457,36887591,111111167,XM_022447985.1,uncharacterized LOC111111167,10134
NC_035788.1,52156888,52162651,52156889,52162651,111111168,XM_022447986.1,uncharacterized LOC111111168,5762
NC_035788.1,52156888,52162651,52156888,52162651,111111168,XM_022447987.1,uncharacterized LOC111111168,5763
NC_035780.1,57355504,57361295,57355504,57361295,111111170,XM_022447992.1,uncharacterized LOC111111170,5791
NC_035788.1,75972841,75978413,75972841,75978413,111111173,XM_022447991.1,uncharacterized LOC111111173,5572
NC_035788.1,103369706,103420102,103369706,103410273,111111178,XM_022448002.1,uncharacterized LOC111111178,40567
NC_035788.1,103369706,103420102,103369706,103410293,111111178,XM_022448001.1,uncharacterized LOC111111178,40587
NC_035788.1,103369706,103420102,103369706,103411745,111111178,XM_022448007.1,uncharacterized LOC111111178,42039
NC_035788.1,103369706,103420102,103369706,103411927,111111178,XM_022447997.1,uncharacterized LOC111111178,42221
NC_035788.1,103369706,103420102,103369706,103412131,111111178,XM_022448003.1,uncharacterized LOC111111178,42425
NC_035788.1,103369706,103420102,103369706,103413934,111111178,XM_022448000.1,uncharacterized LOC111111178,44228
NC_035788.1,103369706,103420102,103369706,103415758,111111178,XM_022447998.1,uncharacterized LOC111111178,46052
NC_035788.1,103369706,103420102,103369706,103420009,111111178,XM_022448006.1,uncharacterized LOC111111178,50303
NC_035788.1,103369706,103420102,103369706,103420102,111111178,XM_022447996.1,uncharacterized LOC111111178,50396
NC_035780.1,13210101,13212032,13210101,13212032,111111183,XM_022448017.1,uncharacterized LOC111111183,1931
NC_035788.1,35434250,35440282,35434250,35440282,111111184,XM_022448014.1,uncharacterized LOC111111184,6032
NC_035788.1,23985046,24002458,23985046,24002458,111111185,XM_022448015.1,uncharacterized LOC111111185,17412
NC_035788.1,23985046,24002458,23985046,23989264,111111185,XM_022448016.1,uncharacterized LOC111111185,4218
NC_035788.1,93302086,93305611,93302086,93304657,111111199,XM_022448026.1,uncharacterized LOC111111199,2571
NC_035788.1,93302086,93305611,93302086,93305611,111111199,XM_022448027.1,uncharacterized LOC111111199,3525
NC_035788.1,20017137,20024446,20017137,20024446,111111200,XM_022448028.1,uncharacterized LOC111111200,7309
NC_035788.1,83229156,83239022,83229156,83239022,111111201,XM_022448029.1,uncharacterized LOC111111201,9866
NC_035788.1,62041292,62043656,62041292,62043656,111111203,XM_022448030.1,uncharacterized LOC111111203,2364
NC_035788.1,90316155,90318936,90316155,90318936,111111204,XM_022448031.1,uncharacterized LOC111111204,2781
NC_035780.1,48016833,48026439,48016833,48026439,111111205,XM_022448034.1,uncharacterized LOC111111205,9606
NC_035780.1,54956910,54959113,54956910,54959113,111111214,XM_022448047.1,uncharacterized LOC111111214,2203
NC_035788.1,36388296,36390318,36388296,36390318,111111217,XM_022448053.1,uncharacterized LOC111111217,2022
NC_035788.1,30270286,30281744,30270286,30281744,111111221,XM_022448057.1,uncharacterized LOC111111221,11458
NC_035788.1,15868332,15871264,15868332,15871264,111111225,XM_022448068.1,uncharacterized LOC111111225,2932
NC_035788.1,15978653,15981356,15978653,15981356,111111227,XM_022448069.1,uncharacterized LOC111111227,2703
NC_035788.1,15757407,15808568,15805390,15808568,111111228,XM_022448071.1,uncharacterized LOC111111228,3178
NC_035788.1,15757407,15808568,15757407,15808568,111111228,XM_022448070.1,uncharacterized LOC111111228,51161
NC_035788.1,16063459,16070058,16063459,16070058,111111229,XM_022448072.1,uncharacterized LOC111111229,6599
NC_035788.1,16051599,16055953,16051599,16055953,111111232,XM_022448080.1,uncharacterized LOC111111232,4354
NC_035788.1,15772453,15779080,15772453,15779080,111111235,XM_022448082.1,uncharacterized LOC111111235,6627
NC_035788.1,15992942,16014112,15992942,16014112,111111239,XM_022448089.1,uncharacterized LOC111111239,21170
NC_035780.1,7462520,7484110,7462520,7484110,111111244,XM_022448114.1,uncharacterized LOC111111244,21590
NC_035788.1,88152589,88163921,88152589,88163921,111111245,XM_022448104.1,uncharacterized LOC111111245,11332
NC_035788.1,66434605,66438828,66434606,66438827,111111248,XM_022448108.1,uncharacterized LOC111111248,4221
NC_035788.1,66434605,66438828,66434606,66438828,111111248,XM_022448109.1,uncharacterized LOC111111248,4222
NC_035788.1,66434605,66438828,66434605,66438828,111111248,XM_022448110.1,uncharacterized LOC111111248,4223
NC_035788.1,90649392,90725240,90649392,90725240,111111251,XM_022448112.1,uncharacterized LOC111111251,75848
NC_035788.1,63700198,63705286,63700198,63705286,111111254,XM_022448115.1,uncharacterized LOC111111254,5088
NC_035788.1,254442,268292,254489,268292,111111255,XM_022448118.1,uncharacterized LOC111111255,13803
NC_035788.1,254442,268292,254470,268292,111111255,XM_022448116.1,uncharacterized LOC111111255,13822
NC_035788.1,254442,268292,254469,268292,111111255,XM_022448120.1,uncharacterized LOC111111255,13823
NC_035788.1,254442,268292,254453,268292,111111255,XM_022448119.1,uncharacterized LOC111111255,13839
NC_035788.1,254442,268292,254442,268292,111111255,XM_022448117.1,uncharacterized LOC111111255,13850
NC_035780.1,39262013,39273805,39262013,39273805,111111256,XM_022448133.1,uncharacterized LOC111111256,11792
NC_035780.1,39262013,39273805,39262013,39270063,111111256,XM_022448124.1,uncharacterized LOC111111256,8050
NC_035788.1,35303352,35314758,35303352,35314758,111111257,XM_022448122.1,uncharacterized LOC111111257,11406
NC_035788.1,18457866,18461860,18457866,18461860,111111258,XM_022448123.1,uncharacterized LOC111111258,3994
NC_035788.1,45254506,45256114,45254506,45256114,111111261,XM_022448129.1,uncharacterized LOC111111261,1608
NC_035780.1,18393367,18397098,18393367,18397098,111111262,XM_022448167.1,uncharacterized LOC111111262,3731
NC_035788.1,62199866,62203623,62199866,62203623,111111264,XM_022448132.1,uncharacterized LOC111111264,3757
NC_035788.1,1322778,1325155,1322778,1325155,111111267,XM_022448135.1,uncharacterized LOC111111267,2377
NC_035788.1,91853577,91858200,91853577,91857280,111111269,XM_022448136.1,uncharacterized LOC111111269,3703
NC_035788.1,91853577,91858200,91853577,91857311,111111269,XM_022448138.1,uncharacterized LOC111111269,3734
NC_035788.1,91853577,91858200,91853577,91858200,111111269,XM_022448137.1,uncharacterized LOC111111269,4623
NC_035788.1,93534855,93536703,93534855,93536703,111111271,XM_022448139.1,uncharacterized LOC111111271,1848
NC_035788.1,67942483,67945607,67942483,67945607,111111276,XM_022448148.1,uncharacterized LOC111111276,3124
NC_035788.1,651703,652690,651703,652690,111111278,XM_022448150.1,uncharacterized LOC111111278,987
NC_035788.1,83009463,83013686,83009476,83013686,111111279,XM_022448152.1,uncharacterized LOC111111279,4210
NC_035788.1,83009463,83013686,83009463,83013686,111111279,XM_022448151.1,uncharacterized LOC111111279,4223
NC_035780.1,63353494,63356139,63353494,63356139,111111280,XM_022448156.1,uncharacterized LOC111111280,2645
NC_035788.1,62768417,62772064,62768417,62772064,111111282,XM_022448155.1,uncharacterized LOC111111282,3647
NC_035788.1,75847031,75869845,75848035,75869844,111111285,XM_022448159.1,uncharacterized LOC111111285,21809
NC_035788.1,75847031,75869845,75847898,75869845,111111285,XM_022448160.1,uncharacterized LOC111111285,21947
NC_035788.1,75847031,75869845,75847031,75869845,111111285,XM_022448161.1,uncharacterized LOC111111285,22814
NC_035788.1,75776261,75792934,75776261,75792934,111111286,XM_022448162.1,uncharacterized LOC111111286,16673
NC_035788.1,75797696,75809977,75798301,75809977,111111289,XM_022448166.1,uncharacterized LOC111111289,11676
NC_035788.1,75797696,75809977,75798296,75809977,111111289,XM_022448165.1,uncharacterized LOC111111289,11681
NC_035788.1,75797696,75809977,75797696,75809977,111111289,XM_022448164.1,uncharacterized LOC111111289,12281
NC_035788.1,75797696,75809977,75798303,75807451,111111289,XM_022448169.1,uncharacterized LOC111111289,9148
NC_035788.1,57766825,57772279,57766833,57772279,111111290,XM_022448170.1,uncharacterized LOC111111290,5446
NC_035788.1,57766825,57772279,57766825,57772279,111111290,XM_022448171.1,uncharacterized LOC111111290,5454
NC_035788.1,58899173,58935948,58908308,58935948,111111297,XM_022448185.1,uncharacterized LOC111111297,27640
NC_035788.1,58899173,58935948,58899173,58935948,111111297,XM_022448184.1,uncharacterized LOC111111297,36775
NC_035788.1,54092226,54116334,54101845,54116318,111111298,XM_022448189.1,uncharacterized LOC111111298,14473
NC_035788.1,54092226,54116334,54107930,54116315,111111298,XM_022448188.1,uncharacterized LOC111111298,8385
NC_035788.1,70604251,70606824,70604251,70606824,111111299,XM_022448190.1,uncharacterized LOC111111299,2573
NC_035780.1,58990755,58999255,58990755,58999255,111111300,XM_022448193.1,uncharacterized LOC111111300,8500
NC_035788.1,50289571,50296075,50292330,50296075,111111306,XM_022448197.1,uncharacterized LOC111111306,3745
NC_035788.1,50289571,50296075,50289571,50296075,111111306,XM_022448196.1,uncharacterized LOC111111306,6504
NC_035788.1,50296075,50298611,50296075,50298611,111111307,XM_022448198.1,uncharacterized LOC111111307,2536
NC_035788.1,87014010,87016139,87014010,87016139,111111309,XM_022448201.1,uncharacterized LOC111111309,2129
NC_035788.1,86991429,86994145,86991429,86994145,111111310,XM_022448202.1,uncharacterized LOC111111310,2716
NC_035788.1,729111,748723,729111,748723,111111313,XM_022448210.1,uncharacterized LOC111111313,19612
NC_035788.1,4144442,4155491,4144444,4155491,111111314,XM_022448213.1,uncharacterized LOC111111314,11047
NC_035788.1,4144442,4155491,4144443,4155491,111111314,XM_022448211.1,uncharacterized LOC111111314,11048
NC_035788.1,4144442,4155491,4144442,4155491,111111314,XM_022448216.1,uncharacterized LOC111111314,11049
NC_035788.1,20594869,20599063,20594869,20599063,111111315,XM_022448217.1,uncharacterized LOC111111315,4194
NC_035788.1,20597835,20598818,20597835,20598818,111111316,XM_022448218.1,uncharacterized LOC111111316,983
NC_035788.1,83242504,83244827,83242504,83244827,111111319,XM_022448221.1,uncharacterized LOC111111319,2323
NC_035788.1,21131448,21137431,21131448,21137431,111111323,XM_022448228.1,uncharacterized LOC111111323,5983
NC_035780.1,6890936,6891942,6890936,6891942,111111325,XM_022448233.1,uncharacterized LOC111111325,1006
NC_035788.1,101861253,101874046,101861253,101874046,111111326,XM_022448230.1,uncharacterized LOC111111326,12793
NC_035788.1,44764330,44766905,44764330,44766905,111111330,XM_022448234.1,uncharacterized LOC111111330,2575
NC_035788.1,22299878,22306084,22299878,22306084,111111332,XM_022448240.1,uncharacterized LOC111111332,6206
NC_035788.1,18177664,18200345,18177664,18200345,111111335,XM_022448251.1,uncharacterized LOC111111335,22681
NC_035780.1,18386289,18391341,18386289,18391340,111111337,XM_022448293.1,uncharacterized LOC111111337,5051
NC_035780.1,18386289,18391341,18386289,18391341,111111337,XM_022448381.1,uncharacterized LOC111111337,5052
NC_035788.1,97721997,97759036,97721997,97759036,111111340,XM_022448254.1,uncharacterized LOC111111340,37039
NC_035780.1,22796939,22799034,22796939,22799034,111111342,XM_022448260.1,uncharacterized LOC111111342,2095
NC_035788.1,50443960,50449874,50443960,50449826,111111343,XM_022448265.1,uncharacterized LOC111111343,5866
NC_035788.1,50443960,50449874,50443960,50449834,111111343,XM_022448264.1,uncharacterized LOC111111343,5874
NC_035788.1,50443960,50449874,50443960,50449874,111111343,XM_022448263.1,uncharacterized LOC111111343,5914
NC_035788.1,50473391,50502653,50473391,50496746,111111344,XM_022448269.1,uncharacterized LOC111111344,23355
NC_035788.1,50473391,50502653,50473391,50502653,111111344,XM_022448270.1,uncharacterized LOC111111344,29262
NC_035788.1,50473391,50502653,50473391,50479010,111111344,XM_022448267.1,uncharacterized LOC111111344,5619
NC_035788.1,50469156,50487138,50469156,50487138,111111346,XM_022448271.1,uncharacterized LOC111111346,17982
NC_035788.1,50588914,50613401,50588914,50613401,111111347,XM_022448276.1,uncharacterized LOC111111347,24487
NC_035788.1,88290298,88292766,88290298,88292766,111111349,XM_022448279.1,uncharacterized LOC111111349,2468
NC_035788.1,20788493,20791684,20788493,20791684,111111352,XM_022448282.1,uncharacterized LOC111111352,3191
NC_035788.1,24634476,24636625,24634476,24636625,111111364,XM_022448305.1,uncharacterized LOC111111364,2149
NC_035788.1,21640701,21653997,21643672,21653997,111111365,XM_022448309.1,uncharacterized LOC111111365,10325
NC_035788.1,21640701,21653997,21642055,21653997,111111365,XM_022448310.1,uncharacterized LOC111111365,11942
NC_035788.1,21640701,21653997,21640701,21653997,111111365,XM_022448306.1,uncharacterized LOC111111365,13296
NC_035788.1,55889091,55893895,55889091,55893895,111111366,XM_022448311.1,uncharacterized LOC111111366,4804
NC_035788.1,55970707,55993641,55970707,55993634,111111367,XM_022448312.1,uncharacterized LOC111111367,22927
NC_035788.1,55970707,55993641,55970707,55974383,111111367,XM_022448313.1,uncharacterized LOC111111367,3676
NC_035788.1,55970707,55993641,55989946,55993641,111111367,XM_022448314.1,uncharacterized LOC111111367,3695
NC_035788.1,55935315,55938129,55935315,55938129,111111368,XM_022448315.1,uncharacterized LOC111111368,2814
NC_035788.1,55743377,55748281,55743377,55748281,111111369,XM_022448316.1,uncharacterized LOC111111369,4904
NC_035788.1,55848576,55851408,55848576,55851408,111111371,XM_022448317.1,uncharacterized LOC111111371,2832
NC_035788.1,56013642,56016524,56013642,56016524,111111372,XM_022448318.1,uncharacterized LOC111111372,2882
NC_035788.1,55697464,55700936,55697464,55700936,111111373,XM_022448319.1,uncharacterized LOC111111373,3472
NC_035788.1,55629811,55633449,55629811,55633449,111111374,XM_022448321.1,uncharacterized LOC111111374,3638
NC_035788.1,55868600,55871963,55868600,55871963,111111375,XM_022448322.1,uncharacterized LOC111111375,3363
NC_035788.1,55910398,55912966,55910398,55912966,111111380,XM_022448335.1,uncharacterized LOC111111380,2568
NC_035788.1,55769301,55797873,55769301,55797873,111111381,XM_022448336.1,uncharacterized LOC111111381,28572
NC_035780.1,16880479,16892728,16880479,16892728,111111383,XM_022448341.1,uncharacterized LOC111111383,12249
NC_035788.1,55807676,55813147,55807676,55813147,111111385,XM_022448339.1,uncharacterized LOC111111385,5471
NC_035788.1,85662330,85667376,85662441,85667376,111111397,XM_022448375.1,uncharacterized LOC111111397,4935
NC_035788.1,85662330,85667376,85662330,85667375,111111397,XM_022448376.1,uncharacterized LOC111111397,5045
NC_035788.1,85689508,85692215,85689508,85692215,111111398,XM_022448378.1,uncharacterized LOC111111398,2707
NC_035788.1,85681118,85683780,85681118,85683778,111111399,XM_022448379.1,uncharacterized LOC111111399,2660
NC_035788.1,85681118,85683780,85681118,85683780,111111399,XM_022448380.1,uncharacterized LOC111111399,2662
NC_035788.1,85686559,85689223,85686559,85689221,111111400,XM_022448382.1,uncharacterized LOC111111400,2662
NC_035788.1,85686559,85689223,85686559,85689223,111111400,XM_022448383.1,uncharacterized LOC111111400,2664
NC_035788.1,85652331,85675228,85652331,85675228,111111402,XM_022448386.1,uncharacterized LOC111111402,22897
NC_035788.1,85652331,85675228,85668631,85675135,111111402,XM_022448387.1,uncharacterized LOC111111402,6504
NC_035780.1,7898151,7909318,7898152,7909300,111111403,XM_022448389.1,uncharacterized LOC111111403,11148
NC_035780.1,7898151,7909318,7898151,7909301,111111403,XM_022448396.1,uncharacterized LOC111111403,11150
NC_035780.1,7898151,7909318,7901237,7909318,111111403,XM_022448403.1,uncharacterized LOC111111403,8081
NC_035788.1,13164685,13171992,13164685,13171992,111111414,XM_022448399.1,uncharacterized LOC111111414,7307
NC_035788.1,21059610,21061707,21059610,21061707,111111416,XM_022448401.1,uncharacterized LOC111111416,2097
NC_035788.1,13404312,13407236,13404312,13407236,111111418,XM_022448404.1,uncharacterized LOC111111418,2924
NC_035788.1,13190449,13208231,13190449,13208210,111111421,XM_022448407.1,uncharacterized LOC111111421,17761
NC_035788.1,13190449,13208231,13190449,13208231,111111421,XM_022448408.1,uncharacterized LOC111111421,17782
NC_035788.1,17017365,17040952,17017365,17040952,111111428,XM_022448414.1,uncharacterized LOC111111428,23587
NC_035788.1,87624413,87630430,87624413,87630430,111111429,XM_022448415.1,uncharacterized LOC111111429,6017
NC_035788.1,87634980,87638027,87634980,87638027,111111435,XM_022448427.1,uncharacterized LOC111111435,3047
NC_035788.1,6098369,6101524,6098369,6101524,111111440,XM_022448431.1,uncharacterized LOC111111440,3155
NC_035788.1,23871713,23883816,23871716,23883815,111111446,XM_022448439.1,uncharacterized LOC111111446,12099
NC_035788.1,23871713,23883816,23871713,23883816,111111446,XM_022448440.1,uncharacterized LOC111111446,12103
NC_035788.1,94951514,94962387,94951514,94962387,111111448,XM_022448441.1,uncharacterized LOC111111448,10873
NC_035788.1,3687985,3699607,3687985,3699607,111111451,XM_022448446.1,uncharacterized LOC111111451,11622
NC_035788.1,3687985,3699607,3687985,3691653,111111451,XM_022448445.1,uncharacterized LOC111111451,3668
NC_035788.1,3687985,3699607,3687985,3695988,111111451,XM_022448447.1,uncharacterized LOC111111451,8003
NC_035788.1,3687985,3699607,3687985,3697673,111111451,XM_022448444.1,uncharacterized LOC111111451,9688
NC_035780.1,45224993,45228359,45224993,45228359,111111455,XM_022448452.1,uncharacterized LOC111111455,3366
NC_035780.1,18361903,18363228,18361903,18363228,111111460,XM_022448488.1,uncharacterized LOC111111460,1325
NC_035788.1,54595657,54601184,54595657,54601184,111111461,XM_022448453.1,uncharacterized LOC111111461,5527
NC_035788.1,54608459,54611248,54608459,54611248,111111462,XM_022448454.1,uncharacterized LOC111111462,2789
NC_035788.1,63555400,63557447,63555400,63557446,111111465,XM_022448460.1,uncharacterized LOC111111465,2046
NC_035788.1,63555400,63557447,63555400,63557447,111111465,XM_022448461.1,uncharacterized LOC111111465,2047
NC_035788.1,95701994,95707125,95701994,95706995,111111467,XM_022448462.1,uncharacterized LOC111111467,5001
NC_035788.1,95701994,95707125,95701994,95707125,111111467,XM_022448463.1,uncharacterized LOC111111467,5131
NC_035788.1,78889524,78927883,78889524,78927883,111111468,XM_022448464.1,uncharacterized LOC111111468,38359
NC_035780.1,57304172,57305318,57304172,57305318,111111473,XM_022448471.1,uncharacterized LOC111111473,1146
NC_035788.1,51496917,51511942,51496917,51511942,111111478,XM_022448472.1,uncharacterized LOC111111478,15025
NC_035788.1,65405191,65420297,65405191,65420297,111111489,XM_022448504.1,uncharacterized LOC111111489,15106
NC_035788.1,15048203,15050243,15048203,15050243,111111495,XM_022448508.1,uncharacterized LOC111111495,2040
NC_035788.1,93851052,93858284,93851981,93858282,111111496,XM_022448512.1,uncharacterized LOC111111496,6301
NC_035788.1,93851052,93858284,93851052,93858282,111111496,XM_022448511.1,uncharacterized LOC111111496,7230
NC_035788.1,93851052,93858284,93851052,93858284,111111496,XM_022448509.1,uncharacterized LOC111111496,7232
NC_035788.1,76784804,76795730,76784804,76795730,111111498,XM_022448515.1,uncharacterized LOC111111498,10926
NC_035788.1,76784804,76795730,76784804,76793229,111111498,XM_022448517.1,uncharacterized LOC111111498,8425
NC_035788.1,76784804,76795730,76784804,76793231,111111498,XM_022448514.1,uncharacterized LOC111111498,8427
NC_035788.1,34944251,34951221,34944251,34951221,111111500,XM_022448518.1,uncharacterized LOC111111500,6970
NC_035788.1,103176005,103187139,103176005,103187139,111111502,XM_022448521.1,uncharacterized LOC111111502,11134
NC_035788.1,22824909,22827203,22824909,22827203,111111506,XM_022448524.1,uncharacterized LOC111111506,2294
NC_035788.1,14936845,14940285,14936845,14939017,111111508,XM_022448525.1,uncharacterized LOC111111508,2172
NC_035788.1,14936845,14940285,14936845,14940285,111111508,XM_022448526.1,uncharacterized LOC111111508,3440
NC_035788.1,66412814,66415324,66412814,66415324,111111511,XM_022448528.1,uncharacterized LOC111111511,2510
NC_035788.1,61567242,61616179,61567242,61611685,111111512,XM_022448529.1,uncharacterized LOC111111512,44443
NC_035788.1,61567242,61616179,61567242,61616179,111111512,XM_022448530.1,uncharacterized LOC111111512,48937
NC_035788.1,4392727,4404105,4392727,4403203,111111514,XM_022448533.1,uncharacterized LOC111111514,10476
NC_035788.1,4392727,4404105,4392727,4404105,111111514,XM_022448532.1,uncharacterized LOC111111514,11378
NC_035788.1,3085057,3094851,3085057,3094851,111111518,XM_022448538.1,uncharacterized LOC111111518,9794
NC_035788.1,60026739,60033430,60026739,60033430,111111521,XM_022448545.1,uncharacterized LOC111111521,6691
NC_035788.1,52529686,52544607,52529690,52544607,111111522,XM_022448547.1,uncharacterized LOC111111522,14917
NC_035788.1,52529686,52544607,52529686,52533841,111111522,XM_022448546.1,uncharacterized LOC111111522,4155
NC_035780.1,5268354,5275155,5268354,5275155,111111523,XM_022448551.1,uncharacterized LOC111111523,6801
NC_035788.1,66419846,66423321,66419846,66423295,111111524,XM_022448549.1,uncharacterized LOC111111524,3449
NC_035788.1,66419846,66423321,66419847,66423321,111111524,XM_022448548.1,uncharacterized LOC111111524,3474
NC_035788.1,83163233,83168868,83163233,83168868,111111526,XM_022448554.1,uncharacterized LOC111111526,5635
NC_035780.1,27321896,27325221,27321896,27325165,111111528,XM_022448563.1,uncharacterized LOC111111528,3269
NC_035780.1,27321896,27325221,27321896,27325221,111111528,XM_022448571.1,uncharacterized LOC111111528,3325
NC_035788.1,94321270,94341414,94327831,94341414,111111531,XM_022448564.1,uncharacterized LOC111111531,13583
NC_035788.1,94321270,94341414,94327830,94341414,111111531,XM_022448566.1,uncharacterized LOC111111531,13584
NC_035788.1,94321270,94341414,94322111,94341414,111111531,XM_022448565.1,uncharacterized LOC111111531,19303
NC_035788.1,94321270,94341414,94321270,94341414,111111531,XM_022448567.1,uncharacterized LOC111111531,20144
NC_035788.1,31754792,31761703,31754792,31759401,111111534,XM_022448569.1,uncharacterized LOC111111534,4609
NC_035788.1,31754792,31761703,31754792,31760511,111111534,XM_022448568.1,uncharacterized LOC111111534,5719
NC_035788.1,31754792,31761703,31754792,31761703,111111534,XM_022448570.1,uncharacterized LOC111111534,6911
NC_035788.1,16656750,16659908,16656750,16659908,111111538,XM_022448579.1,uncharacterized LOC111111538,3158
NC_035788.1,9754233,9761494,9754233,9761494,111111540,XM_022448580.1,uncharacterized LOC111111540,7261
NC_035788.1,75568581,75574870,75568581,75574870,111111542,XM_022448584.1,uncharacterized LOC111111542,6289
NC_035780.1,1543472,1545772,1543472,1545772,111111547,XM_022448595.1,uncharacterized LOC111111547,2300
NC_035788.1,61976180,61978882,61976180,61978882,111111548,XM_022448593.1,uncharacterized LOC111111548,2702
NC_035788.1,61924462,61927148,61924462,61927148,111111549,XM_022448594.1,uncharacterized LOC111111549,2686
NC_035788.1,37261563,37270736,37261563,37270736,111111552,XM_022448598.1,uncharacterized LOC111111552,9173
NC_035788.1,37814396,37819943,37816534,37819943,111111553,XM_022448599.1,uncharacterized LOC111111553,3409
NC_035788.1,37814396,37819943,37814396,37819507,111111553,XM_022448601.1,uncharacterized LOC111111553,5111
NC_035788.1,37814396,37819943,37814396,37819943,111111553,XM_022448600.1,uncharacterized LOC111111553,5547
NC_035788.1,67094516,67127654,67094516,67127654,111111554,XM_022448602.1,uncharacterized LOC111111554,33138
NC_035780.1,63469976,63473194,63469976,63473194,111111555,XM_022448607.1,uncharacterized LOC111111555,3218
NC_035788.1,67164406,67169536,67164406,67169536,111111556,XM_022448603.1,uncharacterized LOC111111556,5130
NC_035788.1,86935392,86946144,86935392,86946144,111111559,XM_022448608.1,uncharacterized LOC111111559,10752
NC_035788.1,37207742,37238815,37207742,37210702,111111568,XM_022448616.1,uncharacterized LOC111111568,2960
NC_035788.1,37207742,37238815,37207742,37238815,111111568,XM_022448617.1,uncharacterized LOC111111568,31073
NC_035788.1,37207742,37238815,37207742,37210954,111111568,XM_022448618.1,uncharacterized LOC111111568,3212
NC_035788.1,103213703,103219923,103213733,103219923,111111570,XM_022448624.1,uncharacterized LOC111111570,6190
NC_035788.1,103213703,103219923,103213709,103219923,111111570,XM_022448625.1,uncharacterized LOC111111570,6214
NC_035788.1,103213703,103219923,103213703,103219923,111111570,XM_022448623.1,uncharacterized LOC111111570,6220
NC_035780.1,19856177,19868531,19856177,19868531,111111571,XM_022448629.1,uncharacterized LOC111111571,12354
NC_035788.1,90565729,90579603,90565731,90579598,111111572,XM_022448627.1,uncharacterized LOC111111572,13867
NC_035788.1,90565729,90579603,90565729,90579603,111111572,XM_022448628.1,uncharacterized LOC111111572,13874
NC_035788.1,90565729,90579603,90565729,90573185,111111572,XM_022448626.1,uncharacterized LOC111111572,7456
NC_035788.1,53183208,53214551,53183208,53214551,111111574,XM_022448631.1,uncharacterized LOC111111574,31343
NC_035788.1,6489744,6495719,6489745,6493099,111111576,XM_022448633.1,uncharacterized LOC111111576,3354
NC_035788.1,6489744,6495719,6489745,6494894,111111576,XM_022448634.1,uncharacterized LOC111111576,5149
NC_035788.1,6489744,6495719,6489744,6495719,111111576,XM_022448635.1,uncharacterized LOC111111576,5975
NC_035788.1,50701695,50717246,50701695,50717246,111111578,XM_022448636.1,uncharacterized LOC111111578,15551
NC_035788.1,61655839,61663851,61656265,61663851,111111582,XM_022448640.1,uncharacterized LOC111111582,7586
NC_035788.1,61655839,61663851,61656263,61663851,111111582,XM_022448637.1,uncharacterized LOC111111582,7588
NC_035788.1,61655839,61663851,61656262,61663851,111111582,XM_022448643.1,uncharacterized LOC111111582,7589
NC_035788.1,61655839,61663851,61655839,61663851,111111582,XM_022448638.1,uncharacterized LOC111111582,8012
NC_035788.1,49362746,49372079,49362746,49372079,111111584,XM_022448647.1,uncharacterized LOC111111584,9333
NC_035788.1,49372130,49383601,49377221,49383601,111111585,XM_022448648.1,uncharacterized LOC111111585,6380
NC_035788.1,49445795,49447323,49445795,49447323,111111587,XM_022448649.1,uncharacterized LOC111111587,1528
NC_035788.1,25125197,25230358,25125197,25230358,111111589,XM_022448651.1,uncharacterized LOC111111589,105161
NC_035788.1,43385923,43386804,43385923,43386804,111111591,XM_022448655.1,uncharacterized LOC111111591,881
NC_035788.1,31562834,31578624,31562834,31578624,111111593,XM_022448657.1,uncharacterized LOC111111593,15790
NC_035788.1,31562834,31578624,31573767,31578624,111111593,XM_022448658.1,uncharacterized LOC111111593,4857
NC_035788.1,45294987,45300306,45294987,45300306,111111594,XM_022448659.1,uncharacterized LOC111111594,5319
NC_035780.1,19670248,19672246,19670248,19672246,111111600,XM_022448672.1,uncharacterized LOC111111600,1998
NC_035788.1,71152633,71155288,71152633,71155288,111111608,XM_022448684.1,uncharacterized LOC111111608,2655
NC_035788.1,10664546,10683351,10664546,10683351,111111611,XM_022448690.1,uncharacterized LOC111111611,18805
NC_035788.1,75004841,75020366,75004841,75020366,111111612,XM_022448691.1,uncharacterized LOC111111612,15525
NC_035788.1,19017928,19032708,19017928,19032708,111111618,XM_022448702.1,uncharacterized LOC111111618,14780
NC_035788.1,14688706,14692826,14688706,14692826,111111625,XM_022448712.1,uncharacterized LOC111111625,4120
NC_035788.1,3364805,3390375,3371582,3390375,111111627,XM_022448716.1,uncharacterized LOC111111627,18793
NC_035788.1,3364805,3390375,3364805,3390375,111111627,XM_022448715.1,uncharacterized LOC111111627,25570
NC_035788.1,16184683,16191989,16184688,16191989,111111630,XM_022448719.1,uncharacterized LOC111111630,7301
NC_035788.1,16184683,16191989,16184683,16191989,111111630,XM_022448718.1,uncharacterized LOC111111630,7306
NC_035788.1,52210013,52234666,52210013,52230874,111111634,XM_022448723.1,uncharacterized LOC111111634,20861
NC_035788.1,52210013,52234666,52210013,52234666,111111634,XM_022448724.1,uncharacterized LOC111111634,24653
NC_035788.1,76300111,76320857,76300111,76320857,111111636,XM_022448725.1,uncharacterized LOC111111636,20746
NC_035788.1,76044798,76052652,76044798,76052652,111111637,XM_022448726.1,uncharacterized LOC111111637,7854
NC_035780.1,19844346,19846519,19844352,19846519,111111640,XM_022448731.1,uncharacterized LOC111111640,2167
NC_035780.1,19844346,19846519,19844346,19846519,111111640,XM_022448740.1,uncharacterized LOC111111640,2173
NC_035788.1,96022096,96097312,96022096,96097312,111111641,XM_022448728.1,uncharacterized LOC111111641,75216
NC_035788.1,54578393,54581386,54578393,54581386,111111642,XM_022448729.1,uncharacterized LOC111111642,2993
NC_035788.1,54587510,54591748,54587510,54591748,111111643,XM_022448730.1,uncharacterized LOC111111643,4238
NC_035788.1,73633882,73636564,73633882,73636564,111111645,XM_022448732.1,uncharacterized LOC111111645,2682
NC_035788.1,61759781,61838668,61759783,61838668,111111646,XM_022448744.1,uncharacterized LOC111111646,78885
NC_035788.1,61759781,61838668,61759781,61838668,111111646,XM_022448733.1,uncharacterized LOC111111646,78887
NC_035788.1,61833635,61836218,61833635,61835537,111111647,XM_022448745.1,uncharacterized LOC111111647,1902
NC_035788.1,73191468,73193572,73191468,73193572,111111652,XM_022448749.1,uncharacterized LOC111111652,2104
NC_035788.1,61544409,61555524,61544409,61555524,111111656,XM_022448753.1,uncharacterized LOC111111656,11115
NC_035788.1,94302387,94316570,94302387,94316570,111111660,XM_022448757.1,uncharacterized LOC111111660,14183
NC_035780.1,19719115,19723451,19719115,19723451,111111661,XM_022448762.1,uncharacterized LOC111111661,4336
NC_035788.1,78945437,78978863,78945437,78978863,111111662,XM_022448758.1,uncharacterized LOC111111662,33426
NC_035788.1,89407573,89448714,89407573,89448714,111111665,XM_022448764.1,uncharacterized LOC111111665,41141
NC_035788.1,89050231,89104403,89050231,89104403,111111667,XM_022448772.1,uncharacterized LOC111111667,54172
NC_035788.1,88847142,88855528,88847142,88855528,111111668,XM_022448773.1,uncharacterized LOC111111668,8386
NC_035788.1,89142265,89145718,89142265,89145718,111111672,XM_022448779.1,uncharacterized LOC111111672,3453
NC_035780.1,19609362,19614198,19609362,19614198,111111673,XM_022448792.1,uncharacterized LOC111111673,4836
NC_035788.1,89960979,89963607,89960979,89963607,111111675,XM_022448784.1,uncharacterized LOC111111675,2628
NC_035788.1,90052231,90054915,90052231,90054915,111111678,XM_022448788.1,uncharacterized LOC111111678,2684
NC_035788.1,90175021,90221833,90175021,90177364,111111680,XM_022448796.1,uncharacterized LOC111111680,2343
NC_035788.1,90175021,90221833,90218284,90221787,111111680,XM_022448797.1,uncharacterized LOC111111680,3503
NC_035788.1,90175021,90221833,90175021,90221833,111111680,XM_022448795.1,uncharacterized LOC111111680,46812
NC_035788.1,89752453,89754577,89752453,89754577,111111681,XM_022448798.1,uncharacterized LOC111111681,2124
NC_035788.1,89946677,89949276,89946677,89949276,111111683,XM_022448800.1,uncharacterized LOC111111683,2599
NC_035780.1,19698969,19706130,19700894,19706130,111111684,XM_022448805.1,uncharacterized LOC111111684,5236
NC_035780.1,19698969,19706130,19698969,19706130,111111684,XM_022448814.1,uncharacterized LOC111111684,7161
NC_035788.1,89920494,89923815,89920494,89923815,111111685,XM_022448801.1,uncharacterized LOC111111685,3321
NC_035788.1,90100174,90102628,90100174,90102628,111111687,XM_022448804.1,uncharacterized LOC111111687,2454
NC_035788.1,88887381,88889977,88887381,88889977,111111688,XM_022448806.1,uncharacterized LOC111111688,2596
NC_035788.1,89209052,89211124,89209052,89211124,111111692,XM_022448815.1,uncharacterized LOC111111692,2072
NC_035788.1,89247423,89249093,89247423,89249093,111111694,XM_022448817.1,uncharacterized LOC111111694,1670
NC_035788.1,89805044,89826865,89805044,89826864,111111696,XM_022448819.1,uncharacterized LOC111111696,21820
NC_035788.1,89805044,89826865,89817399,89826865,111111696,XM_022448820.1,uncharacterized LOC111111696,9466
NC_035788.1,90133270,90136610,90133270,90136610,111111697,XM_022448821.1,uncharacterized LOC111111697,3340
NC_035788.1,89730220,89740906,89730223,89740906,111111699,XM_022448823.1,uncharacterized LOC111111699,10683
NC_035788.1,89730220,89740906,89730220,89732844,111111699,XM_022448822.1,uncharacterized LOC111111699,2624
NC_035788.1,89795328,89802225,89795333,89802225,111111701,XM_022448827.1,uncharacterized LOC111111701,6892
NC_035788.1,89795328,89802225,89795328,89802225,111111701,XM_022448828.1,uncharacterized LOC111111701,6897
NC_035788.1,89373055,89374845,89373055,89374845,111111702,XM_022448829.1,uncharacterized LOC111111702,1790
NC_035788.1,88855541,88862349,88855541,88862349,111111703,XM_022448830.1,uncharacterized LOC111111703,6808
NC_035788.1,89747455,89749380,89747455,89749380,111111705,XM_022448837.1,uncharacterized LOC111111705,1925
NC_035788.1,89587726,89596132,89587726,89596132,111111706,XM_022448838.1,uncharacterized LOC111111706,8406
NC_035788.1,89451701,89457525,89451701,89457525,111111710,XM_022448843.1,uncharacterized LOC111111710,5824
NC_035788.1,89845463,89852842,89845463,89851390,111111715,XM_022448859.1,uncharacterized LOC111111715,5927
NC_035788.1,89845463,89852842,89845463,89852185,111111715,XM_022448856.1,uncharacterized LOC111111715,6722
NC_035788.1,89845463,89852842,89845463,89852842,111111715,XM_022448858.1,uncharacterized LOC111111715,7379
NC_035788.1,89370930,89372852,89370930,89372852,111111717,XM_022448862.1,uncharacterized LOC111111717,1922
NC_035780.1,19708641,19717313,19708641,19712412,111111721,XM_022448878.1,uncharacterized LOC111111721,3771
NC_035780.1,19708641,19717313,19708641,19712966,111111721,XM_022448870.1,uncharacterized LOC111111721,4325
NC_035780.1,19708641,19717313,19708641,19714067,111111721,XM_022448872.1,uncharacterized LOC111111721,5426
NC_035780.1,19708641,19717313,19708641,19717313,111111721,XM_022448868.1,uncharacterized LOC111111721,8672
NC_035788.1,90016982,90018288,90016982,90018288,111111722,XM_022448866.1,uncharacterized LOC111111722,1306
NC_035788.1,89266033,89281456,89266048,89281456,111111723,XM_022448867.1,uncharacterized LOC111111723,15408
NC_035788.1,41096883,41134380,41096883,41134345,111111741,XM_022448876.1,uncharacterized LOC111111741,37462
NC_035788.1,41096883,41134380,41096883,41134358,111111741,XM_022448875.1,uncharacterized LOC111111741,37475
NC_035788.1,41096883,41134380,41096883,41134380,111111741,XM_022448877.1,uncharacterized LOC111111741,37497
NC_035788.1,41104548,41123071,41104548,41123071,111111742,XM_022448879.1,uncharacterized LOC111111742,18523
NC_035788.1,41152476,41155342,41152476,41155342,111111743,XM_022448880.1,uncharacterized LOC111111743,2866
NC_035788.1,44307296,44317179,44310290,44317179,111111750,XM_022448891.1,uncharacterized LOC111111750,6889
NC_035788.1,44307296,44317179,44309664,44317179,111111750,XM_022448890.1,uncharacterized LOC111111750,7515
NC_035788.1,44307296,44317179,44307296,44317179,111111750,XM_022448889.1,uncharacterized LOC111111750,9883
NC_035788.1,44054732,44061412,44054732,44061412,111111752,XM_022448892.1,uncharacterized LOC111111752,6680
NC_035788.1,44206379,44209460,44206379,44209460,111111753,XM_022448893.1,uncharacterized LOC111111753,3081
NC_035788.1,21061822,21064492,21061822,21064492,111111764,XM_022448899.1,uncharacterized LOC111111764,2670
NC_035788.1,29722104,29756276,29734344,29756276,111111766,XM_022448903.1,uncharacterized LOC111111766,21932
NC_035788.1,29722104,29756276,29722104,29756276,111111766,XM_022448902.1,uncharacterized LOC111111766,34172
NC_035788.1,29017687,29274299,29017687,29033904,111111767,XM_022448904.1,uncharacterized LOC111111767,16217
NC_035788.1,29017687,29274299,29017687,29274299,111111767,XM_022448905.1,uncharacterized LOC111111767,256612
NC_035788.1,29306548,29327075,29306548,29327075,111111770,XM_022448906.1,uncharacterized LOC111111770,20527
NC_035788.1,29885151,29936185,29885151,29936185,111111774,XM_022448916.1,uncharacterized LOC111111774,51034
NC_035788.1,29354444,29358234,29354444,29358234,111111784,XM_022448938.1,uncharacterized LOC111111784,3790
NC_035780.1,34092939,34096099,34092939,34096099,111111787,XM_022448941.1,uncharacterized LOC111111787,3160
NC_035788.1,23705796,23714935,23705796,23714935,111111792,XM_022448942.1,uncharacterized LOC111111792,9139
NC_035788.1,61856140,61858722,61856140,61858722,111111793,XM_022448943.1,uncharacterized LOC111111793,2582
NC_035788.1,62877977,62881950,62877977,62881950,111111794,XM_022448944.1,uncharacterized LOC111111794,3973
NC_035780.1,3939048,3949872,3939048,3949872,111111799,XM_022448950.1,uncharacterized LOC111111799,10824
NC_035780.1,3939048,3949872,3941859,3949872,111111799,XM_022448956.1,uncharacterized LOC111111799,8013
NC_035788.1,63805201,63821042,63805201,63821042,111111800,XM_022448948.1,uncharacterized LOC111111800,15841
NC_035788.1,55269266,55274496,55269266,55274496,111111801,XM_022448949.1,uncharacterized LOC111111801,5230
NC_035788.1,3843035,3845918,3843035,3845918,111111802,XM_022448951.1,uncharacterized LOC111111802,2883
NC_035788.1,21879023,21880740,21879023,21880740,111111804,XM_022448952.1,uncharacterized LOC111111804,1717
NC_035788.1,23918194,23921510,23918194,23921510,111111805,XM_022448953.1,uncharacterized LOC111111805,3316
NC_035788.1,19588531,19593138,19588531,19593138,111111808,XM_022448955.1,uncharacterized LOC111111808,4607
NC_035788.1,61668873,61680832,61668875,61680832,111111809,XM_022448957.1,uncharacterized LOC111111809,11957
NC_035788.1,61668873,61680832,61668873,61680832,111111809,XM_022448958.1,uncharacterized LOC111111809,11959
NC_035788.1,3853822,3857977,3853822,3857977,111111811,XM_022448960.1,uncharacterized LOC111111811,4155
NC_035788.1,69073417,69093044,69078113,69093044,111111812,XM_022448962.1,uncharacterized LOC111111812,14931
NC_035788.1,69073417,69093044,69073417,69093044,111111812,XM_022448961.1,uncharacterized LOC111111812,19627
NC_035788.1,69021261,69050705,69021261,69050684,111111813,XM_022448963.1,uncharacterized LOC111111813,29423
NC_035788.1,69021261,69050705,69021261,69050705,111111813,XM_022448965.1,uncharacterized LOC111111813,29444
NC_035788.1,68931151,68952793,68931151,68952793,111111814,XM_022448966.1,uncharacterized LOC111111814,21642
NC_035788.1,68887056,68914869,68887056,68914869,111111815,XM_022448967.1,uncharacterized LOC111111815,27813
NC_035788.1,68861194,68885837,68861325,68885837,111111816,XM_022448969.1,uncharacterized LOC111111816,24512
NC_035788.1,68861194,68885837,68861201,68885837,111111816,XM_022448970.1,uncharacterized LOC111111816,24636
NC_035788.1,68861194,68885837,68861194,68885837,111111816,XM_022448968.1,uncharacterized LOC111111816,24643
NC_035788.1,69105049,69125356,69105049,69125356,111111817,XM_022448971.1,uncharacterized LOC111111817,20307
NC_035788.1,68966793,68992595,68966794,68983158,111111818,XM_022448976.1,uncharacterized LOC111111818,16364
NC_035788.1,68966793,68992595,68966794,68989291,111111818,XM_022448973.1,uncharacterized LOC111111818,22497
NC_035788.1,68966793,68992595,68966793,68989293,111111818,XM_022448972.1,uncharacterized LOC111111818,22500
NC_035788.1,68966793,68992595,68966794,68992595,111111818,XM_022448975.1,uncharacterized LOC111111818,25801
NC_035788.1,68966793,68992595,68966793,68992595,111111818,XM_022448974.1,uncharacterized LOC111111818,25802
NC_035788.1,68956790,68959954,68956790,68959954,111111821,XM_022448982.1,uncharacterized LOC111111821,3164
NC_035788.1,68996528,68999797,68996528,68999797,111111822,XM_022448984.1,uncharacterized LOC111111822,3269
NC_035788.1,69096922,69100173,69096922,69100173,111111823,XM_022448986.1,uncharacterized LOC111111823,3251
NC_035788.1,69058738,69060489,69058738,69060489,111111825,XM_022448987.1,uncharacterized LOC111111825,1751
NC_035788.1,88424477,88431868,88424477,88431868,111111828,XM_022448990.1,uncharacterized LOC111111828,7391
NC_035788.1,22073737,22082289,22073737,22082289,111111830,XM_022448992.1,uncharacterized LOC111111830,8552
NC_035788.1,87938519,87976323,87938519,87976323,111111831,XM_022448993.1,uncharacterized LOC111111831,37804
NC_035780.1,53938737,53947910,53938737,53947910,111111833,XM_022449002.1,uncharacterized LOC111111833,9173
NC_035788.1,87829376,87832002,87829376,87832002,111111835,XM_022449001.1,uncharacterized LOC111111835,2626
NC_035788.1,87930057,87932259,87930057,87932259,111111839,XM_022449007.1,uncharacterized LOC111111839,2202
NC_035788.1,87979361,87984210,87979361,87984210,111111844,XM_022449013.1,uncharacterized LOC111111844,4849
NC_035788.1,87904157,87905571,87904157,87905571,111111847,XM_022449018.1,uncharacterized LOC111111847,1414
NC_035780.1,18297097,18303462,18297097,18303462,111111848,XM_022449050.1,uncharacterized LOC111111848,6365
NC_035788.1,87706303,87708570,87706303,87708570,111111852,XM_022449019.1,uncharacterized LOC111111852,2267
NC_035788.1,56636167,56647346,56636167,56647346,111111853,XM_022449020.1,uncharacterized LOC111111853,11179
NC_035788.1,31765618,31773929,31765618,31773929,111111857,XM_022449023.1,uncharacterized LOC111111857,8311
NC_035788.1,74583169,74599196,74583169,74599196,111111858,XM_022449024.1,uncharacterized LOC111111858,16027
NC_035788.1,65481755,65523724,65497588,65523724,111111860,XM_022449025.1,uncharacterized LOC111111860,26136
NC_035788.1,65481755,65523724,65481755,65523724,111111860,XM_022449027.1,uncharacterized LOC111111860,41969
NC_035788.1,73187234,73189393,73187234,73189393,111111865,XM_022449033.1,uncharacterized LOC111111865,2159
NC_035788.1,777109,780524,777109,780524,111111866,XM_022449034.1,uncharacterized LOC111111866,3415
NC_035788.1,73337718,73344496,73337718,73341580,111111867,XM_022449035.1,uncharacterized LOC111111867,3862
NC_035788.1,73337718,73344496,73337718,73344496,111111867,XM_022449036.1,uncharacterized LOC111111867,6778
NC_035788.1,72429850,72442678,72429850,72442678,111111868,XM_022449037.1,uncharacterized LOC111111868,12828
NC_035788.1,94642863,94650573,94642863,94650573,111111870,XM_022449039.1,uncharacterized LOC111111870,7710
NC_035788.1,86388472,86463148,86388472,86463147,111111872,XM_022449046.1,uncharacterized LOC111111872,74675
NC_035788.1,86388472,86463148,86388472,86463148,111111872,XM_022449047.1,uncharacterized LOC111111872,74676
NC_035788.1,85736807,85801210,85736807,85782936,111111873,XM_022449048.1,uncharacterized LOC111111873,46129
NC_035788.1,85736807,85801210,85736807,85801210,111111873,XM_022449051.1,uncharacterized LOC111111873,64403
NC_035788.1,86351829,86353877,86351829,86353877,111111875,XM_022449053.1,uncharacterized LOC111111875,2048
NC_035788.1,86078174,86081982,86078174,86081982,111111877,XM_022449058.1,uncharacterized LOC111111877,3808
NC_035788.1,86316412,86332690,86316412,86332690,111111882,XM_022449066.1,uncharacterized LOC111111882,16278
NC_035788.1,86316412,86332690,86325924,86332689,111111882,XM_022449067.1,uncharacterized LOC111111882,6765
NC_035788.1,85845386,85853409,85845386,85853409,111111887,XM_022449080.1,uncharacterized LOC111111887,8023
NC_035788.1,86334541,86339156,86334541,86339156,111111889,XM_022449083.1,uncharacterized LOC111111889,4615
NC_035788.1,86500151,86502382,86500151,86502382,111111892,XM_022449086.1,uncharacterized LOC111111892,2231
NC_035788.1,85883292,85885523,85883292,85885523,111111893,XM_022449087.1,uncharacterized LOC111111893,2231
NC_035788.1,17863375,17892204,17870294,17892204,111111906,XM_022449094.1,uncharacterized LOC111111906,21910
NC_035788.1,17863375,17892204,17867563,17892204,111111906,XM_022449093.1,uncharacterized LOC111111906,24641
NC_035788.1,17863375,17892204,17863375,17892204,111111906,XM_022449092.1,uncharacterized LOC111111906,28829
NC_035788.1,31532556,31535518,31532556,31535518,111111908,XM_022449097.1,uncharacterized LOC111111908,2962
NC_035788.1,852664,858986,852664,858986,111111909,XM_022449099.1,uncharacterized LOC111111909,6322
NC_035788.1,848693,850097,848693,850097,111111910,XM_022449100.1,uncharacterized LOC111111910,1404
NC_035788.1,98528366,98571562,98528369,98571562,111111912,XM_022449101.1,uncharacterized LOC111111912,43193
NC_035788.1,98528366,98571562,98528366,98571562,111111912,XM_022449102.1,uncharacterized LOC111111912,43196
NC_035788.1,541993,546222,541993,546222,111111917,XM_022449108.1,uncharacterized LOC111111917,4229
NC_035788.1,70586778,70604046,70592961,70604046,111111918,XM_022449109.1,uncharacterized LOC111111918,11085
NC_035788.1,70586778,70604046,70586778,70593691,111111918,XM_022449110.1,uncharacterized LOC111111918,6913
NC_035788.1,37749665,37760990,37749665,37760990,111111919,XM_022449112.1,uncharacterized LOC111111919,11325
NC_035788.1,37749665,37760990,37754836,37760990,111111919,XM_022449111.1,uncharacterized LOC111111919,6154
NC_035780.1,10814711,10827874,10814711,10827874,111111920,XM_022449123.1,uncharacterized LOC111111920,13163
NC_035788.1,51426958,51437529,51426958,51437529,111111922,XM_022449113.1,uncharacterized LOC111111922,10571
NC_035788.1,62594014,62605102,62594014,62605102,111111926,XM_022449117.1,uncharacterized LOC111111926,11088
NC_035788.1,22890207,22906333,22890207,22906333,111111928,XM_022449118.1,uncharacterized LOC111111928,16126
NC_035780.1,18584381,18591747,18584381,18591747,111111931,XM_022449168.1,uncharacterized LOC111111931,7366
NC_035788.1,66684880,66701310,66684880,66701310,111111936,XM_022449132.1,uncharacterized LOC111111936,16430
NC_035788.1,64837761,64844779,64837761,64844779,111111937,XM_022449133.1,uncharacterized LOC111111937,7018
NC_035788.1,43989348,43992535,43989348,43992535,111111938,XM_022449134.1,uncharacterized LOC111111938,3187
NC_035788.1,171916,185927,171916,185895,111111940,XM_022449135.1,uncharacterized LOC111111940,13979
NC_035788.1,171916,185927,171916,185927,111111940,XM_022449136.1,uncharacterized LOC111111940,14011
NC_035788.1,171916,185927,178443,185895,111111940,XM_022449137.1,uncharacterized LOC111111940,7452
NC_035788.1,31125215,31205925,31165812,31205925,111111943,XM_022449150.1,uncharacterized LOC111111943,40113
NC_035788.1,31125215,31205925,31161349,31205925,111111943,XM_022449151.1,uncharacterized LOC111111943,44576
NC_035788.1,31125215,31205925,31161319,31205925,111111943,XM_022449148.1,uncharacterized LOC111111943,44606
NC_035788.1,31125215,31205925,31156091,31205925,111111943,XM_022449153.1,uncharacterized LOC111111943,49834
NC_035788.1,31125215,31205925,31146167,31205925,111111943,XM_022449152.1,uncharacterized LOC111111943,59758
NC_035788.1,31125215,31205925,31143556,31205925,111111943,XM_022449154.1,uncharacterized LOC111111943,62369
NC_035788.1,31125215,31205925,31125215,31205925,111111943,XM_022449149.1,uncharacterized LOC111111943,80710
NC_035788.1,30974735,30982977,30974735,30982977,111111944,XM_022449156.1,uncharacterized LOC111111944,8242
NC_035788.1,30888414,30890464,30888414,30890464,111111958,XM_022449178.1,uncharacterized LOC111111958,2050
NC_035788.1,62399512,62406677,62399512,62406677,111111970,XM_022449186.1,uncharacterized LOC111111970,7165
NC_035780.1,52434298,52437121,52434298,52437121,111111973,XM_022449197.1,uncharacterized LOC111111973,2823
NC_035788.1,23776785,23797890,23787436,23797890,111111974,XM_022449195.1,uncharacterized LOC111111974,10454
NC_035788.1,23776785,23797890,23776785,23797890,111111974,XM_022449194.1,uncharacterized LOC111111974,21105
NC_035788.1,23776785,23797890,23792236,23797890,111111974,XM_022449196.1,uncharacterized LOC111111974,5654
NC_035788.1,42187346,42257598,42212131,42257598,111111975,XM_022449202.1,uncharacterized LOC111111975,45467
NC_035788.1,42187346,42257598,42187432,42257598,111111975,XM_022449200.1,uncharacterized LOC111111975,70166
NC_035788.1,42187346,42257598,42187346,42257598,111111975,XM_022449199.1,uncharacterized LOC111111975,70252
NC_035788.1,42282576,42314850,42290970,42314850,111111976,XM_022449204.1,uncharacterized LOC111111976,23880
NC_035788.1,42282576,42314850,42282576,42314850,111111976,XM_022449203.1,uncharacterized LOC111111976,32274
NC_035780.1,52406651,52409226,52406651,52409226,111111979,XM_022449210.1,uncharacterized LOC111111979,2575
NC_035788.1,42140373,42144822,42140373,42144822,111111982,XM_022449211.1,uncharacterized LOC111111982,4449
NC_035788.1,42128519,42129452,42128519,42129452,111111984,XM_022449214.1,uncharacterized LOC111111984,933
NC_035780.1,52431093,52433025,52432293,52433025,111111986,XM_022449217.1,uncharacterized LOC111111986,732
NC_035788.1,23840941,23849390,23840941,23849390,111111991,XM_022449220.1,uncharacterized LOC111111991,8449
NC_035788.1,69401774,69410972,69401775,69410972,111111992,XM_022449225.1,uncharacterized LOC111111992,9197
NC_035788.1,69401774,69410972,69401774,69410972,111111992,XM_022449226.1,uncharacterized LOC111111992,9198
NC_035788.1,31543594,31547899,31543594,31547899,111111993,XM_022449227.1,uncharacterized LOC111111993,4305
NC_035788.1,9337824,9341993,9337958,9341993,111111994,XM_022449228.1,uncharacterized LOC111111994,4035
NC_035788.1,9337824,9341993,9337827,9341993,111111994,XM_022449230.1,uncharacterized LOC111111994,4166
NC_035788.1,9337824,9341993,9337824,9341993,111111994,XM_022449229.1,uncharacterized LOC111111994,4169
NC_035788.1,58678202,58707963,58678202,58707963,111111997,XM_022449231.1,uncharacterized LOC111111997,29761
NC_035788.1,77910848,77920095,77910848,77920095,111111999,XM_022449236.1,uncharacterized LOC111111999,9247
NC_035788.1,101643453,101647307,101644567,101647307,111112001,XM_022449239.1,uncharacterized LOC111112001,2740
NC_035788.1,101643453,101647307,101643453,101647307,111112001,XM_022449238.1,uncharacterized LOC111112001,3854
NC_035788.1,15032366,15034081,15032366,15034081,111112002,XM_022449240.1,uncharacterized LOC111112002,1715
NC_035788.1,5067826,5079439,5067826,5079439,111112003,XM_022449241.1,uncharacterized LOC111112003,11613
NC_035780.1,18589066,18601611,18589066,18601611,111112004,XM_022449292.1,uncharacterized LOC111112004,12545
NC_035788.1,85207248,85210715,85207248,85210715,111112012,XM_022449287.1,uncharacterized LOC111112012,3467
NC_035780.1,14404759,14409209,14404759,14409209,111112015,XM_022449301.1,uncharacterized LOC111112015,4450
NC_035788.1,85157076,85168267,85157076,85168267,111112017,XM_022449300.1,uncharacterized LOC111112017,11191
NC_035788.1,85128748,85132476,85128748,85132476,111112018,XM_022449302.1,uncharacterized LOC111112018,3728
NC_035788.1,85103667,85109959,85103667,85109959,111112019,XM_022449303.1,uncharacterized LOC111112019,6292
NC_035788.1,84938710,84939800,84938710,84939800,111112020,XM_022449304.1,uncharacterized LOC111112020,1090
NC_035788.1,84963247,84964570,84963247,84964554,111112022,XM_022449306.1,uncharacterized LOC111112022,1307
NC_035788.1,84963247,84964570,84963247,84964570,111112022,XM_022449307.1,uncharacterized LOC111112022,1323
NC_035788.1,32168030,32172815,32168030,32172815,111112026,XM_022449309.1,uncharacterized LOC111112026,4785
NC_035788.1,97391736,97393806,97391736,97393806,111112027,XM_022449311.1,uncharacterized LOC111112027,2070
NC_035788.1,4976110,4981612,4977834,4981612,111112034,XM_022449328.1,uncharacterized LOC111112034,3778
NC_035788.1,4976110,4981612,4976110,4981612,111112034,XM_022449329.1,uncharacterized LOC111112034,5502
NC_035788.1,82010613,82026158,82010613,82026135,111112036,XM_022449332.1,uncharacterized LOC111112036,15522
NC_035788.1,82010613,82026158,82023881,82026158,111112036,XM_022449331.1,uncharacterized LOC111112036,2277
NC_035788.1,82069657,82083381,82069657,82083326,111112037,XM_022449335.1,uncharacterized LOC111112037,13669
NC_035788.1,82069657,82083381,82069657,82071897,111112037,XM_022449334.1,uncharacterized LOC111112037,2240
NC_035788.1,82069657,82083381,82081007,82083381,111112037,XM_022449336.1,uncharacterized LOC111112037,2374
NC_035788.1,82113756,82136791,82113756,82136791,111112038,XM_022449337.1,uncharacterized LOC111112038,23035
NC_035788.1,81985285,82012876,81985285,81987505,111112040,XM_022449340.1,uncharacterized LOC111112040,2220
NC_035788.1,81985285,82012876,81985285,82012876,111112040,XM_022449339.1,uncharacterized LOC111112040,27591
NC_035788.1,82237317,82251490,82237317,82251490,111112043,XM_022449342.1,uncharacterized LOC111112043,14173
NC_035788.1,82134505,82136087,82134505,82136087,111112046,XM_022449346.1,uncharacterized LOC111112046,1582
NC_035788.1,82312277,82320658,82312277,82320658,111112047,XM_022449347.1,uncharacterized LOC111112047,8381
NC_035788.1,81955599,81962301,81955599,81962301,111112049,XM_022449349.1,uncharacterized LOC111112049,6702
NC_035788.1,73206952,73210083,73206952,73210083,111112057,XM_022449353.1,uncharacterized LOC111112057,3131
NC_035788.1,66265226,66269090,66265226,66269090,111112058,XM_022449354.1,uncharacterized LOC111112058,3864
NC_035780.1,18752909,18757287,18752909,18757287,111112067,XM_022449405.1,uncharacterized LOC111112067,4378
NC_035788.1,1017876,1023128,1017876,1023128,111112071,XM_022449370.1,uncharacterized LOC111112071,5252
NC_035788.1,1701885,1718273,1701885,1718273,111112075,XM_022449374.1,uncharacterized LOC111112075,16388
NC_035788.1,103670161,103727433,103670161,103727433,111112077,XM_022449376.1,uncharacterized LOC111112077,57272
NC_035788.1,6560842,6562532,6560842,6562532,111112081,XM_022449387.1,uncharacterized LOC111112081,1690
NC_035788.1,56657357,56671530,56657357,56671530,111112083,XM_022449388.1,uncharacterized LOC111112083,14173
NC_035788.1,22104884,22117198,22104884,22117198,111112085,XM_022449390.1,uncharacterized LOC111112085,12314
NC_035788.1,68257734,68284520,68273561,68284520,111112086,XM_022449393.1,uncharacterized LOC111112086,10959
NC_035788.1,68257734,68284520,68257776,68284520,111112086,XM_022449394.1,uncharacterized LOC111112086,26744
NC_035788.1,68257734,68284520,68257734,68267173,111112086,XM_022449392.1,uncharacterized LOC111112086,9439
NC_035788.1,53275809,53312796,53275809,53312271,111112093,XM_022449401.1,uncharacterized LOC111112093,36462
NC_035788.1,53275809,53312796,53275809,53312796,111112093,XM_022449402.1,uncharacterized LOC111112093,36987
NC_035788.1,74623204,74626295,74623204,74626294,111112098,XM_022449406.1,uncharacterized LOC111112098,3090
NC_035788.1,74623204,74626295,74623204,74626295,111112098,XM_022449407.1,uncharacterized LOC111112098,3091
NC_035788.1,103334203,103352365,103334203,103352365,111112103,XM_022449429.1,uncharacterized LOC111112103,18162
NC_035788.1,55040190,55065498,55040190,55065498,111112106,XM_022449431.1,uncharacterized LOC111112106,25308
NC_035788.1,8255490,8256098,8255490,8256098,111112107,XM_022449432.1,uncharacterized LOC111112107,608
NC_035788.1,56413347,56425246,56413347,56425246,111112108,XM_022449435.1,uncharacterized LOC111112108,11899
NC_035788.1,56413347,56425246,56422361,56425246,111112108,XM_022449434.1,uncharacterized LOC111112108,2885
NC_035788.1,56538500,56542203,56538500,56542203,111112110,XM_022449436.1,uncharacterized LOC111112110,3703
NC_035788.1,56368087,56385778,56368087,56385778,111112111,XM_022449437.1,uncharacterized LOC111112111,17691
NC_035788.1,56320358,56324506,56320358,56324506,111112112,XM_022449438.1,uncharacterized LOC111112112,4148
NC_035780.1,28193618,28200012,28193618,28200012,111112115,XM_022449445.1,uncharacterized LOC111112115,6394
NC_035788.1,56486991,56493684,56486991,56491091,111112116,XM_022449448.1,uncharacterized LOC111112116,4100
NC_035788.1,56486991,56493684,56486991,56493684,111112116,XM_022449449.1,uncharacterized LOC111112116,6693
NC_035780.1,27697482,27698925,27697482,27698925,111112127,XM_022449470.1,uncharacterized LOC111112127,1443
NC_035788.1,93366933,93367835,93366933,93367835,111112128,XM_022449471.1,uncharacterized LOC111112128,902
NC_035780.1,18654804,18659409,18654804,18659409,111112134,XM_022449531.1,uncharacterized LOC111112134,4605
NC_035788.1,101512312,101513864,101512312,101513864,111112152,XM_022449519.1,uncharacterized LOC111112152,1552
NC_035788.1,100798552,100802968,100798552,100802968,111112169,XM_022449545.1,uncharacterized LOC111112169,4416
NC_035788.1,100763728,100776180,100763728,100776180,111112171,XM_022449549.1,uncharacterized LOC111112171,12452
NC_035788.1,100539980,100549268,100539980,100549268,111112172,XM_022449553.1,uncharacterized LOC111112172,9288
NC_035788.1,100585417,100608843,100590851,100608843,111112173,XM_022449561.1,uncharacterized LOC111112173,17992
NC_035788.1,100585417,100608843,100585959,100608840,111112173,XM_022449557.1,uncharacterized LOC111112173,22881
NC_035788.1,100585417,100608843,100585421,100608839,111112173,XM_022449555.1,uncharacterized LOC111112173,23418
NC_035788.1,100585417,100608843,100585420,100608840,111112173,XM_022449554.1,uncharacterized LOC111112173,23420
NC_035788.1,100585417,100608843,100585418,100608841,111112173,XM_022449560.1,uncharacterized LOC111112173,23423
NC_035788.1,100585417,100608843,100585417,100595007,111112173,XM_022449559.1,uncharacterized LOC111112173,9590
NC_035788.1,100779975,100822400,100779975,100822400,111112177,XM_022449569.1,uncharacterized LOC111112177,42425
NC_035788.1,100968306,101001945,100982698,101001945,111112178,XM_022449571.1,uncharacterized LOC111112178,19247
NC_035788.1,100968306,101001945,100968306,101001945,111112178,XM_022449570.1,uncharacterized LOC111112178,33639
NC_035788.1,100341096,100365894,100341096,100365894,111112179,XM_022449572.1,uncharacterized LOC111112179,24798
NC_035788.1,100614905,100622114,100614905,100622108,111112182,XM_022449576.1,uncharacterized LOC111112182,7203
NC_035788.1,100686645,100689428,100686645,100689428,111112187,XM_022449583.1,uncharacterized LOC111112187,2783
NC_035788.1,100465489,100468097,100465489,100468097,111112188,XM_022449584.1,uncharacterized LOC111112188,2608
NC_035788.1,100812915,100814626,100812915,100814626,111112189,XM_022449585.1,uncharacterized LOC111112189,1711
NC_035788.1,4160670,4194336,4160682,4194336,111112198,XM_022449589.1,uncharacterized LOC111112198,33654
NC_035788.1,4160670,4194336,4160670,4194336,111112198,XM_022449590.1,uncharacterized LOC111112198,33666
NC_035788.1,16519960,16535574,16521479,16535574,111112202,XM_022449597.1,uncharacterized LOC111112202,14095
NC_035788.1,16519960,16535574,16520262,16535574,111112202,XM_022449598.1,uncharacterized LOC111112202,15312
NC_035788.1,16519960,16535574,16520096,16535574,111112202,XM_022449599.1,uncharacterized LOC111112202,15478
NC_035788.1,16519960,16535574,16519960,16535574,111112202,XM_022449596.1,uncharacterized LOC111112202,15614
NC_035788.1,16549419,16552969,16549419,16552969,111112203,XM_022449600.1,uncharacterized LOC111112203,3550
NC_035780.1,58865205,58870348,58865223,58868353,111112204,XM_022449638.1,uncharacterized LOC111112204,3130
NC_035780.1,58865205,58870348,58865226,58869155,111112204,XM_022449631.1,uncharacterized LOC111112204,3929
NC_035780.1,58865205,58870348,58865208,58870327,111112204,XM_022449622.1,uncharacterized LOC111112204,5119
NC_035780.1,58865205,58870348,58865205,58870342,111112204,XM_022449613.1,uncharacterized LOC111112204,5137
NC_035780.1,58865205,58870348,58865205,58870348,111112204,XM_022449605.1,uncharacterized LOC111112204,5143
NC_035788.1,16511641,16515884,16511641,16515884,111112205,XM_022449601.1,uncharacterized LOC111112205,4243
NC_035788.1,68801021,68841966,68809479,68841966,111112206,XM_022449602.1,uncharacterized LOC111112206,32487
NC_035788.1,68801021,68841966,68804115,68841966,111112206,XM_022449603.1,uncharacterized LOC111112206,37851
NC_035788.1,68801021,68841966,68801021,68841966,111112206,XM_022449604.1,uncharacterized LOC111112206,40945
NC_035788.1,9396413,9398375,9396536,9398375,111112208,XM_022449607.1,uncharacterized LOC111112208,1839
NC_035788.1,9396413,9398375,9396413,9398375,111112208,XM_022449606.1,uncharacterized LOC111112208,1962
NC_035788.1,2330045,2333251,2330045,2333251,111112209,XM_022449608.1,uncharacterized LOC111112209,3206
NC_035788.1,81320833,81324761,81320833,81324761,111112212,XM_022449614.1,uncharacterized LOC111112212,3928
NC_035788.1,81304148,81306480,81304148,81306480,111112213,XM_022449615.1,uncharacterized LOC111112213,2332
NC_035788.1,81509120,81513718,81509232,81513718,111112214,XM_022449616.1,uncharacterized LOC111112214,4486
NC_035788.1,81509120,81513718,81509229,81513718,111112214,XM_022449618.1,uncharacterized LOC111112214,4489
NC_035788.1,81509120,81513718,81509130,81513718,111112214,XM_022449619.1,uncharacterized LOC111112214,4588
NC_035788.1,81509120,81513718,81509120,81513718,111112214,XM_022449620.1,uncharacterized LOC111112214,4598
NC_035788.1,81462277,81463663,81462277,81463601,111112217,XM_022449628.1,uncharacterized LOC111112217,1324
NC_035788.1,81462277,81463663,81462277,81463663,111112217,XM_022449627.1,uncharacterized LOC111112217,1386
NC_035788.1,81399868,81401687,81399868,81401681,111112222,XM_022449636.1,uncharacterized LOC111112222,1813
NC_035788.1,21795522,21815393,21798513,21815393,111112227,XM_022449641.1,uncharacterized LOC111112227,16880
NC_035788.1,21795522,21815393,21795522,21815393,111112227,XM_022449643.1,uncharacterized LOC111112227,19871
NC_035788.1,21795522,21815393,21806918,21815393,111112227,XM_022449642.1,uncharacterized LOC111112227,8475
NC_035788.1,9895319,9901484,9895319,9901484,111112232,XM_022449646.1,uncharacterized LOC111112232,6165
NC_035788.1,87137367,87153982,87137367,87153972,111112238,XM_022449652.1,uncharacterized LOC111112238,16605
NC_035788.1,87137367,87153982,87151158,87153982,111112238,XM_022449651.1,uncharacterized LOC111112238,2824
NC_035788.1,27263704,27273631,27263704,27273631,111112252,XM_022449660.1,uncharacterized LOC111112252,9927
NC_035788.1,27222220,27232090,27222220,27232090,111112254,XM_022449661.1,uncharacterized LOC111112254,9870
NC_035788.1,44600052,44608433,44600052,44608433,111112261,XM_022449674.1,uncharacterized LOC111112261,8381
NC_035788.1,44712262,44729241,44712262,44729241,111112263,XM_022449677.1,uncharacterized LOC111112263,16979
NC_035788.1,44645365,44650075,44645365,44650075,111112265,XM_022449679.1,uncharacterized LOC111112265,4710
NC_035788.1,39688817,39696307,39688817,39696307,111112268,XM_022449685.1,uncharacterized LOC111112268,7490
NC_035788.1,39583099,39591700,39584804,39591700,111112269,XM_022449686.1,uncharacterized LOC111112269,6896
NC_035788.1,39680800,39683872,39680800,39683872,111112275,XM_022449692.1,uncharacterized LOC111112275,3072
NC_035788.1,39737062,39738832,39737062,39738832,111112281,XM_022449695.1,uncharacterized LOC111112281,1770
NC_035788.1,39557670,39560058,39557670,39560058,111112282,XM_022449696.1,uncharacterized LOC111112282,2388
NC_035788.1,39940762,39946095,39940762,39946095,111112289,XM_022449699.1,uncharacterized LOC111112289,5333
NC_035788.1,74767296,74802461,74776921,74802461,111112301,XM_022449717.1,uncharacterized LOC111112301,25540
NC_035788.1,74767296,74802461,74776920,74802461,111112301,XM_022449716.1,uncharacterized LOC111112301,25541
NC_035788.1,74767296,74802461,74774243,74802461,111112301,XM_022449725.1,uncharacterized LOC111112301,28218
NC_035788.1,74767296,74802461,74772131,74802461,111112301,XM_022449719.1,uncharacterized LOC111112301,30330
NC_035788.1,74767296,74802461,74767296,74802461,111112301,XM_022449724.1,uncharacterized LOC111112301,35165
NC_035780.1,35475367,35477560,35475367,35477560,111112305,XM_022449734.1,uncharacterized LOC111112305,2193
NC_035780.1,37076247,37078359,37076247,37078359,111112308,XM_022449749.1,uncharacterized LOC111112308,2112
NC_035780.1,37251755,37252914,37251755,37252906,111112317,XM_022449760.1,uncharacterized LOC111112317,1151
NC_035780.1,37251755,37252914,37251755,37252914,111112317,XM_022449767.1,uncharacterized LOC111112317,1159
NC_035788.1,163178,168143,163178,168143,111112321,XM_022449761.1,uncharacterized LOC111112321,4965
NC_035788.1,444620,452395,444620,452395,111112322,XM_022449762.1,uncharacterized LOC111112322,7775
NC_035788.1,464272,465836,464272,465836,111112323,XM_022449763.1,uncharacterized LOC111112323,1564
NC_035788.1,860670,882336,860670,882336,111112324,XM_022449764.1,uncharacterized LOC111112324,21666
NC_035788.1,1214132,1214713,1214132,1214713,111112327,XM_022449768.1,uncharacterized LOC111112327,581
NC_035788.1,1907220,1909319,1907220,1909319,111112335,XM_022449778.1,uncharacterized LOC111112335,2099
NC_035788.1,2157495,2162204,2157495,2162204,111112344,XM_022449786.1,uncharacterized LOC111112344,4709
NC_035788.1,2346977,2349747,2346977,2349747,111112346,XM_022449788.1,uncharacterized LOC111112346,2770
NC_035788.1,2398646,2403424,2398646,2403424,111112347,XM_022449789.1,uncharacterized LOC111112347,4778
NC_035780.1,47314671,47317729,47314671,47317729,111112349,XM_022449796.1,uncharacterized LOC111112349,3058
NC_035788.1,2646370,2649838,2646370,2649838,111112351,XM_022449798.1,uncharacterized LOC111112351,3468
NC_035788.1,2763724,2773416,2763724,2773416,111112353,XM_022449805.1,uncharacterized LOC111112353,9692
NC_035780.1,31845467,31846666,31845467,31846666,111112354,XM_022449809.1,uncharacterized LOC111112354,1199
NC_035788.1,2917455,2919379,2917455,2919379,111112356,XM_022449807.1,uncharacterized LOC111112356,1924
NC_035788.1,3044037,3053115,3044037,3053115,111112359,XM_022449812.1,uncharacterized LOC111112359,9078
NC_035788.1,3067470,3069195,3067470,3069195,111112360,XM_022449813.1,uncharacterized LOC111112360,1725
NC_035788.1,3162928,3206266,3162928,3206266,111112361,XM_022449814.1,uncharacterized LOC111112361,43338
NC_035788.1,3213773,3270906,3213773,3270906,111112362,XM_022449815.1,uncharacterized LOC111112362,57133
NC_035788.1,14465405,14495233,14465405,14495233,111112363,XM_022449816.1,uncharacterized LOC111112363,29828
NC_035788.1,14104270,14105804,14104270,14105804,111112383,XM_022449851.1,uncharacterized LOC111112383,1534
NC_035788.1,13889757,13894746,13889757,13894746,111112385,XM_022449853.1,uncharacterized LOC111112385,4989
NC_035788.1,3326177,3332751,3326177,3332751,111112393,XM_022449857.1,uncharacterized LOC111112393,6574
NC_035788.1,3332353,3343229,3332353,3343229,111112394,XM_022449858.1,uncharacterized LOC111112394,10876
NC_035788.1,3349089,3363495,3349089,3363495,111112395,XM_022449859.1,uncharacterized LOC111112395,14406
NC_035788.1,60832119,60835237,60832337,60835237,111112403,XM_022449882.1,uncharacterized LOC111112403,2900
NC_035788.1,60832119,60835237,60832119,60835237,111112403,XM_022449881.1,uncharacterized LOC111112403,3118
NC_035788.1,60764245,60766856,60764245,60766856,111112405,XM_022449883.1,uncharacterized LOC111112405,2611
NC_035788.1,60866257,60869106,60866257,60869106,111112406,XM_022449884.1,uncharacterized LOC111112406,2849
NC_035788.1,60967080,60992657,60967080,60992657,111112407,XM_022449886.1,uncharacterized LOC111112407,25577
NC_035788.1,60727958,60732879,60727958,60731458,111112408,XM_022449887.1,uncharacterized LOC111112408,3500
NC_035788.1,60744966,60750108,60744966,60750108,111112409,XM_022449888.1,uncharacterized LOC111112409,5142
NC_035788.1,60848999,60853222,60848999,60853222,111112410,XM_022449889.1,uncharacterized LOC111112410,4223
NC_035788.1,61023433,61025465,61023433,61025465,111112416,XM_022449898.1,uncharacterized LOC111112416,2032
NC_035788.1,60790611,60793535,60790611,60793535,111112417,XM_022449899.1,uncharacterized LOC111112417,2924
NC_035780.1,29710853,29714627,29710853,29713007,111112419,XM_022449904.1,uncharacterized LOC111112419,2154
NC_035780.1,29710853,29714627,29710853,29714627,111112419,XM_022449911.1,uncharacterized LOC111112419,3774
NC_035788.1,60818403,60823178,60818403,60823178,111112421,XM_022449902.1,uncharacterized LOC111112421,4775
NC_035788.1,3587604,3594540,3587604,3594540,111112423,XM_022449903.1,uncharacterized LOC111112423,6936
NC_035788.1,3601779,3616936,3601779,3616936,111112424,XM_022449905.1,uncharacterized LOC111112424,15157
NC_035788.1,24358030,24369890,24358030,24369818,111112425,XM_022449906.1,uncharacterized LOC111112425,11788
NC_035788.1,3710917,3713359,3710917,3713359,111112426,XM_022449907.1,uncharacterized LOC111112426,2442
NC_035788.1,3741619,3743836,3741619,3743836,111112427,XM_022449908.1,uncharacterized LOC111112427,2217
NC_035788.1,3871478,3873068,3871478,3873068,111112429,XM_022449910.1,uncharacterized LOC111112429,1590
NC_035788.1,3941479,3942390,3941479,3942390,111112432,XM_022449913.1,uncharacterized LOC111112432,911
NC_035788.1,47735376,47786354,47735376,47760977,111112433,XM_022449914.1,uncharacterized LOC111112433,25601
NC_035788.1,47735376,47786354,47735376,47766865,111112433,XM_022449918.1,uncharacterized LOC111112433,31489
NC_035788.1,47735376,47786354,47735376,47771009,111112433,XM_022449921.1,uncharacterized LOC111112433,35633
NC_035788.1,47735376,47786354,47735376,47783954,111112433,XM_022449919.1,uncharacterized LOC111112433,48578
NC_035788.1,47735376,47786354,47735376,47784028,111112433,XM_022449920.1,uncharacterized LOC111112433,48652
NC_035788.1,47735376,47786354,47735376,47786354,111112433,XM_022449917.1,uncharacterized LOC111112433,50978
NC_035788.1,3965612,3966678,3965612,3966678,111112436,XM_022449923.1,uncharacterized LOC111112436,1066
NC_035788.1,23403483,23421929,23410120,23421929,111112440,XM_022449929.1,uncharacterized LOC111112440,11809
NC_035788.1,23403483,23421929,23403485,23421929,111112440,XM_022449930.1,uncharacterized LOC111112440,18444
NC_035788.1,23403483,23421929,23403483,23421929,111112440,XM_022449928.1,uncharacterized LOC111112440,18446
NC_035788.1,23141315,23160506,23147926,23160503,111112441,XM_022449935.1,uncharacterized LOC111112441,12577
NC_035788.1,23141315,23160506,23141315,23159039,111112441,XM_022449933.1,uncharacterized LOC111112441,17724
NC_035788.1,23141315,23160506,23141315,23160505,111112441,XM_022449932.1,uncharacterized LOC111112441,19190
NC_035788.1,23141315,23160506,23141315,23160506,111112441,XM_022449931.1,uncharacterized LOC111112441,19191
NC_035780.1,48456161,48460698,48456161,48460698,111112442,XM_022449937.1,uncharacterized LOC111112442,4537
NC_035788.1,22989800,23450440,22989800,23450440,111112443,XM_022449936.1,uncharacterized LOC111112443,460640
NC_035788.1,23654818,23667040,23654818,23667040,111112444,XM_022449938.1,uncharacterized LOC111112444,12222
NC_035788.1,23598087,23635627,23598087,23635627,111112445,XM_022449939.1,uncharacterized LOC111112445,37540
NC_035788.1,23005414,23043027,23017733,23043027,111112446,XM_022449940.1,uncharacterized LOC111112446,25294
NC_035788.1,23005414,23043027,23005414,23043027,111112446,XM_022449942.1,uncharacterized LOC111112446,37613
NC_035788.1,23126773,23133036,23126773,23132537,111112447,XM_022449945.1,uncharacterized LOC111112447,5764
NC_035788.1,23126773,23133036,23126773,23133036,111112447,XM_022449944.1,uncharacterized LOC111112447,6263
NC_035780.1,3473206,3486317,3473206,3486317,111112448,XM_022449969.1,uncharacterized LOC111112448,13111
NC_035780.1,3473206,3486317,3473206,3481887,111112448,XM_022449951.1,uncharacterized LOC111112448,8681
NC_035780.1,3473206,3486317,3473206,3481888,111112448,XM_022449961.1,uncharacterized LOC111112448,8682
NC_035788.1,23047832,23051522,23047832,23051522,111112449,XM_022449947.1,uncharacterized LOC111112449,3690
NC_035788.1,23359155,23371041,23359155,23371041,111112450,XM_022449948.1,uncharacterized LOC111112450,11886
NC_035788.1,23375922,23433783,23375922,23433783,111112451,XM_022449953.1,uncharacterized LOC111112451,57861
NC_035788.1,23375922,23433783,23375922,23383715,111112451,XM_022449954.1,uncharacterized LOC111112451,7793
NC_035788.1,23552410,23567063,23552416,23564636,111112452,XM_022449960.1,uncharacterized LOC111112452,12220
NC_035788.1,23552410,23567063,23552414,23564638,111112452,XM_022449956.1,uncharacterized LOC111112452,12224
NC_035788.1,23552410,23567063,23552410,23564642,111112452,XM_022449962.1,uncharacterized LOC111112452,12232
NC_035788.1,23552410,23567063,23552414,23567063,111112452,XM_022449959.1,uncharacterized LOC111112452,14649
NC_035788.1,23113686,23119202,23113686,23119202,111112453,XM_022449963.1,uncharacterized LOC111112453,5516
NC_035788.1,23578267,23585215,23578352,23585215,111112455,XM_022449966.1,uncharacterized LOC111112455,6863
NC_035788.1,23319944,23340029,23319944,23340029,111112456,XM_022449967.1,uncharacterized LOC111112456,20085
NC_035788.1,23500773,23502791,23500773,23502791,111112457,XM_022449968.1,uncharacterized LOC111112457,2018
NC_035788.1,23289683,23293043,23289683,23293043,111112458,XM_022449970.1,uncharacterized LOC111112458,3360
NC_035788.1,23462630,23464308,23462630,23464308,111112459,XM_022449971.1,uncharacterized LOC111112459,1678
NC_035788.1,4325413,4334699,4325413,4334699,111112464,XM_022449972.1,uncharacterized LOC111112464,9286
NC_035788.1,4516648,4517834,4516648,4517834,111112467,XM_022449974.1,uncharacterized LOC111112467,1186
NC_035788.1,4739675,4740928,4739675,4740928,111112469,XM_022449976.1,uncharacterized LOC111112469,1253
NC_035788.1,4741853,4742893,4741853,4742893,111112471,XM_022449978.1,uncharacterized LOC111112471,1040
NC_035788.1,4845636,4851795,4845636,4851795,111112473,XM_022449980.1,uncharacterized LOC111112473,6159
NC_035788.1,5027540,5028777,5027540,5028777,111112475,XM_022449982.1,uncharacterized LOC111112475,1237
NC_035788.1,5134437,5135507,5134437,5135507,111112481,XM_022449992.1,uncharacterized LOC111112481,1070
NC_035788.1,5303371,5304750,5303371,5304750,111112483,XM_022449994.1,uncharacterized LOC111112483,1379
NC_035788.1,5587517,5589143,5587517,5589143,111112485,XM_022449996.1,uncharacterized LOC111112485,1626
NC_035788.1,5727309,5729401,5727309,5729401,111112486,XM_022449997.1,uncharacterized LOC111112486,2092
NC_035788.1,3231681,3250380,3231681,3250380,111112491,XM_022450011.1,uncharacterized LOC111112491,18699
NC_035788.1,3225809,3226478,3225809,3226478,111112492,XM_022450012.1,uncharacterized LOC111112492,669
NC_035788.1,5855337,5862770,5855337,5862770,111112497,XM_022450013.1,uncharacterized LOC111112497,7433
NC_035788.1,41526994,41531957,41526994,41531905,111112499,XM_022450017.1,uncharacterized LOC111112499,4911
NC_035788.1,41526994,41531957,41526994,41531957,111112499,XM_022450016.1,uncharacterized LOC111112499,4963
NC_035788.1,41329450,41344251,41333607,41344251,111112500,XM_022450018.1,uncharacterized LOC111112500,10644
NC_035788.1,41329450,41344251,41329450,41344251,111112500,XM_022450019.1,uncharacterized LOC111112500,14801
NC_035788.1,41329450,41344251,41335414,41344251,111112500,XM_022450020.1,uncharacterized LOC111112500,8837
NC_035788.1,41379549,41406183,41379549,41400357,111112504,XM_022450024.1,uncharacterized LOC111112504,20808
NC_035788.1,41344338,41346444,41344338,41346444,111112505,XM_022450025.1,uncharacterized LOC111112505,2106
NC_035788.1,41842533,41852337,41842533,41852337,111112507,XM_022450029.1,uncharacterized LOC111112507,9804
NC_035780.1,23783926,23785722,23783926,23785722,111112511,XM_022450039.1,uncharacterized LOC111112511,1796
NC_035788.1,41792130,41799322,41792130,41799322,111112512,XM_022450040.1,uncharacterized LOC111112512,7192
NC_035788.1,41542063,41545413,41542063,41545413,111112516,XM_022450047.1,uncharacterized LOC111112516,3350
NC_035780.1,20807004,20817614,20807006,20817589,111112517,XM_022450051.1,uncharacterized LOC111112517,10583
NC_035780.1,20807004,20817614,20807004,20817614,111112517,XM_022450056.1,uncharacterized LOC111112517,10610
NC_035788.1,41414072,41424668,41414072,41424668,111112518,XM_022450048.1,uncharacterized LOC111112518,10596
NC_035788.1,41373694,41376372,41373694,41376372,111112519,XM_022450049.1,uncharacterized LOC111112519,2678
NC_035788.1,6230512,6237305,6230512,6237305,111112528,XM_022450057.1,uncharacterized LOC111112528,6793
NC_035788.1,6363130,6364416,6363130,6364416,111112529,XM_022450058.1,uncharacterized LOC111112529,1286
NC_035788.1,19338559,19439688,19338559,19439688,111112532,XM_022450060.1,uncharacterized LOC111112532,101129
NC_035788.1,6562475,6563947,6562475,6563947,111112534,XM_022450061.1,uncharacterized LOC111112534,1472
NC_035788.1,8031380,8033572,8031380,8033572,111112553,XM_022450079.1,uncharacterized LOC111112553,2192
NC_035788.1,8144119,8145726,8144119,8145726,111112556,XM_022450082.1,uncharacterized LOC111112556,1607
NC_035788.1,8172023,8176592,8172023,8176592,111112563,XM_022450093.1,uncharacterized LOC111112563,4569
NC_035788.1,8178082,8179739,8178082,8179739,111112564,XM_022450094.1,uncharacterized LOC111112564,1657
NC_035788.1,83765454,83767312,83765454,83767312,111112566,XM_022450098.1,uncharacterized LOC111112566,1858
NC_035788.1,83729433,83779017,83729433,83731738,111112568,XM_022450099.1,uncharacterized LOC111112568,2305
NC_035788.1,83729433,83779017,83729433,83779017,111112568,XM_022450100.1,uncharacterized LOC111112568,49584
NC_035788.1,83813953,83816267,83813953,83816267,111112569,XM_022450101.1,uncharacterized LOC111112569,2314
NC_035788.1,83658114,83663327,83658114,83663327,111112574,XM_022450108.1,uncharacterized LOC111112574,5213
NC_035788.1,83678415,83692654,83678415,83692654,111112576,XM_022450113.1,uncharacterized LOC111112576,14239
NC_035788.1,8333939,8340252,8333939,8340252,111112579,XM_022450115.1,uncharacterized LOC111112579,6313
NC_035780.1,54535316,54541222,54535316,54541222,111112582,XM_022450121.1,uncharacterized LOC111112582,5906
NC_035780.1,64043471,64046257,64043471,64046257,111112586,XM_022450137.1,uncharacterized LOC111112586,2786
NC_035780.1,38461037,38463792,38461037,38463792,111112594,XM_022450166.1,uncharacterized LOC111112594,2755
NC_035788.1,8425282,8429352,8425282,8429352,111112598,XM_022450169.1,uncharacterized LOC111112598,4070
NC_035788.1,67775101,67792158,67775101,67792137,111112599,XM_022450170.1,uncharacterized LOC111112599,17036
NC_035788.1,67775101,67792158,67775101,67792158,111112599,XM_022450172.1,uncharacterized LOC111112599,17057
NC_035788.1,8522905,8526003,8522905,8526003,111112600,XM_022450173.1,uncharacterized LOC111112600,3098
NC_035788.1,81169099,81205252,81182623,81205252,111112603,XM_022450175.1,uncharacterized LOC111112603,22629
NC_035788.1,81169099,81205252,81169152,81205252,111112603,XM_022450177.1,uncharacterized LOC111112603,36100
NC_035788.1,81169099,81205252,81169120,81205252,111112603,XM_022450176.1,uncharacterized LOC111112603,36132
NC_035788.1,81169099,81205252,81169118,81205252,111112603,XM_022450174.1,uncharacterized LOC111112603,36134
NC_035788.1,81215927,81217053,81215927,81217053,111112604,XM_022450179.1,uncharacterized LOC111112604,1126
NC_035780.1,23274050,23282726,23274050,23282726,111112607,XM_022450208.1,uncharacterized LOC111112607,8676
NC_035788.1,8530640,8531782,8530640,8531782,111112610,XM_022450209.1,uncharacterized LOC111112610,1142
NC_035788.1,8531659,8533639,8531659,8533639,111112611,XM_022450210.1,uncharacterized LOC111112611,1980
NC_035788.1,51001556,51074500,51062737,51074499,111112612,XM_022450221.1,uncharacterized LOC111112612,11762
NC_035788.1,51001556,51074500,51062346,51074499,111112612,XM_022450220.1,uncharacterized LOC111112612,12153
NC_035788.1,51001556,51074500,51026318,51074499,111112612,XM_022450219.1,uncharacterized LOC111112612,48181
NC_035788.1,51001556,51074500,51023624,51074500,111112612,XM_022450215.1,uncharacterized LOC111112612,50876
NC_035788.1,51001556,51074500,51021398,51074499,111112612,XM_022450218.1,uncharacterized LOC111112612,53101
NC_035788.1,51001556,51074500,51021381,51074499,111112612,XM_022450217.1,uncharacterized LOC111112612,53118
NC_035788.1,51001556,51074500,51008379,51074500,111112612,XM_022450214.1,uncharacterized LOC111112612,66121
NC_035788.1,51001556,51074500,51001579,51074500,111112612,XM_022450213.1,uncharacterized LOC111112612,72921
NC_035788.1,51001556,51074500,51001556,51074500,111112612,XM_022450211.1,uncharacterized LOC111112612,72944
NC_035788.1,51115456,51177259,51155224,51177259,111112614,XM_022450228.1,uncharacterized LOC111112614,22035
NC_035788.1,51115456,51177259,51115456,51177259,111112614,XM_022450224.1,uncharacterized LOC111112614,61803
NC_035788.1,50919430,50975071,50919430,50961230,111112615,XM_022450231.1,uncharacterized LOC111112615,41800
NC_035788.1,50919430,50975071,50919430,50975071,111112615,XM_022450230.1,uncharacterized LOC111112615,55641
NC_035788.1,51210528,51257057,51210528,51257056,111112616,XM_022450234.1,uncharacterized LOC111112616,46528
NC_035788.1,51210528,51257057,51210528,51257057,111112616,XM_022450233.1,uncharacterized LOC111112616,46529
NC_035788.1,51039779,51043161,51039779,51043161,111112617,XM_022450238.1,uncharacterized LOC111112617,3382
NC_035788.1,51053481,51057759,51054857,51057759,111112619,XM_022450240.1,uncharacterized LOC111112619,2902
NC_035788.1,51053481,51057759,51053481,51057759,111112619,XM_022450241.1,uncharacterized LOC111112619,4278
NC_035788.1,37959171,37961864,37959171,37961864,111112626,XM_022450254.1,uncharacterized LOC111112626,2693
NC_035788.1,50717473,50799111,50727147,50799111,111112627,XM_022450258.1,uncharacterized LOC111112627,71964
NC_035788.1,50717473,50799111,50726417,50799111,111112627,XM_022450256.1,uncharacterized LOC111112627,72694
NC_035788.1,50717473,50799111,50717473,50799111,111112627,XM_022450255.1,uncharacterized LOC111112627,81638
NC_035788.1,52631315,52724132,52631315,52722465,111112629,XM_022450278.1,uncharacterized LOC111112629,91150
NC_035788.1,52631315,52724132,52631315,52724132,111112629,XM_022450264.1,uncharacterized LOC111112629,92817
NC_035788.1,52785201,52842402,52803048,52842402,111112630,XM_022450280.1,uncharacterized LOC111112630,39354
NC_035788.1,52785201,52842402,52785201,52842402,111112630,XM_022450279.1,uncharacterized LOC111112630,57201
NC_035788.1,52904297,52968525,52910389,52966918,111112631,XM_022450285.1,uncharacterized LOC111112631,56529
NC_035788.1,52904297,52968525,52910389,52968525,111112631,XM_022450281.1,uncharacterized LOC111112631,58136
NC_035788.1,52904297,52968525,52904297,52968525,111112631,XM_022450282.1,uncharacterized LOC111112631,64228
NC_035788.1,53042537,53075543,53042537,53075543,111112632,XM_022450286.1,uncharacterized LOC111112632,33006
NC_035788.1,15290053,15301572,15290053,15301572,111112636,XM_022450292.1,uncharacterized LOC111112636,11519
NC_035788.1,15264151,15270058,15264151,15270058,111112637,XM_022450293.1,uncharacterized LOC111112637,5907
NC_035788.1,60064012,60066346,60064012,60066346,111112639,XM_022450294.1,uncharacterized LOC111112639,2334
NC_035788.1,58734569,58775121,58734569,58775121,111112647,XM_022450309.1,uncharacterized LOC111112647,40552
NC_035788.1,58810009,58834505,58810009,58834505,111112648,XM_022450310.1,uncharacterized LOC111112648,24496
NC_035788.1,58805478,58806713,58805478,58806713,111112649,XM_022450311.1,uncharacterized LOC111112649,1235
NC_035788.1,55328639,55483798,55328639,55443891,111112653,XM_022450319.1,uncharacterized LOC111112653,115252
NC_035788.1,55328639,55483798,55328642,55483798,111112653,XM_022450314.1,uncharacterized LOC111112653,155156
NC_035788.1,55328639,55483798,55328639,55483798,111112653,XM_022450318.1,uncharacterized LOC111112653,155159
NC_035788.1,96332411,96407750,96332411,96407750,111112654,XM_022450320.1,uncharacterized LOC111112654,75339
NC_035788.1,96537469,96542871,96537469,96542871,111112656,XM_022450341.1,uncharacterized LOC111112656,5402
NC_035788.1,96455867,96511101,96455867,96490463,111112657,XM_022450347.1,uncharacterized LOC111112657,34596
NC_035788.1,96455867,96511101,96455867,96495229,111112657,XM_022450346.1,uncharacterized LOC111112657,39362
NC_035788.1,96455867,96511101,96455867,96500836,111112657,XM_022450343.1,uncharacterized LOC111112657,44969
NC_035788.1,96455867,96511101,96455867,96511019,111112657,XM_022450345.1,uncharacterized LOC111112657,55152
NC_035788.1,96455867,96511101,96455867,96511101,111112657,XM_022450344.1,uncharacterized LOC111112657,55234
NC_035788.1,96131098,96253519,96131098,96253519,111112658,XM_022450353.1,uncharacterized LOC111112658,122421
NC_035788.1,96499383,96500453,96499383,96500453,111112659,XM_022450355.1,uncharacterized LOC111112659,1070
NC_035788.1,96440305,96442968,96440305,96442968,111112660,XM_022450356.1,uncharacterized LOC111112660,2663
NC_035788.1,52110081,52119067,52110081,52119067,111112662,XM_022450357.1,uncharacterized LOC111112662,8986
NC_035788.1,52140622,52145403,52140622,52145403,111112663,XM_022450360.1,uncharacterized LOC111112663,4781
NC_035788.1,102705099,102800361,102722201,102800361,111112665,XM_022450366.1,uncharacterized LOC111112665,78160
NC_035788.1,102705099,102800361,102720582,102800361,111112665,XM_022450365.1,uncharacterized LOC111112665,79779
NC_035788.1,102705099,102800361,102705099,102800361,111112665,XM_022450364.1,uncharacterized LOC111112665,95262
NC_035788.1,102641515,102675972,102641515,102672136,111112666,XM_022450370.1,uncharacterized LOC111112666,30621
NC_035788.1,102641515,102675972,102641515,102675972,111112666,XM_022450371.1,uncharacterized LOC111112666,34457
NC_035788.1,102469830,102870291,102849676,102870291,111112667,XM_022450374.1,uncharacterized LOC111112667,20615
NC_035788.1,102469830,102870291,102469830,102870291,111112667,XM_022450373.1,uncharacterized LOC111112667,400461
NC_035788.1,102675956,102695494,102678122,102695491,111112669,XM_022450379.1,uncharacterized LOC111112669,17369
NC_035788.1,102675956,102695494,102678122,102695494,111112669,XM_022450376.1,uncharacterized LOC111112669,17372
NC_035788.1,102675956,102695494,102678122,102685362,111112669,XM_022450377.1,uncharacterized LOC111112669,7240
NC_035788.1,102701459,102702925,102701459,102702925,111112673,XM_022450384.1,uncharacterized LOC111112673,1466
NC_035788.1,7694386,7701780,7694392,7699107,111112685,XM_022450396.1,uncharacterized LOC111112685,4715
NC_035788.1,7694386,7701780,7694405,7701780,111112685,XM_022450399.1,uncharacterized LOC111112685,7375
NC_035788.1,7694386,7701780,7694386,7701780,111112685,XM_022450397.1,uncharacterized LOC111112685,7394
NC_035788.1,7764260,7775566,7764260,7775566,111112686,XM_022450402.1,uncharacterized LOC111112686,11306
NC_035788.1,7764260,7775566,7764260,7767404,111112686,XM_022450403.1,uncharacterized LOC111112686,3144
NC_035788.1,7360926,7416836,7370592,7416836,111112688,XM_022450411.1,uncharacterized LOC111112688,46244
NC_035788.1,7360926,7416836,7364941,7411368,111112688,XM_022450409.1,uncharacterized LOC111112688,46427
NC_035788.1,7360926,7416836,7364941,7411380,111112688,XM_022450408.1,uncharacterized LOC111112688,46439
NC_035788.1,7360926,7416836,7364941,7416836,111112688,XM_022450407.1,uncharacterized LOC111112688,51895
NC_035788.1,7360926,7416836,7360926,7416836,111112688,XM_022450410.1,uncharacterized LOC111112688,55910
NC_035788.1,7755044,7793664,7755044,7793664,111112689,XM_022450412.1,uncharacterized LOC111112689,38620
NC_035788.1,7656174,7674426,7656174,7674426,111112691,XM_022450415.1,uncharacterized LOC111112691,18252
NC_035788.1,7619359,7626506,7619359,7626506,111112692,XM_022450416.1,uncharacterized LOC111112692,7147
NC_035788.1,60677552,60679844,60677552,60679844,111112704,XM_022450432.1,uncharacterized LOC111112704,2292
NC_035788.1,26175233,26177289,26175233,26177289,111112716,XM_022450451.1,uncharacterized LOC111112716,2056
NC_035788.1,26421511,26425634,26421511,26425634,111112718,XM_022450454.1,uncharacterized LOC111112718,4123
NC_035788.1,26196471,26197312,26196471,26197244,111112719,XM_022450455.1,uncharacterized LOC111112719,773
NC_035788.1,101822129,101826298,101822581,101826298,111112726,XM_022450457.1,uncharacterized LOC111112726,3717
NC_035788.1,101822129,101826298,101822129,101826298,111112726,XM_022450458.1,uncharacterized LOC111112726,4169
NC_035788.1,40958358,40981648,40966824,40981648,111112729,XM_022450461.1,uncharacterized LOC111112729,14824
NC_035788.1,40958358,40981648,40958358,40981648,111112729,XM_022450460.1,uncharacterized LOC111112729,23290
NC_035788.1,40958358,40981648,40977025,40981648,111112729,XM_022450463.1,uncharacterized LOC111112729,4623
NC_035788.1,40958358,40981648,40972210,40981648,111112729,XM_022450462.1,uncharacterized LOC111112729,9438
NC_035780.1,39402096,39404519,39402096,39404519,111112738,XM_022450490.1,uncharacterized LOC111112738,2423
NC_035788.1,9479120,9492049,9479120,9492048,111112740,XM_022450489.1,uncharacterized LOC111112740,12928
NC_035788.1,9479120,9492049,9479120,9492049,111112740,XM_022450488.1,uncharacterized LOC111112740,12929
NC_035788.1,5655810,5668919,5655810,5668900,111112747,XM_022450502.1,uncharacterized LOC111112747,13090
NC_035788.1,5655810,5668919,5655810,5668919,111112747,XM_022450501.1,uncharacterized LOC111112747,13109
NC_035788.1,5655810,5668919,5655810,5660337,111112747,XM_022450500.1,uncharacterized LOC111112747,4527
NC_035788.1,54321455,54338954,54321455,54338954,111112748,XM_022450503.1,uncharacterized LOC111112748,17499
NC_035788.1,15204118,15224186,15204118,15224182,111112750,XM_022450508.1,uncharacterized LOC111112750,20064
NC_035788.1,15204118,15224186,15204118,15224185,111112750,XM_022450506.1,uncharacterized LOC111112750,20067
NC_035788.1,15204118,15224186,15204118,15224186,111112750,XM_022450505.1,uncharacterized LOC111112750,20068
NC_035788.1,33070004,33071908,33070004,33071908,111112759,XM_022450521.1,uncharacterized LOC111112759,1904
NC_035788.1,32082604,32085908,32082605,32085907,111112767,XM_022450538.1,uncharacterized LOC111112767,3302
NC_035788.1,32082604,32085908,32082604,32085908,111112767,XM_022450539.1,uncharacterized LOC111112767,3304
NC_035788.1,32058924,32068542,32058924,32068542,111112768,XM_022450540.1,uncharacterized LOC111112768,9618
NC_035788.1,41040905,41054929,41040905,41054929,111112770,XM_022450541.1,uncharacterized LOC111112770,14024
NC_035788.1,6670297,6735699,6717585,6735697,111112774,XM_022450557.1,uncharacterized LOC111112774,18112
NC_035788.1,6670297,6735699,6672680,6735699,111112774,XM_022450546.1,uncharacterized LOC111112774,63019
NC_035788.1,6670297,6735699,6670730,6735699,111112774,XM_022450547.1,uncharacterized LOC111112774,64969
NC_035788.1,6670297,6735699,6670311,6735698,111112774,XM_022450554.1,uncharacterized LOC111112774,65387
NC_035788.1,6670297,6735699,6670310,6735699,111112774,XM_022450545.1,uncharacterized LOC111112774,65389
NC_035788.1,6670297,6735699,6670309,6735699,111112774,XM_022450556.1,uncharacterized LOC111112774,65390
NC_035788.1,6670297,6735699,6670297,6735699,111112774,XM_022450548.1,uncharacterized LOC111112774,65402
NC_035788.1,6865967,6875928,6865967,6869099,111112775,XM_022450559.1,uncharacterized LOC111112775,3132
NC_035788.1,6865967,6875928,6865967,6875928,111112775,XM_022450558.1,uncharacterized LOC111112775,9961
NC_035788.1,6885437,6891011,6885444,6891008,111112779,XM_022450571.1,uncharacterized LOC111112779,5564
NC_035788.1,6885437,6891011,6885441,6891008,111112779,XM_022450568.1,uncharacterized LOC111112779,5567
NC_035788.1,6885437,6891011,6885438,6891008,111112779,XM_022450567.1,uncharacterized LOC111112779,5570
NC_035788.1,6885437,6891011,6885437,6891008,111112779,XM_022450570.1,uncharacterized LOC111112779,5571
NC_035788.1,6885437,6891011,6885438,6891011,111112779,XM_022450569.1,uncharacterized LOC111112779,5573
NC_035788.1,43506045,43540029,43506045,43540029,111112787,XM_022450580.1,uncharacterized LOC111112787,33984
NC_035788.1,43524340,43526872,43524340,43526872,111112789,XM_022450584.1,uncharacterized LOC111112789,2532
NC_035780.1,26832468,26834736,26832468,26834704,111112792,XM_022451787.1,uncharacterized LOC111112792,2236
NC_035780.1,26832468,26834736,26832468,26834736,111112792,XM_022450987.1,uncharacterized LOC111112792,2268
NC_035788.1,73487036,73489889,73487036,73489889,111112795,XM_022450599.1,uncharacterized LOC111112795,2853
NC_035788.1,73458123,73466564,73458123,73462061,111112797,XM_022450600.1,uncharacterized LOC111112797,3938
NC_035788.1,73458123,73466564,73458123,73466564,111112797,XM_022450601.1,uncharacterized LOC111112797,8441
NC_035788.1,56978318,56997089,56986840,56997089,111112810,XM_022450629.1,uncharacterized LOC111112810,10249
NC_035788.1,56978318,56997089,56980443,56997089,111112810,XM_022450619.1,uncharacterized LOC111112810,16646
NC_035788.1,56978318,56997089,56979419,56997089,111112810,XM_022450618.1,uncharacterized LOC111112810,17670
NC_035788.1,56978318,56997089,56978326,56997089,111112810,XM_022450620.1,uncharacterized LOC111112810,18763
NC_035788.1,56978318,56997089,56978320,56997089,111112810,XM_022450626.1,uncharacterized LOC111112810,18769
NC_035788.1,56978318,56997089,56978319,56997089,111112810,XM_022450623.1,uncharacterized LOC111112810,18770
NC_035788.1,56978318,56997089,56978318,56997089,111112810,XM_022450616.1,uncharacterized LOC111112810,18771
NC_035788.1,10819347,10841474,10819348,10841474,111112816,XM_022450645.1,uncharacterized LOC111112816,22126
NC_035788.1,10819347,10841474,10819347,10841474,111112816,XM_022450643.1,uncharacterized LOC111112816,22127
NC_035788.1,10792003,10799426,10792003,10799426,111112818,XM_022450648.1,uncharacterized LOC111112818,7423
NC_035788.1,10766957,10773074,10766957,10773074,111112819,XM_022450649.1,uncharacterized LOC111112819,6117
NC_035788.1,10913651,10923592,10913651,10923592,111112821,XM_022450651.1,uncharacterized LOC111112821,9941
NC_035788.1,10887830,10910397,10887830,10910397,111112822,XM_022450654.1,uncharacterized LOC111112822,22567
NC_035788.1,10804503,10817498,10804503,10817498,111112823,XM_022450656.1,uncharacterized LOC111112823,12995
NC_035788.1,10846047,10856153,10846110,10856153,111112825,XM_022450660.1,uncharacterized LOC111112825,10043
NC_035788.1,10846047,10856153,10846047,10856153,111112825,XM_022450659.1,uncharacterized LOC111112825,10106
NC_035788.1,11057536,11075852,11057536,11075852,111112826,XM_022450661.1,uncharacterized LOC111112826,18316
NC_035788.1,10775539,10778409,10776367,10778409,111112829,XM_022450670.1,uncharacterized LOC111112829,2042
NC_035788.1,10775539,10778409,10775539,10778409,111112829,XM_022450669.1,uncharacterized LOC111112829,2870
NC_035788.1,11121657,11130855,11121657,11130855,111112830,XM_022450671.1,uncharacterized LOC111112830,9198
NC_035788.1,11184882,11190356,11184882,11190356,111112832,XM_022450674.1,uncharacterized LOC111112832,5474
NC_035788.1,10865344,10868674,10865344,10868674,111112835,XM_022450677.1,uncharacterized LOC111112835,3330
NC_035788.1,95940503,95946930,95940666,95943839,111112839,XM_022450683.1,uncharacterized LOC111112839,3173
NC_035788.1,95940503,95946930,95940503,95943839,111112839,XM_022450684.1,uncharacterized LOC111112839,3336
NC_035788.1,95940503,95946930,95940666,95946930,111112839,XM_022450682.1,uncharacterized LOC111112839,6264
NC_035788.1,95940503,95946930,95940503,95946930,111112839,XM_022450681.1,uncharacterized LOC111112839,6427
NC_035788.1,62061361,62065681,62061361,62065681,111112842,XM_022450689.1,uncharacterized LOC111112842,4320
NC_035780.1,33814296,33821577,33814296,33821577,111112847,XM_022450700.1,uncharacterized LOC111112847,7281
NC_035780.1,57023081,57026142,57023081,57026142,111112854,XM_022450712.1,uncharacterized LOC111112854,3061
NC_035788.1,95421265,95424362,95421265,95424362,111112855,XM_022450709.1,uncharacterized LOC111112855,3097
NC_035788.1,95532247,95533358,95532247,95533358,111112859,XM_022450714.1,uncharacterized LOC111112859,1111
NC_035788.1,36900947,36904312,36900947,36904312,111112860,XM_022450715.1,uncharacterized LOC111112860,3365
NC_035788.1,36898612,36900923,36898612,36900923,111112861,XM_022450716.1,uncharacterized LOC111112861,2311
NC_035788.1,77764180,77765437,77764180,77765437,111112867,XM_022450721.1,uncharacterized LOC111112867,1257
NC_035788.1,25844602,25850230,25844602,25850230,111112873,XM_022450726.1,uncharacterized LOC111112873,5628
NC_035788.1,31441401,31454047,31441401,31454047,111112874,XM_022450727.1,uncharacterized LOC111112874,12646
NC_035788.1,4216027,4274181,4216027,4274181,111112877,XM_022450730.1,uncharacterized LOC111112877,58154
NC_035788.1,4242927,4247120,4243397,4247120,111112878,XM_022450735.1,uncharacterized LOC111112878,3723
NC_035788.1,4242927,4247120,4243396,4247120,111112878,XM_022450731.1,uncharacterized LOC111112878,3724
NC_035788.1,4242927,4247120,4243049,4247120,111112878,XM_022450733.1,uncharacterized LOC111112878,4071
NC_035788.1,4242927,4247120,4242927,4247120,111112878,XM_022450732.1,uncharacterized LOC111112878,4193
NC_035788.1,4248066,4257361,4251244,4257361,111112879,XM_022450738.1,uncharacterized LOC111112879,6117
NC_035788.1,4248066,4257361,4248066,4255298,111112879,XM_022450737.1,uncharacterized LOC111112879,7232
NC_035788.1,4248066,4257361,4248067,4255876,111112879,XM_022450736.1,uncharacterized LOC111112879,7809
NC_035780.1,21632901,21668693,21632901,21668693,111112884,XM_022450747.1,uncharacterized LOC111112884,35792
NC_035788.1,1059270,1063097,1059270,1063097,111112885,XM_022450746.1,uncharacterized LOC111112885,3827
NC_035788.1,59777719,59882347,59777719,59882345,111112887,XM_022450751.1,uncharacterized LOC111112887,104626
NC_035788.1,59777719,59882347,59777719,59882347,111112887,XM_022450752.1,uncharacterized LOC111112887,104628
NC_035788.1,59862256,59866560,59862256,59866552,111112888,XM_022450753.1,uncharacterized LOC111112888,4296
NC_035780.1,21672794,21702438,21672794,21702438,111112890,XM_022450759.1,uncharacterized LOC111112890,29644
NC_035788.1,10230906,10255227,10230906,10255215,111112891,XM_022450756.1,uncharacterized LOC111112891,24309
NC_035788.1,10230906,10255227,10230906,10255227,111112891,XM_022450755.1,uncharacterized LOC111112891,24321
NC_035788.1,10438920,10463672,10438920,10463672,111112892,XM_022450757.1,uncharacterized LOC111112892,24752
NC_035788.1,10348354,10360894,10348354,10360894,111112893,XM_022450758.1,uncharacterized LOC111112893,12540
NC_035788.1,10508471,10526482,10508471,10526482,111112895,XM_022450764.1,uncharacterized LOC111112895,18011
NC_035788.1,10602390,10634823,10602390,10634823,111112896,XM_022450765.1,uncharacterized LOC111112896,32433
NC_035788.1,10332053,10343512,10332053,10343512,111112897,XM_022450766.1,uncharacterized LOC111112897,11459
NC_035788.1,10268603,10285235,10272259,10285235,111112898,XM_022450768.1,uncharacterized LOC111112898,12976
NC_035788.1,10268603,10285235,10268603,10285235,111112898,XM_022450770.1,uncharacterized LOC111112898,16632
NC_035788.1,10475626,10491981,10476896,10491979,111112900,XM_022450771.1,uncharacterized LOC111112900,15083
NC_035788.1,10475626,10491981,10476896,10491980,111112900,XM_022450773.1,uncharacterized LOC111112900,15084
NC_035788.1,10475626,10491981,10476896,10491981,111112900,XM_022450774.1,uncharacterized LOC111112900,15085
NC_035788.1,10550080,10577994,10550080,10577994,111112901,XM_022450775.1,uncharacterized LOC111112901,27914
NC_035788.1,45083956,45091200,45083956,45091200,111112902,XM_022450776.1,uncharacterized LOC111112902,7244
NC_035788.1,45118148,45121190,45118148,45121190,111112905,XM_022450781.1,uncharacterized LOC111112905,3042
NC_035788.1,40610559,40616849,40610559,40616849,111112916,XM_022450797.1,uncharacterized LOC111112916,6290
NC_035788.1,97065018,97086048,97065018,97086048,111112927,XM_022450816.1,uncharacterized LOC111112927,21030
NC_035788.1,96883416,96885517,96883416,96885517,111112930,XM_022450820.1,uncharacterized LOC111112930,2101
NC_035788.1,97211123,97214983,97211123,97214983,111112932,XM_022450822.1,uncharacterized LOC111112932,3860
NC_035788.1,96920702,96922120,96920702,96922120,111112933,XM_022450823.1,uncharacterized LOC111112933,1418
NC_035780.1,62635912,62637469,62635912,62637469,111112934,XM_022450834.1,uncharacterized LOC111112934,1557
NC_035780.1,54579210,54580235,54579210,54580235,111112941,XM_022450866.1,uncharacterized LOC111112941,1025
NC_035788.1,10070724,10076326,10070724,10076326,111112945,XM_022450839.1,uncharacterized LOC111112945,5602
NC_035780.1,32342130,32346880,32342130,32346880,111112949,XM_022450846.1,uncharacterized LOC111112949,4750
NC_035788.1,21466587,21479558,21466587,21479558,111112950,XM_022450843.1,uncharacterized LOC111112950,12971
NC_035788.1,21480645,21483348,21480645,21483348,111112956,XM_022450849.1,uncharacterized LOC111112956,2703
NC_035788.1,21554136,21559225,21554137,21559225,111112957,XM_022450850.1,uncharacterized LOC111112957,5088
NC_035788.1,21554136,21559225,21554136,21559225,111112957,XM_022450851.1,uncharacterized LOC111112957,5089
NC_035788.1,21561595,21562635,21561595,21562635,111112958,XM_022450852.1,uncharacterized LOC111112958,1040
NC_035788.1,64107821,64138382,64107822,64138382,111112966,XM_022450864.1,uncharacterized LOC111112966,30560
NC_035788.1,64107821,64138382,64107821,64138382,111112966,XM_022450863.1,uncharacterized LOC111112966,30561
NC_035788.1,64190740,64200855,64190784,64200855,111112968,XM_022450869.1,uncharacterized LOC111112968,10071
NC_035788.1,64190740,64200855,64190740,64193015,111112968,XM_022450868.1,uncharacterized LOC111112968,2275
NC_035788.1,64190740,64200855,64197664,64200855,111112968,XM_022450870.1,uncharacterized LOC111112968,3191
NC_035780.1,51607723,51619992,51607723,51619992,111112971,XM_022450880.1,uncharacterized LOC111112971,12269
NC_035788.1,64163818,64165688,64163818,64165688,111112973,XM_022450878.1,uncharacterized LOC111112973,1870
NC_035788.1,64040210,64042929,64040210,64042929,111112974,XM_022450879.1,uncharacterized LOC111112974,2719
NC_035788.1,64003109,64013002,64003109,64013002,111112976,XM_022450882.1,uncharacterized LOC111112976,9893
NC_035788.1,36700031,36734234,36700031,36734234,111112981,XM_022450886.1,uncharacterized LOC111112981,34203
NC_035788.1,36548564,36581742,36548564,36581742,111112983,XM_022450887.1,uncharacterized LOC111112983,33178
NC_035788.1,59012968,59016671,59012968,59016671,111112988,XM_022450891.1,uncharacterized LOC111112988,3703
NC_035788.1,74255523,74276973,74255523,74276973,111112994,XM_022450909.1,uncharacterized LOC111112994,21450
NC_035788.1,74213206,74219107,74213206,74219107,111112995,XM_022450910.1,uncharacterized LOC111112995,5901
NC_035788.1,74228747,74236870,74228747,74236870,111112998,XM_022450912.1,uncharacterized LOC111112998,8123
NC_035780.1,16837460,16847394,16837460,16847394,111113005,XM_022450926.1,uncharacterized LOC111113005,9934
NC_035788.1,15669970,15682901,15669970,15682901,111113013,XM_022450930.1,uncharacterized LOC111113013,12931
NC_035788.1,15669970,15682901,15678544,15682901,111113013,XM_022450932.1,uncharacterized LOC111113013,4357
NC_035788.1,15669970,15682901,15678541,15682900,111113013,XM_022450929.1,uncharacterized LOC111113013,4359
NC_035788.1,15688113,15692562,15688113,15692562,111113015,XM_022450933.1,uncharacterized LOC111113015,4449
NC_035788.1,15700501,15705239,15700501,15705239,111113016,XM_022450934.1,uncharacterized LOC111113016,4738
NC_035788.1,101161994,101164668,101161994,101164668,111113023,XM_022450951.1,uncharacterized LOC111113023,2674
NC_035788.1,77313098,77317026,77313916,77317026,111113031,XM_022450962.1,uncharacterized LOC111113031,3110
NC_035788.1,77313098,77317026,77313098,77317026,111113031,XM_022450963.1,uncharacterized LOC111113031,3928
NC_035788.1,88597881,88601376,88597881,88601376,111113044,XM_022450990.1,uncharacterized LOC111113044,3495
NC_035788.1,88434822,88446887,88434822,88446887,111113046,XM_022450993.1,uncharacterized LOC111113046,12065
NC_035788.1,88489023,88492301,88489023,88492301,111113047,XM_022450994.1,uncharacterized LOC111113047,3278
NC_035788.1,88545032,88546500,88545032,88546500,111113049,XM_022450998.1,uncharacterized LOC111113049,1468
NC_035788.1,76432066,76439358,76432066,76439347,111113051,XM_022451000.1,uncharacterized LOC111113051,7281
NC_035788.1,22947588,22951154,22947588,22951154,111113052,XM_022451001.1,uncharacterized LOC111113052,3566
NC_035788.1,22937742,22980826,22965428,22980826,111113053,XM_022451004.1,uncharacterized LOC111113053,15398
NC_035788.1,22937742,22980826,22937742,22973938,111113053,XM_022451003.1,uncharacterized LOC111113053,36196
NC_035788.1,22937742,22980826,22937742,22980826,111113053,XM_022451002.1,uncharacterized LOC111113053,43084
NC_035788.1,22950295,22953780,22950678,22953776,111113054,XM_022451005.1,uncharacterized LOC111113054,3098
NC_035788.1,22950295,22953780,22950672,22953779,111113054,XM_022451006.1,uncharacterized LOC111113054,3107
NC_035788.1,40172817,40299409,40198674,40299409,111113056,XM_022451011.1,uncharacterized LOC111113056,100735
NC_035788.1,40172817,40299409,40172817,40299409,111113056,XM_022451009.1,uncharacterized LOC111113056,126592
NC_035788.1,40172817,40299409,40172817,40225315,111113056,XM_022451012.1,uncharacterized LOC111113056,52498
NC_035788.1,40077714,40141400,40130207,40141400,111113057,XM_022451018.1,uncharacterized LOC111113057,11193
NC_035788.1,40077714,40141400,40137235,40141400,111113057,XM_022451017.1,uncharacterized LOC111113057,4165
NC_035788.1,40077714,40141400,40086491,40141400,111113057,XM_022451014.1,uncharacterized LOC111113057,54909
NC_035788.1,40077714,40141400,40077714,40141400,111113057,XM_022451013.1,uncharacterized LOC111113057,63686
NC_035788.1,40326019,40335163,40326019,40335163,111113058,XM_022451019.1,uncharacterized LOC111113058,9144
NC_035788.1,32690724,32742535,32690724,32702767,111113062,XM_022451029.1,uncharacterized LOC111113062,12043
NC_035788.1,32690724,32742535,32690724,32742526,111113062,XM_022451027.1,uncharacterized LOC111113062,51802
NC_035788.1,32690724,32742535,32690724,32742535,111113062,XM_022451025.1,uncharacterized LOC111113062,51811
NC_035788.1,32676242,32678400,32676242,32678400,111113065,XM_022451036.1,uncharacterized LOC111113065,2158
NC_035788.1,32393967,32399188,32393967,32399188,111113066,XM_022451037.1,uncharacterized LOC111113066,5221
NC_035788.1,32552720,32559291,32552720,32559291,111113067,XM_022451038.1,uncharacterized LOC111113067,6571
NC_035788.1,32718114,32723638,32718116,32723638,111113070,XM_022451042.1,uncharacterized LOC111113070,5522
NC_035788.1,32718114,32723638,32718114,32723638,111113070,XM_022451043.1,uncharacterized LOC111113070,5524
NC_035788.1,32675825,32682820,32675825,32682820,111113071,XM_022451044.1,uncharacterized LOC111113071,6995
NC_035788.1,32648869,32649687,32648869,32649687,111113074,XM_022451048.1,uncharacterized LOC111113074,818
NC_035788.1,8783521,8790370,8783521,8790370,111113079,XM_022451050.1,uncharacterized LOC111113079,6849
NC_035788.1,8783857,8785792,8783857,8785792,111113080,XM_022451051.1,uncharacterized LOC111113080,1935
NC_035788.1,99209778,99216971,99209778,99216971,111113081,XM_022451052.1,uncharacterized LOC111113081,7193
NC_035788.1,99070604,99074515,99070604,99074515,111113082,XM_022451053.1,uncharacterized LOC111113082,3911
NC_035788.1,99230021,99267220,99230021,99267220,111113083,XM_022451054.1,uncharacterized LOC111113083,37199
NC_035788.1,20199381,20205141,20199381,20204720,111113099,XM_022451085.1,uncharacterized LOC111113099,5339
NC_035788.1,20199381,20205141,20199381,20205141,111113099,XM_022451086.1,uncharacterized LOC111113099,5760
NC_035788.1,20377132,20398453,20377132,20398453,111113101,XM_022451087.1,uncharacterized LOC111113101,21321
NC_035788.1,20180161,20182926,20180161,20182926,111113102,XM_022451088.1,uncharacterized LOC111113102,2765
NC_035788.1,20485543,20488289,20485543,20488289,111113103,XM_022451090.1,uncharacterized LOC111113103,2746
NC_035788.1,20435113,20436422,20435113,20436422,111113105,XM_022451093.1,uncharacterized LOC111113105,1309
NC_035788.1,4982899,5014044,4982899,5000917,111113125,XM_022451118.1,uncharacterized LOC111113125,18018
NC_035788.1,5033924,5057993,5033924,5057993,111113126,XM_022451122.1,uncharacterized LOC111113126,24069
NC_035788.1,74659320,74698104,74671093,74698101,111113130,XM_022451134.1,uncharacterized LOC111113130,27008
NC_035788.1,74659320,74698104,74659321,74698103,111113130,XM_022451136.1,uncharacterized LOC111113130,38782
NC_035788.1,74659320,74698104,74659320,74698104,111113130,XM_022451135.1,uncharacterized LOC111113130,38784
NC_035788.1,74654224,74658909,74654224,74658909,111113133,XM_022451137.1,uncharacterized LOC111113133,4685
NC_035788.1,28572861,28587707,28572861,28587707,111113144,XM_022451151.1,uncharacterized LOC111113144,14846
NC_035788.1,28144246,28190601,28144246,28190601,111113146,XM_022451154.1,uncharacterized LOC111113146,46355
NC_035788.1,28172873,28180157,28172873,28180157,111113148,XM_022451156.1,uncharacterized LOC111113148,7284
NC_035788.1,28487622,28488766,28487622,28488766,111113149,XM_022451157.1,uncharacterized LOC111113149,1144
NC_035788.1,28461062,28473682,28461062,28473682,111113150,XM_022451159.1,uncharacterized LOC111113150,12620
NC_035788.1,28461062,28473682,28461062,28467679,111113150,XM_022451158.1,uncharacterized LOC111113150,6617
NC_035788.1,5464107,5496807,5472167,5496807,111113157,XM_022451164.1,uncharacterized LOC111113157,24640
NC_035788.1,5464107,5496807,5472166,5496807,111113157,XM_022451163.1,uncharacterized LOC111113157,24641
NC_035788.1,5464107,5496807,5468070,5496807,111113157,XM_022451166.1,uncharacterized LOC111113157,28737
NC_035788.1,5464107,5496807,5464107,5496807,111113157,XM_022451171.1,uncharacterized LOC111113157,32700
NC_035780.1,45964694,45969601,45964694,45969601,111113164,XM_022451199.1,uncharacterized LOC111113164,4907
NC_035788.1,46782713,46788598,46782713,46788598,111113176,XM_022451246.1,uncharacterized LOC111113176,5885
NC_035788.1,45638641,45640925,45638641,45640925,111113195,XM_022451287.1,uncharacterized LOC111113195,2284
NC_035788.1,46540226,46553068,46540226,46553068,111113196,XM_022451288.1,uncharacterized LOC111113196,12842
NC_035788.1,46303174,46315678,46303174,46315675,111113198,XM_022451292.1,uncharacterized LOC111113198,12501
NC_035788.1,46303174,46315678,46303174,46315678,111113198,XM_022451291.1,uncharacterized LOC111113198,12504
NC_035788.1,46303174,46315678,46303174,46306078,111113198,XM_022451293.1,uncharacterized LOC111113198,2904
NC_035788.1,46519417,46530386,46519417,46530369,111113200,XM_022451296.1,uncharacterized LOC111113200,10952
NC_035788.1,46519417,46530386,46519417,46530386,111113200,XM_022451295.1,uncharacterized LOC111113200,10969
NC_035788.1,46496185,46505175,46496185,46505175,111113201,XM_022451298.1,uncharacterized LOC111113201,8990
NC_035788.1,46511360,46516840,46511360,46516840,111113202,XM_022451299.1,uncharacterized LOC111113202,5480
NC_035788.1,45637085,45638647,45637085,45638647,111113205,XM_022451303.1,uncharacterized LOC111113205,1562
NC_035788.1,46574603,46576314,46574603,46576314,111113206,XM_022451304.1,uncharacterized LOC111113206,1711
NC_035788.1,47415793,47462630,47458571,47462625,111113208,XM_022451307.1,uncharacterized LOC111113208,4054
NC_035788.1,47415793,47462630,47415793,47462625,111113208,XM_022451308.1,uncharacterized LOC111113208,46832
NC_035788.1,46487603,46494164,46487603,46494164,111113211,XM_022451311.1,uncharacterized LOC111113211,6561
NC_035788.1,46115183,46118828,46115183,46118828,111113212,XM_022451312.1,uncharacterized LOC111113212,3645
NC_035788.1,45876079,45881373,45876079,45881373,111113213,XM_022451313.1,uncharacterized LOC111113213,5294
NC_035788.1,102931221,102933415,102931221,102933415,111113218,XM_022451327.1,uncharacterized LOC111113218,2194
NC_035780.1,34848354,34850525,34848354,34850525,111113220,XM_022451331.1,uncharacterized LOC111113220,2171
NC_035788.1,102942014,102946408,102942014,102945264,111113221,XM_022451330.1,uncharacterized LOC111113221,3250
NC_035788.1,102942014,102946408,102942014,102946408,111113221,XM_022451329.1,uncharacterized LOC111113221,4394
NC_035780.1,49868432,49870611,49868432,49870611,111113237,XM_022451372.1,uncharacterized LOC111113237,2179
NC_035788.1,65128351,65135568,65128351,65135568,111113240,XM_022451337.1,uncharacterized LOC111113240,7217
NC_035788.1,64989790,64993115,64989790,64993115,111113241,XM_022451340.1,uncharacterized LOC111113241,3325
NC_035788.1,65057881,65082026,65057881,65082026,111113242,XM_022451341.1,uncharacterized LOC111113242,24145
NC_035788.1,84010197,84018799,84010197,84018799,111113247,XM_022451343.1,uncharacterized LOC111113247,8602
NC_035788.1,15534102,15553827,15542097,15553827,111113256,XM_022451357.1,uncharacterized LOC111113256,11730
NC_035788.1,15534102,15553827,15538479,15553827,111113256,XM_022451356.1,uncharacterized LOC111113256,15348
NC_035788.1,15534102,15553827,15534102,15536855,111113256,XM_022451355.1,uncharacterized LOC111113256,2753
NC_035788.1,15503175,15524235,15503176,15524235,111113257,XM_022451359.1,uncharacterized LOC111113257,21059
NC_035788.1,15503175,15524235,15503175,15524235,111113257,XM_022451361.1,uncharacterized LOC111113257,21060
NC_035788.1,54834392,54877962,54840409,54877962,111113260,XM_022451366.1,uncharacterized LOC111113260,37553
NC_035788.1,54834392,54877962,54840044,54877962,111113260,XM_022451365.1,uncharacterized LOC111113260,37918
NC_035788.1,54834392,54877962,54834392,54839762,111113260,XM_022451364.1,uncharacterized LOC111113260,5370
NC_035788.1,81001952,81009526,81001952,81009526,111113261,XM_022451368.1,uncharacterized LOC111113261,7574
NC_035788.1,5366676,5401794,5382057,5401786,111113267,XM_022451381.1,uncharacterized LOC111113267,19729
NC_035788.1,5366676,5401794,5371250,5401789,111113267,XM_022451380.1,uncharacterized LOC111113267,30539
NC_035788.1,5366676,5401794,5366676,5401794,111113267,XM_022451382.1,uncharacterized LOC111113267,35118
NC_035788.1,26647338,26672569,26659104,26672569,111113269,XM_022451384.1,uncharacterized LOC111113269,13465
NC_035788.1,26647338,26672569,26658998,26672569,111113269,XM_022451387.1,uncharacterized LOC111113269,13571
NC_035788.1,26647338,26672569,26647338,26672569,111113269,XM_022451386.1,uncharacterized LOC111113269,25231
NC_035788.1,92650,155345,92650,120572,111113274,XM_022451398.1,uncharacterized LOC111113274,27922
NC_035788.1,92650,155345,92650,150354,111113274,XM_022451394.1,uncharacterized LOC111113274,57704
NC_035788.1,92650,155345,92650,150356,111113274,XM_022451396.1,uncharacterized LOC111113274,57706
NC_035788.1,92650,155345,92650,154702,111113274,XM_022451395.1,uncharacterized LOC111113274,62052
NC_035788.1,92650,155345,92650,155339,111113274,XM_022451392.1,uncharacterized LOC111113274,62689
NC_035788.1,92650,155345,92650,155345,111113274,XM_022451397.1,uncharacterized LOC111113274,62695
NC_035788.1,63217002,63218564,63217002,63218564,111113280,XM_022451406.1,uncharacterized LOC111113280,1562
NC_035788.1,63176402,63180660,63176402,63178670,111113281,XM_022451408.1,uncharacterized LOC111113281,2268
NC_035788.1,63176402,63180660,63176402,63180660,111113281,XM_022451407.1,uncharacterized LOC111113281,4258
NC_035788.1,63170327,63171957,63170327,63171957,111113282,XM_022451409.1,uncharacterized LOC111113282,1630
NC_035788.1,63146405,63148044,63146405,63148044,111113283,XM_022451411.1,uncharacterized LOC111113283,1639
NC_035788.1,63153000,63156428,63153000,63156428,111113284,XM_022451412.1,uncharacterized LOC111113284,3428
NC_035788.1,63140554,63143332,63140554,63143332,111113285,XM_022451413.1,uncharacterized LOC111113285,2778
NC_035788.1,63186478,63202365,63186478,63202365,111113286,XM_022451414.1,uncharacterized LOC111113286,15887
NC_035788.1,60368493,60397621,60368498,60397621,111113291,XM_022451420.1,uncharacterized LOC111113291,29123
NC_035788.1,60368493,60397621,60368493,60397620,111113291,XM_022451421.1,uncharacterized LOC111113291,29127
NC_035788.1,60368493,60397621,60368493,60397621,111113291,XM_022451419.1,uncharacterized LOC111113291,29128
NC_035788.1,53428916,53477851,53457893,53477851,111113294,XM_022451441.1,uncharacterized LOC111113294,19958
NC_035788.1,53428916,53477851,53429697,53477851,111113294,XM_022451428.1,uncharacterized LOC111113294,48154
NC_035788.1,53428916,53477851,53429633,53477851,111113294,XM_022451431.1,uncharacterized LOC111113294,48218
NC_035788.1,53428916,53477851,53428928,53477851,111113294,XM_022451429.1,uncharacterized LOC111113294,48923
NC_035788.1,53428916,53477851,53428916,53477851,111113294,XM_022451430.1,uncharacterized LOC111113294,48935
NC_035788.1,53428916,53477851,53448515,53456653,111113294,XM_022451427.1,uncharacterized LOC111113294,8138
NC_035788.1,53504483,53509095,53504483,53509095,111113295,XM_022451443.1,uncharacterized LOC111113295,4612
NC_035788.1,69701483,69723071,69701483,69723071,111113298,XM_022451446.1,uncharacterized LOC111113298,21588
NC_035788.1,11590997,11599094,11590997,11599094,111113307,XM_022451472.1,uncharacterized LOC111113307,8097
NC_035788.1,52080330,52103608,52080330,52103608,111113317,XM_022451497.1,uncharacterized LOC111113317,23278
NC_035788.1,77631915,77634083,77631915,77634083,111113321,XM_022451509.1,uncharacterized LOC111113321,2168
NC_035788.1,77619834,77627224,77619834,77627224,111113322,XM_022451511.1,uncharacterized LOC111113322,7390
NC_035788.1,68029918,68036640,68029918,68036640,111113324,XM_022451513.1,uncharacterized LOC111113324,6722
NC_035788.1,78853302,78857023,78853523,78856101,111113327,XM_022451519.1,uncharacterized LOC111113327,2578
NC_035788.1,78853302,78857023,78853302,78855996,111113327,XM_022451517.1,uncharacterized LOC111113327,2694
NC_035788.1,78853302,78857023,78853523,78857023,111113327,XM_022451520.1,uncharacterized LOC111113327,3500
NC_035788.1,81650246,81655511,81650246,81655511,111113333,XM_022451527.1,uncharacterized LOC111113333,5265
NC_035788.1,32108422,32142277,32108422,32136375,111113335,XM_022451531.1,uncharacterized LOC111113335,27953
NC_035788.1,32108422,32142277,32108422,32141689,111113335,XM_022451532.1,uncharacterized LOC111113335,33267
NC_035788.1,32108422,32142277,32108422,32142277,111113335,XM_022451530.1,uncharacterized LOC111113335,33855
NC_035788.1,67477518,67485039,67477518,67485039,111113338,XM_022451534.1,uncharacterized LOC111113338,7521
NC_035788.1,57298703,57308378,57298703,57308378,111113339,XM_022451535.1,uncharacterized LOC111113339,9675
NC_035788.1,57283699,57296477,57283699,57296477,111113340,XM_022451537.1,uncharacterized LOC111113340,12778
NC_035788.1,5847286,5871452,5847286,5871452,111113343,XM_022451541.1,uncharacterized LOC111113343,24166
NC_035780.1,1919019,1926830,1921267,1926830,111113346,XM_022451548.1,uncharacterized LOC111113346,5563
NC_035780.1,1919019,1926830,1921037,1926830,111113346,XM_022451556.1,uncharacterized LOC111113346,5793
NC_035780.1,1919019,1926830,1919019,1926830,111113346,XM_022451565.1,uncharacterized LOC111113346,7811
NC_035788.1,59560268,59606495,59560268,59596247,111113349,XM_022451553.1,uncharacterized LOC111113349,35979
NC_035788.1,59560268,59606495,59560268,59606495,111113349,XM_022451550.1,uncharacterized LOC111113349,46227
NC_035788.1,59533739,59552938,59533739,59552938,111113350,XM_022451554.1,uncharacterized LOC111113350,19199
NC_035788.1,2088851,2090517,2088851,2090517,111113353,XM_022451562.1,uncharacterized LOC111113353,1666
NC_035780.1,24842676,24844978,24842676,24844978,111113356,XM_022451580.1,uncharacterized LOC111113356,2302
NC_035780.1,4330509,4337426,4330509,4337426,111113361,XM_022451593.1,uncharacterized LOC111113361,6917
NC_035788.1,31715814,31719324,31715814,31719324,111113364,XM_022451595.1,uncharacterized LOC111113364,3510
NC_035788.1,31712566,31715202,31712566,31715202,111113365,XM_022451596.1,uncharacterized LOC111113365,2636
NC_035788.1,57343973,57347701,57343973,57347701,111113367,XM_022451599.1,uncharacterized LOC111113367,3728
NC_035788.1,24542608,24547882,24542608,24547882,111113375,XM_022451613.1,uncharacterized LOC111113375,5274
NC_035788.1,24611040,24626018,24611040,24626018,111113376,XM_022451614.1,uncharacterized LOC111113376,14978
NC_035788.1,78174089,78186466,78174090,78186466,111113381,XM_022451620.1,uncharacterized LOC111113381,12376
NC_035788.1,78174089,78186466,78174089,78186466,111113381,XM_022451618.1,uncharacterized LOC111113381,12377
NC_035788.1,10026309,10028530,10026309,10028530,111113382,XM_022451621.1,uncharacterized LOC111113382,2221
NC_035788.1,22532866,22536613,22532866,22536613,111113383,XM_022451622.1,uncharacterized LOC111113383,3747
NC_035788.1,22543235,22546807,22543235,22546807,111113384,XM_022451623.1,uncharacterized LOC111113384,3572
NC_035788.1,65738489,65742349,65738489,65742349,111113393,XM_022451641.1,uncharacterized LOC111113393,3860
NC_035788.1,69587665,69593910,69587665,69590408,111113403,XM_022451655.1,uncharacterized LOC111113403,2743
NC_035788.1,69587665,69593910,69587665,69591385,111113403,XM_022451654.1,uncharacterized LOC111113403,3720
NC_035788.1,69587665,69593910,69587665,69593909,111113403,XM_022451652.1,uncharacterized LOC111113403,6244
NC_035788.1,69587665,69593910,69587665,69593910,111113403,XM_022451653.1,uncharacterized LOC111113403,6245
NC_035788.1,25293704,25298934,25293704,25298934,111113406,XM_022451658.1,uncharacterized LOC111113406,5230
NC_035788.1,35586710,35590187,35586710,35590187,111113413,XM_022451669.1,uncharacterized LOC111113413,3477
NC_035788.1,21251733,21256697,21251733,21254726,111113418,XM_022451683.1,uncharacterized LOC111113418,2993
NC_035788.1,21251733,21256697,21251733,21256697,111113418,XM_022451684.1,uncharacterized LOC111113418,4964
NC_035788.1,21267256,21281387,21267256,21281387,111113420,XM_022451686.1,uncharacterized LOC111113420,14131
NC_035788.1,97560522,97567868,97560522,97567857,111113421,XM_022451687.1,uncharacterized LOC111113421,7335
NC_035788.1,92368141,92372449,92368164,92372449,111113422,XM_022451688.1,uncharacterized LOC111113422,4285
NC_035788.1,92368141,92372449,92368141,92372449,111113422,XM_022451689.1,uncharacterized LOC111113422,4308
NC_035780.1,64087264,64106850,64087264,64106850,111113431,XM_022451720.1,uncharacterized LOC111113431,19586
NC_035788.1,102078732,102124849,102080734,102124849,111113434,XM_022451723.1,uncharacterized LOC111113434,44115
NC_035788.1,102078732,102124849,102079034,102124849,111113434,XM_022451721.1,uncharacterized LOC111113434,45815
NC_035788.1,102078732,102124849,102078732,102124849,111113434,XM_022451722.1,uncharacterized LOC111113434,46117
NC_035788.1,102004607,102010258,102004607,102010258,111113437,XM_022451726.1,uncharacterized LOC111113437,5651
NC_035788.1,102144117,102149108,102144117,102149108,111113438,XM_022451727.1,uncharacterized LOC111113438,4991
NC_035788.1,98854979,98913024,98854980,98865909,111113441,XM_022451729.1,uncharacterized LOC111113441,10929
NC_035788.1,98854979,98913024,98854979,98913024,111113441,XM_022451728.1,uncharacterized LOC111113441,58045
NC_035788.1,98869904,98884008,98869904,98884008,111113442,XM_022451730.1,uncharacterized LOC111113442,14104
NC_035788.1,98897345,98901982,98897345,98901982,111113443,XM_022451732.1,uncharacterized LOC111113443,4637
NC_035788.1,65825785,65827629,65825785,65827629,111113444,XM_022451734.1,uncharacterized LOC111113444,1844
NC_035788.1,65827651,65828662,65827651,65828662,111113445,XM_022451735.1,uncharacterized LOC111113445,1011
NC_035788.1,68145513,68148599,68145513,68148569,111113448,XM_022451742.1,uncharacterized LOC111113448,3056
NC_035788.1,68145513,68148599,68145513,68148597,111113448,XM_022451743.1,uncharacterized LOC111113448,3084
NC_035788.1,68145513,68148599,68145513,68148599,111113448,XM_022451744.1,uncharacterized LOC111113448,3086
NC_035788.1,68090187,68092702,68090187,68092601,111113449,XM_022451745.1,uncharacterized LOC111113449,2414
NC_035788.1,68090187,68092702,68090187,68092702,111113449,XM_022451746.1,uncharacterized LOC111113449,2515
NC_035788.1,8776333,8782602,8776333,8782602,111113453,XM_022451750.1,uncharacterized LOC111113453,6269
NC_035780.1,44176358,44177206,44176358,44177206,111113458,XM_022451758.1,uncharacterized LOC111113458,848
NC_035788.1,9317235,9318818,9317235,9318818,111113460,XM_022451756.1,uncharacterized LOC111113460,1583
NC_035788.1,9328580,9334751,9328580,9334751,111113461,XM_022451757.1,uncharacterized LOC111113461,6171
NC_035788.1,9336098,9337943,9336098,9337943,111113462,XM_022451759.1,uncharacterized LOC111113462,1845
NC_035788.1,10023996,10026177,10023996,10026177,111113467,XM_022451763.1,uncharacterized LOC111113467,2181
NC_035788.1,10044509,10045358,10044509,10045358,111113468,XM_022451764.1,uncharacterized LOC111113468,849
NC_035788.1,10115127,10116346,10115127,10116346,111113470,XM_022451765.1,uncharacterized LOC111113470,1219
NC_035788.1,10152581,10156396,10152581,10156396,111113471,XM_022451766.1,uncharacterized LOC111113471,3815
NC_035788.1,10157945,10199042,10157945,10199042,111113472,XM_022451767.1,uncharacterized LOC111113472,41097
NC_035788.1,10400449,10417546,10400449,10417546,111113474,XM_022451770.1,uncharacterized LOC111113474,17097
NC_035788.1,10644014,10651961,10644014,10651961,111113475,XM_022451771.1,uncharacterized LOC111113475,7947
NC_035788.1,11148865,11151850,11148865,11151850,111113478,XM_022451774.1,uncharacterized LOC111113478,2985
NC_035780.1,32036596,32037722,32036596,32037722,111113480,XM_022451779.1,uncharacterized LOC111113480,1126
NC_035788.1,11205485,11215904,11205485,11215904,111113481,XM_022451776.1,uncharacterized LOC111113481,10419
NC_035788.1,11282171,11287321,11282171,11287321,111113482,XM_022451777.1,uncharacterized LOC111113482,5150
NC_035788.1,11353998,11402251,11353998,11402251,111113483,XM_022451778.1,uncharacterized LOC111113483,48253
NC_035788.1,12120081,12122908,12120081,12122908,111113493,XM_022451788.1,uncharacterized LOC111113493,2827
NC_035788.1,12259366,12264271,12259366,12264271,111113494,XM_022451789.1,uncharacterized LOC111113494,4905
NC_035788.1,12511515,12512076,12511515,12512076,111113498,XM_022451794.1,uncharacterized LOC111113498,561
NC_035788.1,12849474,12851165,12849474,12851165,111113501,XM_022451797.1,uncharacterized LOC111113501,1691
NC_035788.1,13093194,13094829,13093194,13094829,111113508,XM_022451802.1,uncharacterized LOC111113508,1635
NC_035788.1,13128267,13133840,13128267,13133840,111113509,XM_022451803.1,uncharacterized LOC111113509,5573
NC_035788.1,13287646,13313951,13287646,13313951,111113511,XM_022451805.1,uncharacterized LOC111113511,26305
NC_035788.1,13368600,13373081,13368600,13373081,111113513,XM_022451807.1,uncharacterized LOC111113513,4481
NC_035788.1,13635312,13642057,13635312,13642057,111113516,XM_022451809.1,uncharacterized LOC111113516,6745
NC_035788.1,13827590,13845455,13827590,13845455,111113518,XM_022451812.1,uncharacterized LOC111113518,17865
NC_035788.1,13970541,14051150,13970541,14051150,111113519,XM_022451813.1,uncharacterized LOC111113519,80609
NC_035788.1,14233462,14237681,14233462,14237681,111113523,XM_022451817.1,uncharacterized LOC111113523,4219
NC_035780.1,33981215,33990910,33981215,33988488,111113524,XM_022451821.1,uncharacterized LOC111113524,7273
NC_035780.1,33981215,33990910,33981215,33989379,111113524,XM_022451832.1,uncharacterized LOC111113524,8164
NC_035780.1,33981215,33990910,33981215,33990907,111113524,XM_022451826.1,uncharacterized LOC111113524,9692
NC_035780.1,33981215,33990910,33981215,33990910,111113524,XM_022451838.1,uncharacterized LOC111113524,9695
NC_035788.1,15339676,15349962,15339676,15349962,111113537,XM_022451828.1,uncharacterized LOC111113537,10286
NC_035788.1,15414116,15445103,15414116,15445103,111113538,XM_022451829.1,uncharacterized LOC111113538,30987
NC_035788.1,15640110,15641594,15640110,15641594,111113540,XM_022451830.1,uncharacterized LOC111113540,1484
NC_035788.1,15650037,15651542,15650037,15651542,111113541,XM_022451831.1,uncharacterized LOC111113541,1505
NC_035788.1,15727039,15728538,15727039,15728538,111113542,XM_022451833.1,uncharacterized LOC111113542,1499
NC_035788.1,15741770,15752331,15741770,15752331,111113543,XM_022451834.1,uncharacterized LOC111113543,10561
NC_035788.1,15758710,15760119,15758710,15760119,111113544,XM_022451835.1,uncharacterized LOC111113544,1409
NC_035788.1,15786298,15802015,15786298,15802015,111113545,XM_022451836.1,uncharacterized LOC111113545,15717
NC_035788.1,15855409,15858720,15855409,15858720,111113546,XM_022451837.1,uncharacterized LOC111113546,3311
NC_035788.1,15986303,15992926,15986303,15992926,111113547,XM_022451839.1,uncharacterized LOC111113547,6623
NC_035788.1,16222460,16248000,16222460,16248000,111113549,XM_022451841.1,uncharacterized LOC111113549,25540
NC_035788.1,16268006,16285806,16268006,16285806,111113550,XM_022451842.1,uncharacterized LOC111113550,17800
NC_035788.1,16757234,16758916,16757234,16758916,111113552,XM_022451844.1,uncharacterized LOC111113552,1682
NC_035780.1,32278477,32292315,32278905,32292311,111113554,XM_022451849.1,uncharacterized LOC111113554,13406
NC_035780.1,32278477,32292315,32278882,32292315,111113554,XM_022451857.1,uncharacterized LOC111113554,13433
NC_035780.1,32278477,32292315,32278477,32292310,111113554,XM_022451865.1,uncharacterized LOC111113554,13833
NC_035780.1,32278477,32292315,32278477,32292311,111113554,XM_022451871.1,uncharacterized LOC111113554,13834
NC_035780.1,32278477,32292315,32282742,32292311,111113554,XM_022451877.1,uncharacterized LOC111113554,9569
NC_035788.1,16857212,16858438,16857212,16858438,111113555,XM_022451846.1,uncharacterized LOC111113555,1226
NC_035788.1,16944218,16945297,16944218,16945297,111113556,XM_022451847.1,uncharacterized LOC111113556,1079
NC_035788.1,17088976,17090093,17088976,17090093,111113558,XM_022451850.1,uncharacterized LOC111113558,1117
NC_035788.1,17128488,17144960,17128488,17144960,111113559,XM_022451851.1,uncharacterized LOC111113559,16472
NC_035788.1,17412518,17416496,17412518,17416496,111113563,XM_022451855.1,uncharacterized LOC111113563,3978
NC_035788.1,17460076,17463102,17460076,17463102,111113565,XM_022451858.1,uncharacterized LOC111113565,3026
NC_035788.1,17493624,17496932,17493624,17496932,111113566,XM_022451859.1,uncharacterized LOC111113566,3308
NC_035788.1,17611925,17615274,17611925,17615274,111113567,XM_022451860.1,uncharacterized LOC111113567,3349
NC_035788.1,17950358,17953988,17950358,17953988,111113571,XM_022451864.1,uncharacterized LOC111113571,3630
NC_035788.1,17961731,17963284,17961731,17963284,111113572,XM_022451866.1,uncharacterized LOC111113572,1553
NC_035788.1,18079065,18084729,18079065,18084729,111113578,XM_022451873.1,uncharacterized LOC111113578,5664
NC_035788.1,18611226,18617730,18611226,18617730,111113583,XM_022451878.1,uncharacterized LOC111113583,6504
NC_035788.1,19512079,19515321,19512079,19515321,111113587,XM_022451882.1,uncharacterized LOC111113587,3242
NC_035788.1,19871710,19884277,19871710,19884277,111113590,XM_022451884.1,uncharacterized LOC111113590,12567
NC_035788.1,19964633,19965757,19964633,19965757,111113591,XM_022451885.1,uncharacterized LOC111113591,1124
NC_035780.1,54607665,54612202,54608350,54612201,111113592,XM_022451984.1,uncharacterized LOC111113592,3851
NC_035780.1,54607665,54612202,54607665,54612202,111113592,XM_022451917.1,uncharacterized LOC111113592,4537
NC_035788.1,19989007,19992237,19989007,19992237,111113593,XM_022451887.1,uncharacterized LOC111113593,3230
NC_035788.1,20598891,20600701,20598891,20600701,111113595,XM_022451889.1,uncharacterized LOC111113595,1810
NC_035788.1,20813015,20813797,20813015,20813797,111113598,XM_022451892.1,uncharacterized LOC111113598,782
NC_035780.1,29220894,29222351,29220894,29222351,111113599,XM_022451896.1,uncharacterized LOC111113599,1457
NC_035788.1,20845938,20890070,20845938,20890070,111113601,XM_022451894.1,uncharacterized LOC111113601,44132
NC_035788.1,20951117,20955765,20951117,20955765,111113602,XM_022451895.1,uncharacterized LOC111113602,4648
NC_035788.1,20980350,20982023,20980350,20982023,111113603,XM_022451897.1,uncharacterized LOC111113603,1673
NC_035788.1,21079577,21081391,21079577,21081391,111113604,XM_022451898.1,uncharacterized LOC111113604,1814
NC_035788.1,21711847,21713580,21711847,21713580,111113610,XM_022451903.1,uncharacterized LOC111113610,1733
NC_035788.1,21870491,21871766,21870491,21871766,111113611,XM_022451904.1,uncharacterized LOC111113611,1275
NC_035788.1,21923023,21923834,21923023,21923834,111113612,XM_022451905.1,uncharacterized LOC111113612,811
NC_035788.1,22310482,22312710,22310482,22312710,111113614,XM_022451907.1,uncharacterized LOC111113614,2228
NC_035788.1,22330871,22332497,22330871,22332497,111113615,XM_022451908.1,uncharacterized LOC111113615,1626
NC_035788.1,22815510,22816984,22815510,22816984,111113618,XM_022451910.1,uncharacterized LOC111113618,1474
NC_035788.1,22827411,22835596,22827411,22835596,111113619,XM_022451911.1,uncharacterized LOC111113619,8185
NC_035788.1,22839520,22841966,22839520,22841966,111113620,XM_022451912.1,uncharacterized LOC111113620,2446
NC_035788.1,22883853,22884578,22883853,22884578,111113621,XM_022451913.1,uncharacterized LOC111113621,725
NC_035788.1,23000980,23003316,23000980,23003316,111113623,XM_022451914.1,uncharacterized LOC111113623,2336
NC_035788.1,23065451,23170108,23065451,23170108,111113624,XM_022451915.1,uncharacterized LOC111113624,104657
NC_035788.1,23456364,23462258,23456364,23462258,111113625,XM_022451916.1,uncharacterized LOC111113625,5894
NC_035788.1,23479035,23486548,23479035,23486548,111113627,XM_022451920.1,uncharacterized LOC111113627,7513
NC_035788.1,23671430,23676540,23671430,23676540,111113629,XM_022451922.1,uncharacterized LOC111113629,5110
NC_035788.1,23678281,23680431,23678281,23680431,111113630,XM_022451923.1,uncharacterized LOC111113630,2150
NC_035788.1,23749510,23750466,23749510,23750466,111113632,XM_022451925.1,uncharacterized LOC111113632,956
NC_035780.1,58882917,58893352,58882917,58893351,111113633,XM_022451929.1,uncharacterized LOC111113633,10434
NC_035780.1,58882917,58893352,58882917,58893352,111113633,XM_022451936.1,uncharacterized LOC111113633,10435
NC_035788.1,23821269,23828072,23821269,23828072,111113634,XM_022451926.1,uncharacterized LOC111113634,6803
NC_035788.1,23832431,23835189,23832431,23835189,111113635,XM_022451927.1,uncharacterized LOC111113635,2758
NC_035788.1,24600580,24603130,24600580,24603130,111113644,XM_022451937.1,uncharacterized LOC111113644,2550
NC_035788.1,24788300,24797864,24788300,24797864,111113645,XM_022451938.1,uncharacterized LOC111113645,9564
NC_035788.1,24875326,24887285,24875326,24887285,111113646,XM_022451939.1,uncharacterized LOC111113646,11959
NC_035788.1,25104427,25105310,25104427,25105310,111113648,XM_022451941.1,uncharacterized LOC111113648,883
NC_035788.1,25249393,25252036,25249393,25252036,111113649,XM_022451942.1,uncharacterized LOC111113649,2643
NC_035788.1,25287108,25293846,25287108,25293846,111113651,XM_022451943.1,uncharacterized LOC111113651,6738
NC_035788.1,25569182,25593559,25569182,25593559,111113654,XM_022451946.1,uncharacterized LOC111113654,24377
NC_035788.1,25880444,25882869,25880444,25882869,111113659,XM_022451950.1,uncharacterized LOC111113659,2425
NC_035788.1,26067721,26068618,26067721,26068618,111113660,XM_022451951.1,uncharacterized LOC111113660,897
NC_035788.1,26219911,26486139,26219911,26486139,111113661,XM_022451953.1,uncharacterized LOC111113661,266228
NC_035788.1,26606275,26616159,26606275,26616159,111113662,XM_022451954.1,uncharacterized LOC111113662,9884
NC_035788.1,26743768,26749447,26743768,26749447,111113663,XM_022451955.1,uncharacterized LOC111113663,5679
NC_035788.1,26831196,26832980,26831196,26832980,111113664,XM_022451956.1,uncharacterized LOC111113664,1784
NC_035780.1,64197895,64199845,64197895,64199845,111113666,XM_022451961.1,uncharacterized LOC111113666,1950
NC_035788.1,27196007,27198068,27196007,27198068,111113667,XM_022451958.1,uncharacterized LOC111113667,2061
NC_035788.1,27392514,27396477,27392514,27396477,111113669,XM_022451960.1,uncharacterized LOC111113669,3963
NC_035788.1,27464832,27478363,27464832,27478363,111113670,XM_022451962.1,uncharacterized LOC111113670,13531
NC_035788.1,27507089,27512509,27507089,27512509,111113672,XM_022451964.1,uncharacterized LOC111113672,5420
NC_035788.1,27847684,27852230,27847684,27852230,111113675,XM_022451966.1,uncharacterized LOC111113675,4546
NC_035788.1,27869243,27877050,27869243,27877050,111113676,XM_022451967.1,uncharacterized LOC111113676,7807
NC_035788.1,28606563,28615397,28606563,28615397,111113687,XM_022451977.1,uncharacterized LOC111113687,8834
NC_035788.1,28682622,28688493,28682622,28688493,111113689,XM_022451978.1,uncharacterized LOC111113689,5871
NC_035788.1,28718102,28720673,28718102,28720673,111113690,XM_022451979.1,uncharacterized LOC111113690,2571
NC_035788.1,28945953,28952606,28945953,28952606,111113691,XM_022451980.1,uncharacterized LOC111113691,6653
NC_035788.1,29278197,29279392,29278197,29279392,111113692,XM_022451982.1,uncharacterized LOC111113692,1195
NC_035788.1,29428692,29433433,29428692,29433433,111113694,XM_022451985.1,uncharacterized LOC111113694,4741
NC_035788.1,29474234,29516385,29474234,29516385,111113695,XM_022451986.1,uncharacterized LOC111113695,42151
NC_035788.1,29776403,29779169,29776403,29779169,111113701,XM_022451990.1,uncharacterized LOC111113701,2766
NC_035788.1,30125148,30126263,30125148,30126263,111113703,XM_022451993.1,uncharacterized LOC111113703,1115
NC_035788.1,30596530,30597484,30596530,30597484,111113710,XM_022451999.1,uncharacterized LOC111113710,954
NC_035788.1,30622186,30623671,30622186,30623671,111113711,XM_022452000.1,uncharacterized LOC111113711,1485
NC_035788.1,31047719,31048771,31047719,31048771,111113713,XM_022452003.1,uncharacterized LOC111113713,1052
NC_035788.1,31715402,31716710,31715402,31716710,111113717,XM_022452007.1,uncharacterized LOC111113717,1308
NC_035788.1,31863859,31874986,31863859,31874986,111113718,XM_022452008.1,uncharacterized LOC111113718,11127
NC_035788.1,31992394,31993903,31992394,31993903,111113719,XM_022452009.1,uncharacterized LOC111113719,1509
NC_035788.1,32209776,32214980,32209776,32214980,111113721,XM_022452010.1,uncharacterized LOC111113721,5204
NC_035788.1,32378149,32381741,32378149,32381741,111113725,XM_022452014.1,uncharacterized LOC111113725,3592
NC_035788.1,32428015,32444715,32428015,32444715,111113726,XM_022452015.1,uncharacterized LOC111113726,16700
NC_035788.1,32451864,32455971,32451864,32455971,111113727,XM_022452016.1,uncharacterized LOC111113727,4107
NC_035788.1,32627553,32630523,32627553,32630523,111113730,XM_022452020.1,uncharacterized LOC111113730,2970
NC_035788.1,32633561,32639022,32633561,32639022,111113731,XM_022452021.1,uncharacterized LOC111113731,5461
NC_035788.1,32678375,32681053,32678375,32681053,111113732,XM_022452022.1,uncharacterized LOC111113732,2678
NC_035788.1,32780911,32783807,32780911,32783807,111113734,XM_022452024.1,uncharacterized LOC111113734,2896
NC_035788.1,32808841,32825046,32808841,32825046,111113736,XM_022452026.1,uncharacterized LOC111113736,16205
NC_035788.1,32986249,33003987,32986249,33003987,111113741,XM_022452030.1,uncharacterized LOC111113741,17738
NC_035780.1,7975237,7982162,7975237,7982162,111113745,XM_022452036.1,uncharacterized LOC111113745,6925
NC_035788.1,33271221,33271908,33271221,33271908,111113750,XM_022452038.1,uncharacterized LOC111113750,687
NC_035788.1,33440621,33448308,33440621,33448308,111113752,XM_022452040.1,uncharacterized LOC111113752,7687
NC_035788.1,33453500,33454860,33453500,33454860,111113753,XM_022452041.1,uncharacterized LOC111113753,1360
NC_035788.1,33920133,33922336,33920133,33922336,111113759,XM_022452046.1,uncharacterized LOC111113759,2203
NC_035788.1,34026218,34031461,34026218,34031461,111113764,XM_022452052.1,uncharacterized LOC111113764,5243
NC_035788.1,61992218,62006432,61992218,62006432,111113768,XM_022452056.1,uncharacterized LOC111113768,14214
NC_035788.1,34252543,34254781,34252543,34254781,111113769,XM_022452058.1,uncharacterized LOC111113769,2238
NC_035788.1,34490824,34497430,34490824,34497430,111113772,XM_022452061.1,uncharacterized LOC111113772,6606
NC_035788.1,34520075,34564033,34520075,34564033,111113774,XM_022452064.1,uncharacterized LOC111113774,43958
NC_035788.1,34718044,34725500,34718044,34725500,111113775,XM_022452065.1,uncharacterized LOC111113775,7456
NC_035788.1,34729541,34730465,34729541,34730465,111113776,XM_022452066.1,uncharacterized LOC111113776,924
NC_035788.1,34776852,34801800,34776852,34801800,111113777,XM_022452067.1,uncharacterized LOC111113777,24948
NC_035788.1,35230353,35271231,35230353,35271231,111113780,XM_022452071.1,uncharacterized LOC111113780,40878
NC_035788.1,35300170,35301051,35300170,35301051,111113782,XM_022452073.1,uncharacterized LOC111113782,881
NC_035788.1,35322482,35323141,35322482,35323141,111113783,XM_022452074.1,uncharacterized LOC111113783,659
NC_035788.1,35333156,35334835,35333156,35334835,111113784,XM_022452075.1,uncharacterized LOC111113784,1679
NC_035788.1,35394542,35399279,35394542,35399279,111113785,XM_022452076.1,uncharacterized LOC111113785,4737
NC_035788.1,35425212,35426935,35425212,35426935,111113786,XM_022452077.1,uncharacterized LOC111113786,1723
NC_035788.1,35527135,35534573,35527135,35534573,111113788,XM_022452078.1,uncharacterized LOC111113788,7438
NC_035788.1,35600371,35621097,35600371,35621097,111113790,XM_022452080.1,uncharacterized LOC111113790,20726
NC_035788.1,36069988,36071351,36069988,36071351,111113792,XM_022452083.1,uncharacterized LOC111113792,1363
NC_035788.1,36096243,36098452,36096243,36098452,111113793,XM_022452084.1,uncharacterized LOC111113793,2209
NC_035788.1,36485698,36486814,36485698,36486814,111113799,XM_022452089.1,uncharacterized LOC111113799,1116
NC_035788.1,36679337,36682691,36679337,36682691,111113802,XM_022452093.1,uncharacterized LOC111113802,3354
NC_035788.1,37347185,37349921,37347185,37349921,111113805,XM_022452096.1,uncharacterized LOC111113805,2736
NC_035788.1,37678213,37684196,37678213,37684196,111113810,XM_022452100.1,uncharacterized LOC111113810,5983
NC_035788.1,37923029,37934418,37923029,37934418,111113811,XM_022452101.1,uncharacterized LOC111113811,11389
NC_035788.1,38858438,38862112,38858438,38862112,111113814,XM_022452105.1,uncharacterized LOC111113814,3674
NC_035788.1,38907148,38908329,38907148,38908329,111113816,XM_022452107.1,uncharacterized LOC111113816,1181
NC_035788.1,39039217,39042312,39039217,39042312,111113818,XM_022452109.1,uncharacterized LOC111113818,3095
NC_035788.1,40161410,40163217,40161410,40163217,111113822,XM_022452112.1,uncharacterized LOC111113822,1807
NC_035788.1,40162871,40165829,40162871,40165829,111113823,XM_022452114.1,uncharacterized LOC111113823,2958
NC_035788.1,40412340,40423421,40412340,40423421,111113825,XM_022452116.1,uncharacterized LOC111113825,11081
NC_035788.1,40430625,40432527,40430625,40432527,111113826,XM_022452117.1,uncharacterized LOC111113826,1902
NC_035788.1,40499275,40508578,40499275,40508578,111113827,XM_022452118.1,uncharacterized LOC111113827,9303
NC_035788.1,40879641,40885707,40879641,40885707,111113829,XM_022452121.1,uncharacterized LOC111113829,6066
NC_035788.1,41172289,41208679,41172289,41208679,111113832,XM_022452124.1,uncharacterized LOC111113832,36390
NC_035788.1,41199439,41200074,41199439,41200074,111113834,XM_022452126.1,uncharacterized LOC111113834,635
NC_035788.1,41328509,41329483,41328509,41329483,111113835,XM_022452127.1,uncharacterized LOC111113835,974
NC_035788.1,41442070,41446237,41442070,41446237,111113837,XM_022452129.1,uncharacterized LOC111113837,4167
NC_035788.1,41531890,41535843,41531890,41535843,111113838,XM_022452130.1,uncharacterized LOC111113838,3953
NC_035788.1,41636488,41638072,41636488,41638072,111113839,XM_022452131.1,uncharacterized LOC111113839,1584
NC_035788.1,41682236,41696950,41682236,41696950,111113842,XM_022452133.1,uncharacterized LOC111113842,14714
NC_035788.1,41786842,41788608,41786842,41788608,111113843,XM_022452134.1,uncharacterized LOC111113843,1766
NC_035788.1,42130909,42135217,42130909,42135217,111113846,XM_022452138.1,uncharacterized LOC111113846,4308
NC_035788.1,42321179,42323800,42321179,42323800,111113849,XM_022452141.1,uncharacterized LOC111113849,2621
NC_035780.1,60527557,60535886,60527557,60535886,111113850,XM_022452145.1,uncharacterized LOC111113850,8329
NC_035788.1,42357705,42359324,42357705,42359324,111113851,XM_022452142.1,uncharacterized LOC111113851,1619
NC_035788.1,42363259,42371022,42363259,42371022,111113852,XM_022452143.1,uncharacterized LOC111113852,7763
NC_035788.1,42378176,42379816,42378176,42379816,111113853,XM_022452144.1,uncharacterized LOC111113853,1640
NC_035788.1,42508777,42513870,42508777,42513870,111113854,XM_022452146.1,uncharacterized LOC111113854,5093
NC_035788.1,42820541,42822841,42820541,42822841,111113855,XM_022452147.1,uncharacterized LOC111113855,2300
NC_035788.1,42831752,42832300,42831752,42832300,111113857,XM_022452149.1,uncharacterized LOC111113857,548
NC_035788.1,43055635,43059333,43055635,43059333,111113859,XM_022452151.1,uncharacterized LOC111113859,3698
NC_035788.1,43166267,43170561,43166267,43170561,111113862,XM_022452153.1,uncharacterized LOC111113862,4294
NC_035788.1,43331459,43335168,43331459,43335168,111113863,XM_022452154.1,uncharacterized LOC111113863,3709
NC_035788.1,43598190,43622614,43598190,43622614,111113865,XM_022452157.1,uncharacterized LOC111113865,24424
NC_035788.1,43978030,43983636,43978030,43983636,111113868,XM_022452161.1,uncharacterized LOC111113868,5606
NC_035788.1,44005873,44009288,44005873,44009288,111113869,XM_022452162.1,uncharacterized LOC111113869,3415
NC_035788.1,44030362,44033300,44030362,44033300,111113870,XM_022452163.1,uncharacterized LOC111113870,2938
NC_035788.1,44175797,44179902,44175797,44179902,111113872,XM_022452164.1,uncharacterized LOC111113872,4105
NC_035788.1,44267983,44269186,44267983,44269186,111113873,XM_022452165.1,uncharacterized LOC111113873,1203
NC_035788.1,44288151,44290056,44288151,44290056,111113874,XM_022452166.1,uncharacterized LOC111113874,1905
NC_035788.1,44546255,44555380,44546255,44555380,111113876,XM_022452169.1,uncharacterized LOC111113876,9125
NC_035788.1,44838162,44916853,44838162,44916853,111113880,XM_022452173.1,uncharacterized LOC111113880,78691
NC_035788.1,45139698,45143157,45139698,45143157,111113881,XM_022452175.1,uncharacterized LOC111113881,3459
NC_035788.1,46100251,46102210,46100251,46102210,111113885,XM_022452178.1,uncharacterized LOC111113885,1959
NC_035788.1,46604208,46608650,46604208,46608650,111113889,XM_022452181.1,uncharacterized LOC111113889,4442
NC_035788.1,46706925,46712603,46706925,46712603,111113892,XM_022452184.1,uncharacterized LOC111113892,5678
NC_035788.1,46738178,46740514,46738178,46740514,111113894,XM_022452185.1,uncharacterized LOC111113894,2336
NC_035788.1,47058262,47059893,47058262,47059893,111113895,XM_022452186.1,uncharacterized LOC111113895,1631
NC_035788.1,47601144,47606314,47601144,47606314,111113897,XM_022452188.1,uncharacterized LOC111113897,5170
NC_035788.1,47714775,47715847,47714775,47715847,111113899,XM_022452190.1,uncharacterized LOC111113899,1072
NC_035788.1,48309975,48323833,48309975,48323833,111113900,XM_022452191.1,uncharacterized LOC111113900,13858
NC_035788.1,48367107,48368240,48367107,48368240,111113902,XM_022452192.1,uncharacterized LOC111113902,1133
NC_035788.1,48380933,48390212,48380933,48390212,111113903,XM_022452194.1,uncharacterized LOC111113903,9279
NC_035788.1,48631564,48636117,48631564,48636117,111113905,XM_022452195.1,uncharacterized LOC111113905,4553
NC_035788.1,48635720,48638108,48635720,48638108,111113906,XM_022452196.1,uncharacterized LOC111113906,2388
NC_035788.1,48670440,48679008,48670440,48679008,111113907,XM_022452197.1,uncharacterized LOC111113907,8568
NC_035788.1,48702158,48708386,48702158,48708386,111113908,XM_022452198.1,uncharacterized LOC111113908,6228
NC_035788.1,48730055,48749678,48730055,48749678,111113909,XM_022452200.1,uncharacterized LOC111113909,19623
NC_035788.1,48777336,48780025,48777336,48780025,111113910,XM_022452201.1,uncharacterized LOC111113910,2689
NC_035788.1,48883567,48907046,48883567,48907046,111113911,XM_022452202.1,uncharacterized LOC111113911,23479
NC_035788.1,48919368,48928643,48919368,48928643,111113912,XM_022452203.1,uncharacterized LOC111113912,9275
NC_035788.1,48960515,48967534,48960515,48967534,111113913,XM_022452204.1,uncharacterized LOC111113913,7019
NC_035788.1,48962623,49003397,48962623,49003397,111113914,XM_022452206.1,uncharacterized LOC111113914,40774
NC_035788.1,49051577,49055971,49051577,49055971,111113915,XM_022452207.1,uncharacterized LOC111113915,4394
NC_035788.1,49142546,49165959,49142546,49165959,111113917,XM_022452209.1,uncharacterized LOC111113917,23413
NC_035788.1,49316852,49321603,49316852,49321603,111113918,XM_022452210.1,uncharacterized LOC111113918,4751
NC_035788.1,49321654,49322544,49321654,49322544,111113919,XM_022452211.1,uncharacterized LOC111113919,890
NC_035788.1,49323332,49324812,49323332,49324812,111113920,XM_022452212.1,uncharacterized LOC111113920,1480
NC_035780.1,9377368,9379472,9377368,9379472,111113921,XM_022452216.1,uncharacterized LOC111113921,2104
NC_035788.1,49357571,49361390,49357571,49361390,111113922,XM_022452213.1,uncharacterized LOC111113922,3819
NC_035788.1,49430154,49457438,49430154,49457438,111113923,XM_022452214.1,uncharacterized LOC111113923,27284
NC_035788.1,49508169,49508699,49508169,49508699,111113924,XM_022452215.1,uncharacterized LOC111113924,530
NC_035788.1,49558456,49566339,49558456,49566339,111113925,XM_022452217.1,uncharacterized LOC111113925,7883
NC_035788.1,49722252,49750507,49722252,49750507,111113926,XM_022452218.1,uncharacterized LOC111113926,28255
NC_035788.1,49931589,49933106,49931589,49933106,111113928,XM_022452220.1,uncharacterized LOC111113928,1517
NC_035788.1,50271929,50278022,50271929,50278022,111113930,XM_022452222.1,uncharacterized LOC111113930,6093
NC_035788.1,50384061,50384954,50384061,50384954,111113931,XM_022452223.1,uncharacterized LOC111113931,893
NC_035788.1,50659991,50661813,50659991,50661813,111113932,XM_022452226.1,uncharacterized LOC111113932,1822
NC_035788.1,50850757,50876805,50850757,50876805,111113935,XM_022452229.1,uncharacterized LOC111113935,26048
NC_035788.1,50899222,50903661,50899222,50903661,111113936,XM_022452230.1,uncharacterized LOC111113936,4439
NC_035788.1,50904035,50904700,50904035,50904700,111113937,XM_022452231.1,uncharacterized LOC111113937,665
NC_035788.1,50988672,50992984,50988672,50992984,111113940,XM_022452233.1,uncharacterized LOC111113940,4312
NC_035788.1,52282046,52283487,52282046,52283487,111113941,XM_022452234.1,uncharacterized LOC111113941,1441
NC_035788.1,52432296,52488868,52432296,52488868,111113943,XM_022452237.1,uncharacterized LOC111113943,56572
NC_035788.1,52612852,52616753,52612852,52616753,111113946,XM_022452240.1,uncharacterized LOC111113946,3901
NC_035788.1,52767722,52770133,52767722,52770133,111113947,XM_022452241.1,uncharacterized LOC111113947,2411
NC_035788.1,53484683,53488456,53484683,53488456,111113950,XM_022452242.1,uncharacterized LOC111113950,3773
NC_035788.1,54756105,54760594,54756105,54760594,111113956,XM_022452248.1,uncharacterized LOC111113956,4489
NC_035788.1,54762164,54763351,54762164,54763351,111113957,XM_022452249.1,uncharacterized LOC111113957,1187
NC_035788.1,55094459,55112738,55094459,55112738,111113959,XM_022452250.1,uncharacterized LOC111113959,18279
NC_035788.1,55115361,55119418,55115361,55119418,111113960,XM_022452251.1,uncharacterized LOC111113960,4057
NC_035788.1,55120344,55125483,55120344,55125483,111113961,XM_022452252.1,uncharacterized LOC111113961,5139
NC_035788.1,55284052,55285032,55284052,55285032,111113963,XM_022452255.1,uncharacterized LOC111113963,980
NC_035788.1,55605438,55607218,55605438,55607218,111113964,XM_022452256.1,uncharacterized LOC111113964,1780
NC_035788.1,56229452,56234650,56229452,56234650,111113968,XM_022452260.1,uncharacterized LOC111113968,5198
NC_035780.1,34299580,34306676,34299580,34306676,111113969,XM_022452264.1,uncharacterized LOC111113969,7096
NC_035788.1,57175120,57178186,57175120,57178186,111113981,XM_022452271.1,uncharacterized LOC111113981,3066
NC_035788.1,57315977,57322222,57315977,57322222,111113982,XM_022452272.1,uncharacterized LOC111113982,6245
NC_035788.1,57613646,57620539,57613646,57620539,111113984,XM_022452275.1,uncharacterized LOC111113984,6893
NC_035788.1,57639381,57659956,57639381,57659956,111113986,XM_022452277.1,uncharacterized LOC111113986,20575
NC_035788.1,57676209,57708691,57676209,57708691,111113987,XM_022452278.1,uncharacterized LOC111113987,32482
NC_035788.1,57826975,57829795,57826975,57829795,111113988,XM_022452279.1,uncharacterized LOC111113988,2820
NC_035788.1,58251274,58252137,58251274,58252137,111113993,XM_022452282.1,uncharacterized LOC111113993,863
NC_035788.1,58254121,58254702,58254121,58254702,111113994,XM_022452283.1,uncharacterized LOC111113994,581
NC_035788.1,58265698,58266279,58265698,58266279,111113997,XM_022452287.1,uncharacterized LOC111113997,581
NC_035788.1,58671776,58672643,58671776,58672643,111113998,XM_022452288.1,uncharacterized LOC111113998,867
NC_035788.1,58713476,58723328,58713476,58723328,111113999,XM_022452289.1,uncharacterized LOC111113999,9852
NC_035788.1,58834643,58888797,58834643,58888797,111114000,XM_022452291.1,uncharacterized LOC111114000,54154
NC_035780.1,19052011,19071483,19052011,19071483,111114001,XM_022452294.1,uncharacterized LOC111114001,19472
NC_035788.1,58941354,58942532,58941354,58942532,111114002,XM_022452292.1,uncharacterized LOC111114002,1178
NC_035788.1,58957960,58962918,58957960,58962918,111114003,XM_022452293.1,uncharacterized LOC111114003,4958
NC_035788.1,59120679,59122591,59120679,59122591,111114004,XM_022452295.1,uncharacterized LOC111114004,1912
NC_035788.1,59241778,59244221,59241778,59244221,111114006,XM_022452296.1,uncharacterized LOC111114006,2443
NC_035788.1,59730113,59731683,59730113,59731683,111114007,XM_022452297.1,uncharacterized LOC111114007,1570
NC_035788.1,59770082,59772828,59770082,59772828,111114008,XM_022452298.1,uncharacterized LOC111114008,2746
NC_035788.1,59779091,59780260,59779091,59780260,111114009,XM_022452299.1,uncharacterized LOC111114009,1169
NC_035788.1,59968690,59969766,59968690,59969766,111114010,XM_022452300.1,uncharacterized LOC111114010,1076
NC_035788.1,60235639,60239577,60235639,60239577,111114012,XM_022452301.1,uncharacterized LOC111114012,3938
NC_035788.1,60243126,60244250,60243126,60244250,111114014,XM_022452303.1,uncharacterized LOC111114014,1124
NC_035788.1,60353573,60356712,60353573,60356712,111114017,XM_022452307.1,uncharacterized LOC111114017,3139
NC_035788.1,61158508,61178213,61158508,61178213,111114024,XM_022452313.1,uncharacterized LOC111114024,19705
NC_035788.1,61225019,61226765,61225019,61226765,111114026,XM_022452315.1,uncharacterized LOC111114026,1746
NC_035788.1,61394319,61397758,61394319,61397758,111114028,XM_022452316.1,uncharacterized LOC111114028,3439
NC_035788.1,61514797,61532708,61514797,61532708,111114030,XM_022452318.1,uncharacterized LOC111114030,17911
NC_035788.1,61888848,61890221,61888848,61890221,111114031,XM_022452320.1,uncharacterized LOC111114031,1373
NC_035788.1,61949523,61950422,61949523,61950422,111114032,XM_022452321.1,uncharacterized LOC111114032,899
NC_035788.1,62179260,62191573,62179260,62191573,111114033,XM_022452322.1,uncharacterized LOC111114033,12313
NC_035788.1,62237342,62238436,62237342,62238436,111114034,XM_022452323.1,uncharacterized LOC111114034,1094
NC_035788.1,62821650,62842403,62821650,62842403,111114035,XM_022452324.1,uncharacterized LOC111114035,20753
NC_035788.1,62956447,62960932,62956447,62960932,111114036,XM_022452325.1,uncharacterized LOC111114036,4485
NC_035780.1,29433339,29440834,29433339,29440820,111114037,XM_022452329.1,uncharacterized LOC111114037,7481
NC_035780.1,29433339,29440834,29433339,29440834,111114037,XM_022452336.1,uncharacterized LOC111114037,7495
NC_035788.1,63015331,63017895,63015331,63017895,111114038,XM_022452326.1,uncharacterized LOC111114038,2564
NC_035788.1,63470089,63475468,63470089,63475468,111114040,XM_022452328.1,uncharacterized LOC111114040,5379
NC_035788.1,63760159,63768179,63760159,63768179,111114043,XM_022452332.1,uncharacterized LOC111114043,8020
NC_035788.1,63802611,63804712,63802611,63804712,111114045,XM_022452334.1,uncharacterized LOC111114045,2101
NC_035788.1,64003636,64004869,64003636,64004869,111114047,XM_022452337.1,uncharacterized LOC111114047,1233
NC_035788.1,64383513,64387478,64383513,64387478,111114057,XM_022452347.1,uncharacterized LOC111114057,3965
NC_035788.1,64389369,64391147,64389369,64391147,111114058,XM_022452348.1,uncharacterized LOC111114058,1778
NC_035788.1,64752176,64761921,64752176,64761921,111114060,XM_022452350.1,uncharacterized LOC111114060,9745
NC_035788.1,64886361,64889434,64886361,64889434,111114062,XM_022452352.1,uncharacterized LOC111114062,3073
NC_035780.1,9637204,9642529,9637204,9642529,111114063,XM_022452356.1,uncharacterized LOC111114063,5325
NC_035788.1,65309925,65311046,65309925,65311046,111114069,XM_022452358.1,uncharacterized LOC111114069,1121
NC_035788.1,65313924,65317856,65313924,65317856,111114071,XM_022452360.1,uncharacterized LOC111114071,3932
NC_035788.1,65388854,65397968,65388854,65397968,111114073,XM_022452362.1,uncharacterized LOC111114073,9114
NC_035788.1,65567565,65570563,65567565,65570563,111114074,XM_022452363.1,uncharacterized LOC111114074,2998
NC_035780.1,58308314,58319924,58308324,58319921,111114075,XM_022452371.1,uncharacterized LOC111114075,11597
NC_035780.1,58308314,58319924,58308314,58319921,111114075,XM_022452367.1,uncharacterized LOC111114075,11607
NC_035780.1,58308314,58319924,58308314,58319924,111114075,XM_022452383.1,uncharacterized LOC111114075,11610
NC_035780.1,58308314,58319924,58310728,58319921,111114075,XM_022452375.1,uncharacterized LOC111114075,9193
NC_035788.1,66510790,66518606,66510790,66518606,111114076,XM_022452364.1,uncharacterized LOC111114076,7816
NC_035788.1,66540793,66619889,66540793,66619889,111114077,XM_022452365.1,uncharacterized LOC111114077,79096
NC_035788.1,66644473,66654078,66644473,66654078,111114078,XM_022452366.1,uncharacterized LOC111114078,9605
NC_035788.1,67271523,67274529,67271523,67274529,111114081,XM_022452368.1,uncharacterized LOC111114081,3006
NC_035788.1,67409086,67414134,67409086,67414134,111114084,XM_022452370.1,uncharacterized LOC111114084,5048
NC_035788.1,68010925,68012409,68010925,68012409,111114087,XM_022452373.1,uncharacterized LOC111114087,1484
NC_035788.1,68169690,68172588,68169690,68172588,111114090,XM_022452377.1,uncharacterized LOC111114090,2898
NC_035788.1,68186448,68190906,68186448,68190906,111114092,XM_022452379.1,uncharacterized LOC111114092,4458
NC_035788.1,68403003,68407867,68403003,68407867,111114094,XM_022452381.1,uncharacterized LOC111114094,4864
NC_035788.1,68417221,68419699,68417221,68419699,111114095,XM_022452382.1,uncharacterized LOC111114095,2478
NC_035788.1,69133562,69137074,69133562,69137074,111114101,XM_022452389.1,uncharacterized LOC111114101,3512
NC_035788.1,69323899,69326976,69323899,69326976,111114102,XM_022452390.1,uncharacterized LOC111114102,3077
NC_035788.1,69415326,69433047,69415326,69433047,111114104,XM_022452391.1,uncharacterized LOC111114104,17721
NC_035788.1,69475531,69498907,69475531,69498907,111114105,XM_022452392.1,uncharacterized LOC111114105,23376
NC_035788.1,69679640,69688408,69679640,69688408,111114106,XM_022452393.1,uncharacterized LOC111114106,8768
NC_035788.1,69725244,69736488,69725244,69736488,111114107,XM_022452395.1,uncharacterized LOC111114107,11244
NC_035788.1,70171763,70177472,70171763,70177472,111114112,XM_022452400.1,uncharacterized LOC111114112,5709
NC_035788.1,71785450,71786971,71785450,71786971,111114116,XM_022452405.1,uncharacterized LOC111114116,1521
NC_035788.1,72122176,72122943,72122176,72122943,111114117,XM_022452406.1,uncharacterized LOC111114117,767
NC_035780.1,27438099,27441309,27438099,27441309,111114120,XM_022452410.1,uncharacterized LOC111114120,3210
NC_035788.1,72513004,72521313,72513004,72521313,111114124,XM_022452412.1,uncharacterized LOC111114124,8309
NC_035788.1,72561346,72575052,72561346,72575052,111114125,XM_022452413.1,uncharacterized LOC111114125,13706
NC_035788.1,72740170,72741556,72740170,72741556,111114126,XM_022452414.1,uncharacterized LOC111114126,1386
NC_035788.1,72820929,72821441,72820929,72821441,111114128,XM_022452416.1,uncharacterized LOC111114128,512
NC_035788.1,73268259,73272360,73268259,73272360,111114129,XM_022452418.1,uncharacterized LOC111114129,4101
NC_035788.1,73444411,73444749,73444411,73444749,111114130,XM_022452419.1,uncharacterized LOC111114130,338
NC_035788.1,73462627,73465060,73462627,73465060,111114131,XM_022452420.1,uncharacterized LOC111114131,2433
NC_035788.1,73506247,73506792,73506247,73506792,111114135,XM_022452423.1,uncharacterized LOC111114135,545
NC_035788.1,73565440,73569405,73565440,73569405,111114136,XM_022452424.1,uncharacterized LOC111114136,3965
NC_035788.1,73696248,73714577,73696248,73714577,111114137,XM_022452425.1,uncharacterized LOC111114137,18329
NC_035788.1,73797392,73812833,73797392,73812833,111114138,XM_022452427.1,uncharacterized LOC111114138,15441
NC_035788.1,74248718,74251972,74248718,74251972,111114139,XM_022452428.1,uncharacterized LOC111114139,3254
NC_035788.1,74357850,74369602,74357850,74369602,111114141,XM_022452430.1,uncharacterized LOC111114141,11752
NC_035788.1,74414293,74433470,74414293,74433470,111114142,XM_022452431.1,uncharacterized LOC111114142,19177
NC_035788.1,74834029,74834955,74834029,74834955,111114145,XM_022452434.1,uncharacterized LOC111114145,926
NC_035788.1,74885428,74889393,74885428,74889393,111114147,XM_022452436.1,uncharacterized LOC111114147,3965
NC_035788.1,75349324,75351693,75349324,75351693,111114151,XM_022452441.1,uncharacterized LOC111114151,2369
NC_035788.1,75580414,75583899,75580414,75583899,111114152,XM_022452442.1,uncharacterized LOC111114152,3485
NC_035788.1,75768630,75769757,75768630,75769757,111114153,XM_022452443.1,uncharacterized LOC111114153,1127
NC_035788.1,75942548,75943093,75942548,75943093,111114154,XM_022452445.1,uncharacterized LOC111114154,545
NC_035788.1,75979646,75981894,75979646,75981894,111114156,XM_022452447.1,uncharacterized LOC111114156,2248
NC_035788.1,76079735,76082623,76079735,76082623,111114157,XM_022452448.1,uncharacterized LOC111114157,2888
NC_035788.1,76115541,76121543,76115541,76121543,111114158,XM_022452449.1,uncharacterized LOC111114158,6002
NC_035788.1,76646143,76658601,76646143,76658601,111114162,XM_022452452.1,uncharacterized LOC111114162,12458
NC_035788.1,76660749,76668936,76660749,76668936,111114163,XM_022452453.1,uncharacterized LOC111114163,8187
NC_035788.1,77214325,77219415,77214325,77219415,111114169,XM_022452458.1,uncharacterized LOC111114169,5090
NC_035788.1,77545658,77568734,77545658,77568734,111114170,XM_022452459.1,uncharacterized LOC111114170,23076
NC_035788.1,78030898,78033976,78030898,78033976,111114172,XM_022452460.1,uncharacterized LOC111114172,3078
NC_035788.1,78309640,78339453,78309640,78339453,111114173,XM_022452461.1,uncharacterized LOC111114173,29813
NC_035788.1,79014725,79015483,79014725,79015483,111114175,XM_022452462.1,uncharacterized LOC111114175,758
NC_035788.1,79016505,79026823,79016505,79026823,111114176,XM_022452463.1,uncharacterized LOC111114176,10318
NC_035788.1,79018415,79019379,79018415,79019379,111114177,XM_022452465.1,uncharacterized LOC111114177,964
NC_035788.1,79230104,79230661,79230104,79230661,111114179,XM_022452466.1,uncharacterized LOC111114179,557
NC_035788.1,80195330,80195860,80195330,80195860,111114185,XM_022452471.1,uncharacterized LOC111114185,530
NC_035788.1,80853243,80863834,80853243,80863834,111114187,XM_022452473.1,uncharacterized LOC111114187,10591
NC_035780.1,45625756,45627346,45625756,45627346,111114190,XM_022452479.1,uncharacterized LOC111114190,1590
NC_035788.1,81475842,81480838,81475842,81480838,111114193,XM_022452478.1,uncharacterized LOC111114193,4996
NC_035788.1,81523101,81547515,81523101,81547515,111114195,XM_022452481.1,uncharacterized LOC111114195,24414
NC_035788.1,81905515,81907974,81905515,81907974,111114197,XM_022452483.1,uncharacterized LOC111114197,2459
NC_035788.1,81936674,81944569,81936674,81944569,111114199,XM_022452484.1,uncharacterized LOC111114199,7895
NC_035788.1,82215786,82218554,82215786,82218554,111114202,XM_022452486.1,uncharacterized LOC111114202,2768
NC_035788.1,82444251,82448395,82444251,82448395,111114205,XM_022452490.1,uncharacterized LOC111114205,4144
NC_035788.1,82622820,82624505,82622820,82624505,111114208,XM_022452493.1,uncharacterized LOC111114208,1685
NC_035788.1,82643967,82645628,82643967,82645628,111114209,XM_022452494.1,uncharacterized LOC111114209,1661
NC_035788.1,83005855,83006965,83005855,83006965,111114211,XM_022452496.1,uncharacterized LOC111114211,1110
NC_035788.1,83144431,83144814,83144431,83144814,111114213,XM_022452497.1,uncharacterized LOC111114213,383
NC_035788.1,83183149,83185249,83183149,83185249,111114215,XM_022452499.1,uncharacterized LOC111114215,2100
NC_035788.1,83425489,83426358,83425489,83426358,111114217,XM_022452501.1,uncharacterized LOC111114217,869
NC_035788.1,83792725,83796352,83792725,83796352,111114220,XM_022452504.1,uncharacterized LOC111114220,3627
NC_035788.1,83856489,83907279,83856489,83907279,111114221,XM_022452505.1,uncharacterized LOC111114221,50790
NC_035788.1,84334540,84336225,84334540,84336225,111114224,XM_022452509.1,uncharacterized LOC111114224,1685
NC_035788.1,84354626,84356287,84354626,84356287,111114225,XM_022452510.1,uncharacterized LOC111114225,1661
NC_035788.1,84510939,84533126,84510939,84533126,111114227,XM_022452512.1,uncharacterized LOC111114227,22187
NC_035788.1,84583714,84589298,84583714,84589298,111114228,XM_022452513.1,uncharacterized LOC111114228,5584
NC_035788.1,85425283,85432671,85425283,85432671,111114231,XM_022452514.1,uncharacterized LOC111114231,7388
NC_035788.1,85830797,85836503,85830797,85836503,111114232,XM_022452515.1,uncharacterized LOC111114232,5706
NC_035788.1,85948665,85953941,85948665,85953941,111114234,XM_022452518.1,uncharacterized LOC111114234,5276
NC_035788.1,87057371,87061129,87057371,87061129,111114239,XM_022452523.1,uncharacterized LOC111114239,3758
NC_035788.1,87086499,87088936,87086499,87088936,111114241,XM_022452524.1,uncharacterized LOC111114241,2437
NC_035788.1,87326032,87326670,87326032,87326670,111114243,XM_022452526.1,uncharacterized LOC111114243,638
NC_035788.1,87671879,87673552,87671879,87673552,111114245,XM_022452529.1,uncharacterized LOC111114245,1673
NC_035788.1,87674579,87676372,87674579,87676372,111114246,XM_022452530.1,uncharacterized LOC111114246,1793
NC_035788.1,87782334,87783000,87782334,87783000,111114249,XM_022452533.1,uncharacterized LOC111114249,666
NC_035788.1,88029293,88031152,88029293,88031152,111114251,XM_022452535.1,uncharacterized LOC111114251,1859
NC_035788.1,88127468,88128218,88127468,88128218,111114254,XM_022452539.1,uncharacterized LOC111114254,750
NC_035788.1,88362778,88363986,88362778,88363986,111114256,XM_022452541.1,uncharacterized LOC111114256,1208
NC_035788.1,88394125,88395167,88394125,88395167,111114258,XM_022452543.1,uncharacterized LOC111114258,1042
NC_035788.1,88475879,88480141,88475879,88480141,111114259,XM_022452544.1,uncharacterized LOC111114259,4262
NC_035788.1,88546791,88552344,88546791,88552344,111114260,XM_022452545.1,uncharacterized LOC111114260,5553
NC_035788.1,88582972,88587195,88582972,88587195,111114263,XM_022452547.1,uncharacterized LOC111114263,4223
NC_035788.1,88644002,88657008,88644002,88657008,111114264,XM_022452548.1,uncharacterized LOC111114264,13006
NC_035788.1,88658580,88661694,88658580,88661694,111114265,XM_022452551.1,uncharacterized LOC111114265,3114
NC_035788.1,88720690,88724103,88720690,88724103,111114266,XM_022452552.1,uncharacterized LOC111114266,3413
NC_035788.1,88874068,88877530,88874068,88877530,111114267,XM_022452553.1,uncharacterized LOC111114267,3462
NC_035788.1,88905524,88913807,88905524,88913807,111114269,XM_022452555.1,uncharacterized LOC111114269,8283
NC_035788.1,88927744,88929696,88927744,88929696,111114270,XM_022452556.1,uncharacterized LOC111114270,1952
NC_035788.1,88944443,88947805,88944443,88947805,111114271,XM_022452557.1,uncharacterized LOC111114271,3362
NC_035780.1,24572732,24575372,24572732,24575372,111114272,XM_022452561.1,uncharacterized LOC111114272,2640
NC_035788.1,89235037,89236717,89235037,89236717,111114275,XM_022452560.1,uncharacterized LOC111114275,1680
NC_035788.1,89278708,89281296,89278708,89281296,111114276,XM_022452562.1,uncharacterized LOC111114276,2588
NC_035780.1,14586851,14593533,14586851,14592833,111114283,XM_022452580.1,uncharacterized LOC111114283,5982
NC_035780.1,14586851,14593533,14586851,14593227,111114283,XM_022452608.1,uncharacterized LOC111114283,6376
NC_035780.1,14586851,14593533,14586851,14593482,111114283,XM_022452587.1,uncharacterized LOC111114283,6631
NC_035780.1,14586851,14593533,14586851,14593501,111114283,XM_022452602.1,uncharacterized LOC111114283,6650
NC_035780.1,14586851,14593533,14586851,14593532,111114283,XM_022452572.1,uncharacterized LOC111114283,6681
NC_035780.1,14586851,14593533,14586851,14593533,111114283,XM_022452616.1,uncharacterized LOC111114283,6682
NC_035788.1,89644809,89649532,89644809,89649532,111114284,XM_022452569.1,uncharacterized LOC111114284,4723
NC_035788.1,89981969,89994868,89981969,89994868,111114286,XM_022452571.1,uncharacterized LOC111114286,12899
NC_035788.1,90001865,90007282,90001865,90007282,111114287,XM_022452573.1,uncharacterized LOC111114287,5417
NC_035788.1,90074635,90084775,90074635,90084775,111114288,XM_022452574.1,uncharacterized LOC111114288,10140
NC_035788.1,90099207,90100174,90099207,90100174,111114289,XM_022452575.1,uncharacterized LOC111114289,967
NC_035788.1,90155681,90160867,90155681,90160867,111114291,XM_022452577.1,uncharacterized LOC111114291,5186
NC_035788.1,90375561,90380346,90375561,90380346,111114292,XM_022452578.1,uncharacterized LOC111114292,4785
NC_035788.1,90444848,90476791,90444848,90476791,111114293,XM_022452579.1,uncharacterized LOC111114293,31943
NC_035788.1,91044526,91047216,91044526,91047216,111114296,XM_022452583.1,uncharacterized LOC111114296,2690
NC_035788.1,91101247,91101951,91101247,91101951,111114298,XM_022452585.1,uncharacterized LOC111114298,704
NC_035788.1,91198747,91201827,91198747,91201827,111114299,XM_022452586.1,uncharacterized LOC111114299,3080
NC_035788.1,91231027,91233785,91231027,91233785,111114300,XM_022452588.1,uncharacterized LOC111114300,2758
NC_035788.1,91595250,91680736,91595250,91680736,111114305,XM_022452592.1,uncharacterized LOC111114305,85486
NC_035788.1,91699194,91702628,91699194,91702628,111114306,XM_022452593.1,uncharacterized LOC111114306,3434
NC_035788.1,91717185,91724261,91717185,91724261,111114307,XM_022452595.1,uncharacterized LOC111114307,7076
NC_035788.1,91993780,91997558,91993780,91997558,111114308,XM_022452596.1,uncharacterized LOC111114308,3778
NC_035788.1,92006715,92007131,92006715,92007131,111114310,XM_022452598.1,uncharacterized LOC111114310,416
NC_035788.1,92011709,92014918,92011709,92014918,111114311,XM_022452599.1,uncharacterized LOC111114311,3209
NC_035788.1,92177994,92186657,92177994,92186657,111114316,XM_022452605.1,uncharacterized LOC111114316,8663
NC_035788.1,92346718,92348052,92346718,92348052,111114317,XM_022452606.1,uncharacterized LOC111114317,1334
NC_035788.1,92357163,92358481,92357163,92358481,111114318,XM_022452607.1,uncharacterized LOC111114318,1318
NC_035788.1,92492967,92493760,92492967,92493760,111114320,XM_022452610.1,uncharacterized LOC111114320,793
NC_035788.1,92534613,92549918,92534613,92549918,111114321,XM_022452611.1,uncharacterized LOC111114321,15305
NC_035788.1,92649195,92651288,92649195,92651288,111114322,XM_022452612.1,uncharacterized LOC111114322,2093
NC_035788.1,92813022,92814313,92813022,92814313,111114323,XM_022452613.1,uncharacterized LOC111114323,1291
NC_035788.1,93189815,93206241,93189815,93206241,111114325,XM_022452615.1,uncharacterized LOC111114325,16426
NC_035788.1,93283207,93288849,93283207,93288849,111114326,XM_022452617.1,uncharacterized LOC111114326,5642
NC_035788.1,93409804,93412681,93409804,93412681,111114329,XM_022452620.1,uncharacterized LOC111114329,2877
NC_035780.1,36669662,36686546,36669662,36686546,111114332,XM_022452625.1,uncharacterized LOC111114332,16884
NC_035788.1,93504782,93528858,93504782,93528858,111114333,XM_022452622.1,uncharacterized LOC111114333,24076
NC_035788.1,93553702,93555043,93553702,93555043,111114334,XM_022452623.1,uncharacterized LOC111114334,1341
NC_035788.1,93793883,93797051,93793883,93797051,111114335,XM_022452624.1,uncharacterized LOC111114335,3168
NC_035788.1,93877738,93879252,93877738,93879252,111114336,XM_022452626.1,uncharacterized LOC111114336,1514
NC_035788.1,93879795,93880732,93879795,93880732,111114337,XM_022452627.1,uncharacterized LOC111114337,937
NC_035788.1,94669294,94670313,94669294,94670313,111114338,XM_022452628.1,uncharacterized LOC111114338,1019
NC_035780.1,884611,885996,884611,885996,111114340,XM_022452633.1,uncharacterized LOC111114340,1385
NC_035788.1,94797489,94807896,94797489,94807896,111114343,XM_022452632.1,uncharacterized LOC111114343,10407
NC_035788.1,94894392,94904303,94894392,94904303,111114344,XM_022452634.1,uncharacterized LOC111114344,9911
NC_035788.1,76712368,76723966,76712368,76723439,111114346,XM_022452638.1,uncharacterized LOC111114346,11071
NC_035788.1,76712368,76723966,76712368,76723440,111114346,XM_022452636.1,uncharacterized LOC111114346,11072
NC_035788.1,76712368,76723966,76712368,76723966,111114346,XM_022452637.1,uncharacterized LOC111114346,11598
NC_035788.1,94971183,94978811,94971183,94978811,111114349,XM_022452639.1,uncharacterized LOC111114349,7628
NC_035788.1,95166607,95171750,95166607,95171750,111114350,XM_022452641.1,uncharacterized LOC111114350,5143
NC_035788.1,95239677,95241817,95239677,95241817,111114351,XM_022452642.1,uncharacterized LOC111114351,2140
NC_035788.1,95254707,95255312,95254707,95255312,111114352,XM_022452643.1,uncharacterized LOC111114352,605
NC_035788.1,95789591,95791188,95789591,95791188,111114355,XM_022452647.1,uncharacterized LOC111114355,1597
NC_035788.1,95792564,95794084,95792564,95794084,111114356,XM_022452648.1,uncharacterized LOC111114356,1520
NC_035788.1,95839504,95843616,95839504,95843616,111114357,XM_022452650.1,uncharacterized LOC111114357,4112
NC_035788.1,95894310,95902612,95894310,95902612,111114358,XM_022452651.1,uncharacterized LOC111114358,8302
NC_035788.1,95907371,95923861,95907371,95923861,111114359,XM_022452652.1,uncharacterized LOC111114359,16490
NC_035780.1,53843929,53846535,53843929,53846535,111114360,XM_022452656.1,uncharacterized LOC111114360,2606
NC_035788.1,95968947,95976628,95968947,95976628,111114361,XM_022452653.1,uncharacterized LOC111114361,7681
NC_035788.1,96445092,96449536,96445092,96449536,111114362,XM_022452654.1,uncharacterized LOC111114362,4444
NC_035788.1,96496916,96499416,96496916,96499416,111114363,XM_022452655.1,uncharacterized LOC111114363,2500
NC_035788.1,96662405,96668355,96662405,96668355,111114364,XM_022452657.1,uncharacterized LOC111114364,5950
NC_035788.1,96876772,96882635,96876772,96882635,111114366,XM_022452659.1,uncharacterized LOC111114366,5863
NC_035788.1,97001192,97005614,97001192,97005614,111114367,XM_022452660.1,uncharacterized LOC111114367,4422
NC_035788.1,97308255,97314029,97308255,97314029,111114368,XM_022452661.1,uncharacterized LOC111114368,5774
NC_035788.1,97314030,97321996,97314030,97321996,111114369,XM_022452662.1,uncharacterized LOC111114369,7966
NC_035788.1,97390416,97391558,97390416,97391558,111114371,XM_022452664.1,uncharacterized LOC111114371,1142
NC_035788.1,97786356,97790444,97786356,97790444,111114377,XM_022452670.1,uncharacterized LOC111114377,4088
NC_035788.1,97795664,97850914,97795664,97850914,111114378,XM_022452671.1,uncharacterized LOC111114378,55250
NC_035780.1,17553618,17572102,17553618,17572102,111114379,XM_022452675.1,uncharacterized LOC111114379,18484
NC_035788.1,98003273,98023269,98003273,98023269,111114381,XM_022452673.1,uncharacterized LOC111114381,19996
NC_035788.1,98651526,98661797,98651526,98661797,111114384,XM_022452677.1,uncharacterized LOC111114384,10271
NC_035788.1,98933391,98937017,98933391,98937017,111114388,XM_022452681.1,uncharacterized LOC111114388,3626
NC_035788.1,98967958,98969762,98967958,98969762,111114389,XM_022452682.1,uncharacterized LOC111114389,1804
NC_035788.1,98975907,98982534,98975907,98982534,111114390,XM_022452684.1,uncharacterized LOC111114390,6627
NC_035788.1,99203146,99206070,99203146,99206070,111114394,XM_022452688.1,uncharacterized LOC111114394,2924
NC_035788.1,100233807,100250394,100233807,100250394,111114395,XM_022452689.1,uncharacterized LOC111114395,16587
NC_035780.1,45341444,45344720,45341444,45344720,111114397,XM_022452693.1,uncharacterized LOC111114397,3276
NC_035788.1,100476024,100482239,100476024,100482239,111114398,XM_022452691.1,uncharacterized LOC111114398,6215
NC_035788.1,100576395,100581556,100576395,100581556,111114399,XM_022452692.1,uncharacterized LOC111114399,5161
NC_035788.1,100977053,100979990,100977053,100979990,111114403,XM_022452697.1,uncharacterized LOC111114403,2937
NC_035780.1,20552608,20563449,20552608,20563449,111114407,XM_022452703.1,uncharacterized LOC111114407,10841
NC_035788.1,101647992,101658810,101647992,101658810,111114423,XM_022452714.1,uncharacterized LOC111114423,10818
NC_035788.1,101735009,101805612,101735009,101805612,111114424,XM_022452715.1,uncharacterized LOC111114424,70603
NC_035788.1,101998036,102000987,101998036,102000987,111114428,XM_022452718.1,uncharacterized LOC111114428,2951
NC_035788.1,102038826,102045196,102038826,102045196,111114429,XM_022452719.1,uncharacterized LOC111114429,6370
NC_035788.1,102048363,102049619,102048363,102049619,111114431,XM_022452720.1,uncharacterized LOC111114431,1256
NC_035788.1,102182160,102185474,102182160,102185474,111114435,XM_022452725.1,uncharacterized LOC111114435,3314
NC_035788.1,102400046,102402136,102400046,102402136,111114436,XM_022452726.1,uncharacterized LOC111114436,2090
NC_035788.1,102887849,102911485,102887849,102911485,111114437,XM_022452727.1,uncharacterized LOC111114437,23636
NC_035788.1,103062511,103065308,103062511,103065308,111114438,XM_022452728.1,uncharacterized LOC111114438,2797
NC_035788.1,103091367,103091977,103091367,103091977,111114439,XM_022452729.1,uncharacterized LOC111114439,610
NC_035788.1,103645661,103658991,103645661,103658991,111114442,XM_022452731.1,uncharacterized LOC111114442,13330
NC_035788.1,103780531,103782266,103780531,103782266,111114443,XM_022452732.1,uncharacterized LOC111114443,1735
NC_035788.1,78376533,78380131,78376533,78380131,111114452,XM_022452748.1,uncharacterized LOC111114452,3598
NC_035788.1,78368690,78372477,78368690,78370965,111114453,XM_022452749.1,uncharacterized LOC111114453,2275
NC_035788.1,70685753,70689367,70685753,70689367,111114458,XM_022452760.1,uncharacterized LOC111114458,3614
NC_035788.1,17259573,17261823,17259573,17261823,111114465,XM_022452771.1,uncharacterized LOC111114465,2250
NC_035788.1,17261939,17264109,17261939,17264109,111114466,XM_022452772.1,uncharacterized LOC111114466,2170
NC_035788.1,103760598,103775366,103760598,103775356,111114467,XM_022452774.1,uncharacterized LOC111114467,14758
NC_035788.1,103760598,103775366,103760598,103775366,111114467,XM_022452776.1,uncharacterized LOC111114467,14768
NC_035788.1,103755607,103758399,103755607,103758399,111114468,XM_022452777.1,uncharacterized LOC111114468,2792
NC_035788.1,103750625,103753416,103750625,103753416,111114470,XM_022452779.1,uncharacterized LOC111114470,2791
NC_035788.1,36231505,36247929,36231505,36247929,111114478,XM_022452791.1,uncharacterized LOC111114478,16424
NC_035788.1,51267389,51290519,51268606,51290519,111114482,XM_022452796.1,uncharacterized LOC111114482,21913
NC_035788.1,51267389,51290519,51267389,51290519,111114482,XM_022452797.1,uncharacterized LOC111114482,23130
NC_035788.1,51290946,51302414,51290946,51302414,111114483,XM_022452798.1,uncharacterized LOC111114483,11468
NC_035788.1,71985290,72029113,71985290,72029113,111114484,XM_022452799.1,uncharacterized LOC111114484,43823
NC_035788.1,58580750,58645524,58580750,58618769,111114492,XM_022452816.1,uncharacterized LOC111114492,38019
NC_035788.1,58580750,58645524,58580750,58645524,111114492,XM_022452814.1,uncharacterized LOC111114492,64774
NC_035788.1,226156,233542,226156,233542,111114494,XM_022452817.1,uncharacterized LOC111114494,7386
NC_035788.1,207765,244133,211017,244133,111114495,XM_022452822.1,uncharacterized LOC111114495,33116
NC_035788.1,207765,244133,211016,244133,111114495,XM_022452821.1,uncharacterized LOC111114495,33117
NC_035788.1,207765,244133,207779,244133,111114495,XM_022452823.1,uncharacterized LOC111114495,36354
NC_035788.1,207765,244133,207766,244133,111114495,XM_022452818.1,uncharacterized LOC111114495,36367
NC_035788.1,207765,244133,207765,244133,111114495,XM_022452820.1,uncharacterized LOC111114495,36368
NC_035788.1,28032741,28084274,28032741,28084274,111114503,XM_022452837.1,uncharacterized LOC111114503,51533
NC_035788.1,27712324,27743110,27712324,27739760,111114505,XM_022452839.1,uncharacterized LOC111114505,27436
NC_035788.1,27712324,27743110,27712324,27743110,111114505,XM_022452838.1,uncharacterized LOC111114505,30786
NC_035788.1,28054805,28059071,28054805,28059071,111114507,XM_022452842.1,uncharacterized LOC111114507,4266
NC_035788.1,28016822,28025969,28016822,28025969,111114508,XM_022452843.1,uncharacterized LOC111114508,9147
NC_035780.1,7862439,7869860,7862439,7869825,111114510,XM_022452855.1,uncharacterized LOC111114510,7386
NC_035780.1,7862439,7869860,7862439,7869860,111114510,XM_022452848.1,uncharacterized LOC111114510,7421
NC_035788.1,27961230,27963718,27961230,27963718,111114511,XM_022452845.1,uncharacterized LOC111114511,2488
NC_035788.1,27992095,28005643,27992095,28005643,111114512,XM_022452846.1,uncharacterized LOC111114512,13548
NC_035788.1,27967218,27984179,27967263,27984179,111114513,XM_022452849.1,uncharacterized LOC111114513,16916
NC_035788.1,27967218,27984179,27967218,27984179,111114513,XM_022452847.1,uncharacterized LOC111114513,16961
NC_035788.1,95118707,95127973,95118707,95127813,111114515,XM_022452850.1,uncharacterized LOC111114515,9106
NC_035788.1,95118707,95127973,95118707,95127973,111114515,XM_022452851.1,uncharacterized LOC111114515,9266
NC_035788.1,95109964,95151596,95109964,95151596,111114516,XM_022452852.1,uncharacterized LOC111114516,41632
NC_035788.1,95181191,95195231,95181191,95195231,111114517,XM_022452853.1,uncharacterized LOC111114517,14040
NC_035788.1,90338615,90341523,90338624,90341523,111114521,XM_022452860.1,uncharacterized LOC111114521,2899
NC_035788.1,90338615,90341523,90338615,90341523,111114521,XM_022452861.1,uncharacterized LOC111114521,2908
NC_035788.1,90364111,90366974,90364111,90366974,111114522,XM_022452862.1,uncharacterized LOC111114522,2863
NC_035788.1,90351098,90353640,90351098,90353640,111114523,XM_022452863.1,uncharacterized LOC111114523,2542
NC_035780.1,57228095,57231088,57228095,57231088,111114524,XM_022452867.1,uncharacterized LOC111114524,2993
NC_035788.1,90366974,90369904,90366974,90369904,111114525,XM_022452864.1,uncharacterized LOC111114525,2930
NC_035788.1,24714884,24719918,24714884,24719918,111114528,XM_022452870.1,uncharacterized LOC111114528,5034
NC_035788.1,62944838,62946652,62944838,62946652,111114529,XM_022452871.1,uncharacterized LOC111114529,1814
NC_035788.1,18880655,18886047,18880655,18886037,111114531,XM_022452873.1,uncharacterized LOC111114531,5382
NC_035788.1,18880655,18886047,18880656,18886047,111114531,XM_022452874.1,uncharacterized LOC111114531,5391
NC_035780.1,8308657,8310945,8308657,8310945,111114533,XM_022452879.1,uncharacterized LOC111114533,2288
NC_035788.1,60704729,60720771,60704729,60720771,111114534,XM_022452877.1,uncharacterized LOC111114534,16042
NC_035788.1,60704729,60720771,60704729,60709629,111114534,XM_022452876.1,uncharacterized LOC111114534,4900
NC_035788.1,40649548,40691083,40649548,40667480,111114535,XM_022452880.1,uncharacterized LOC111114535,17932
NC_035788.1,40649548,40691083,40649548,40668792,111114535,XM_022452878.1,uncharacterized LOC111114535,19244
NC_035788.1,40649548,40691083,40649548,40691083,111114535,XM_022452881.1,uncharacterized LOC111114535,41535
NC_035788.1,59253443,59274112,59253443,59274112,111114539,XM_022452886.1,uncharacterized LOC111114539,20669
NC_035788.1,59144627,59147864,59144627,59147864,111114540,XM_022452887.1,uncharacterized LOC111114540,3237
NC_035788.1,59165359,59168545,59165359,59168545,111114542,XM_022452888.1,uncharacterized LOC111114542,3186
NC_035788.1,59190483,59192746,59190483,59192746,111114543,XM_022452889.1,uncharacterized LOC111114543,2263
NC_035788.1,59402760,59444923,59402760,59444923,111114544,XM_022452890.1,uncharacterized LOC111114544,42163
NC_035788.1,59362743,59386721,59368475,59386721,111114549,XM_022452900.1,uncharacterized LOC111114549,18246
NC_035788.1,59362743,59386721,59362951,59386721,111114549,XM_022452901.1,uncharacterized LOC111114549,23770
NC_035788.1,59362743,59386721,59362743,59386721,111114549,XM_022452899.1,uncharacterized LOC111114549,23978
NC_035780.1,9080279,9090126,9080279,9090126,111114550,XM_022452904.1,uncharacterized LOC111114550,9847
NC_035788.1,59227998,59230492,59227998,59230492,111114551,XM_022452902.1,uncharacterized LOC111114551,2494
NC_035788.1,59213792,59216222,59213792,59216216,111114553,XM_022452906.1,uncharacterized LOC111114553,2424
NC_035788.1,59213792,59216222,59213792,59216222,111114553,XM_022452905.1,uncharacterized LOC111114553,2430
NC_035788.1,59126725,59128096,59126725,59128096,111114556,XM_022452918.1,uncharacterized LOC111114556,1371
NC_035788.1,59282048,59285142,59282048,59285142,111114557,XM_022452919.1,uncharacterized LOC111114557,3094
NC_035788.1,59256611,59258608,59256611,59258608,111114562,XM_022452924.1,uncharacterized LOC111114562,1997
NC_035788.1,42970182,43041711,42970182,43041711,111114568,XM_022452932.1,uncharacterized LOC111114568,71529
NC_035788.1,42956105,42960679,42956105,42960679,111114570,XM_022452933.1,uncharacterized LOC111114570,4574
NC_035788.1,43090341,43095054,43090341,43095054,111114571,XM_022452934.1,uncharacterized LOC111114571,4713
NC_035788.1,77650149,77655279,77650149,77655279,111114573,XM_022452936.1,uncharacterized LOC111114573,5130
NC_035788.1,57206529,57211212,57206529,57211212,111114575,XM_022452938.1,uncharacterized LOC111114575,4683
NC_035788.1,57193579,57198138,57193579,57198138,111114577,XM_022452940.1,uncharacterized LOC111114577,4559
NC_035780.1,61385291,61389798,61385291,61389798,111114580,XM_022452946.1,uncharacterized LOC111114580,4507
NC_035788.1,17096352,17098684,17096352,17098427,111114581,XM_022452944.1,uncharacterized LOC111114581,2075
NC_035788.1,17096352,17098684,17096353,17098684,111114581,XM_022452943.1,uncharacterized LOC111114581,2331
NC_035788.1,74446245,74453848,74446245,74453848,111114584,XM_022452950.1,uncharacterized LOC111114584,7603
NC_035788.1,78532074,78535529,78532074,78535529,111114589,XM_022452959.1,uncharacterized LOC111114589,3455
NC_035788.1,53549916,53561597,53549916,53561537,111114601,XM_022452981.1,uncharacterized LOC111114601,11621
NC_035788.1,53549916,53561597,53549916,53561586,111114601,XM_022452980.1,uncharacterized LOC111114601,11670
NC_035788.1,53549916,53561597,53549916,53561597,111114601,XM_022452979.1,uncharacterized LOC111114601,11681
NC_035788.1,67504525,67513474,67504525,67513474,111114602,XM_022452982.1,uncharacterized LOC111114602,8949
NC_035788.1,65424133,65472338,65424730,65467623,111114603,XM_022452986.1,uncharacterized LOC111114603,42893
NC_035788.1,65424133,65472338,65424730,65472338,111114603,XM_022452983.1,uncharacterized LOC111114603,47608
NC_035788.1,65424133,65472338,65424133,65472338,111114603,XM_022452984.1,uncharacterized LOC111114603,48205
NC_035788.1,91802737,91804711,91802737,91804711,111114605,XM_022452987.1,uncharacterized LOC111114605,1974
NC_035788.1,26767145,26776130,26767145,26776130,111114612,XM_022452993.1,uncharacterized LOC111114612,8985
NC_035788.1,66331123,66335502,66333699,66335502,111114615,XM_022452997.1,uncharacterized LOC111114615,1803
NC_035788.1,21941274,21945620,21941274,21945620,111114618,XM_022453004.1,uncharacterized LOC111114618,4346
NC_035788.1,78571310,78572745,78571310,78572745,111114619,XM_022453006.1,uncharacterized LOC111114619,1435
NC_035788.1,103047087,103051149,103047087,103051149,111114622,XM_022453012.1,uncharacterized LOC111114622,4062
NC_035788.1,87797098,87798466,87797098,87798466,111114623,XM_022453013.1,uncharacterized LOC111114623,1368
NC_035788.1,87803045,87809051,87803045,87809051,111114624,XM_022453014.1,uncharacterized LOC111114624,6006
NC_035788.1,78708243,78719586,78708243,78719586,111114626,XM_022453016.1,uncharacterized LOC111114626,11343
NC_035788.1,21779935,21782338,21779935,21782334,111114633,XM_022453025.1,uncharacterized LOC111114633,2399
NC_035788.1,21779935,21782338,21779935,21782336,111114633,XM_022453022.1,uncharacterized LOC111114633,2401
NC_035788.1,21779935,21782338,21779935,21782337,111114633,XM_022453023.1,uncharacterized LOC111114633,2402
NC_035788.1,21779935,21782338,21779935,21782338,111114633,XM_022453024.1,uncharacterized LOC111114633,2403
NC_035788.1,21774963,21779445,21774963,21779445,111114634,XM_022453026.1,uncharacterized LOC111114634,4482
NC_035788.1,21783178,21786301,21783178,21786301,111114635,XM_022453027.1,uncharacterized LOC111114635,3123
NC_035788.1,91576616,91588197,91576616,91588197,111114637,XM_022453028.1,uncharacterized LOC111114637,11581
NC_035788.1,5811542,5842463,5811542,5842463,111114638,XM_022453029.1,uncharacterized LOC111114638,30921
NC_035788.1,5828781,5830629,5828781,5830629,111114639,XM_022453030.1,uncharacterized LOC111114639,1848
NC_035788.1,70690638,70697633,70690638,70697633,111114642,XM_022453032.1,uncharacterized LOC111114642,6995
NC_035788.1,103800209,103867096,103807164,103860556,111114647,XM_022453049.1,uncharacterized LOC111114647,53392
NC_035788.1,103800209,103867096,103807164,103867096,111114647,XM_022453045.1,uncharacterized LOC111114647,59932
NC_035788.1,103800209,103867096,103800209,103867096,111114647,XM_022453046.1,uncharacterized LOC111114647,66887
NC_035780.1,17687775,17692146,17687775,17692146,111114648,XM_022453053.1,uncharacterized LOC111114648,4371
NC_035788.1,103932823,103937169,103932823,103937169,111114649,XM_022453050.1,uncharacterized LOC111114649,4346
NC_035788.1,66141771,66159296,66141771,66159296,111114656,XM_022453059.1,uncharacterized LOC111114656,17525
NC_035780.1,24796957,24801330,24796957,24798980,111114657,XM_022453073.1,uncharacterized LOC111114657,2023
NC_035780.1,24796957,24801330,24796963,24801330,111114657,XM_022453064.1,uncharacterized LOC111114657,4367
NC_035788.1,15405208,15413198,15405208,15413198,111114662,XM_022453067.1,uncharacterized LOC111114662,7990
NC_035788.1,24386512,24405750,24386517,24405750,111114665,XM_022453070.1,uncharacterized LOC111114665,19233
NC_035788.1,24386512,24405750,24386512,24405749,111114665,XM_022453071.1,uncharacterized LOC111114665,19237
NC_035788.1,90813178,90844845,90813184,90825072,111114669,XM_022453080.1,uncharacterized LOC111114669,11888
NC_035788.1,90813178,90844845,90813184,90844845,111114669,XM_022453083.1,uncharacterized LOC111114669,31661
NC_035788.1,90813178,90844845,90813184,90817280,111114669,XM_022453082.1,uncharacterized LOC111114669,4096
NC_035788.1,90813178,90844845,90813184,90817396,111114669,XM_022453079.1,uncharacterized LOC111114669,4212
NC_035788.1,90813178,90844845,90813178,90818963,111114669,XM_022453081.1,uncharacterized LOC111114669,5785
NC_035788.1,18218951,18222416,18218951,18222416,111114671,XM_022453084.1,uncharacterized LOC111114671,3465
NC_035788.1,56059823,56067188,56059823,56067188,111114672,XM_022453086.1,uncharacterized LOC111114672,7365
NC_035788.1,56067335,56096128,56067335,56078788,111114673,XM_022453087.1,uncharacterized LOC111114673,11453
NC_035788.1,56067335,56096128,56067335,56090408,111114673,XM_022453090.1,uncharacterized LOC111114673,23073
NC_035788.1,56067335,56096128,56067335,56091336,111114673,XM_022453089.1,uncharacterized LOC111114673,24001
NC_035788.1,56067335,56096128,56067335,56096128,111114673,XM_022453088.1,uncharacterized LOC111114673,28793
NC_035780.1,23355088,23357009,23355088,23357009,111114677,XM_022453098.1,uncharacterized LOC111114677,1921
NC_035788.1,48095507,48123159,48095507,48123159,111114682,XM_022453103.1,uncharacterized LOC111114682,27652
NC_035788.1,48095507,48123159,48095507,48103032,111114682,XM_022453102.1,uncharacterized LOC111114682,7525
NC_035788.1,48108111,48120406,48108128,48120406,111114683,XM_022453105.1,uncharacterized LOC111114683,12278
NC_035788.1,48108111,48120406,48108111,48110771,111114683,XM_022453104.1,uncharacterized LOC111114683,2660
NC_035788.1,48110369,48115193,48111242,48115193,111114685,XM_022453106.1,uncharacterized LOC111114685,3951
NC_035788.1,48110369,48115193,48110369,48115193,111114685,XM_022453107.1,uncharacterized LOC111114685,4824
NC_035788.1,48119755,48120572,48119755,48120572,111114686,XM_022453108.1,uncharacterized LOC111114686,817
NC_035780.1,24954981,24956486,24954981,24956486,111114693,XM_022453121.1,uncharacterized LOC111114693,1505
NC_035788.1,84780354,84785110,84780354,84785110,111114697,XM_022453123.1,uncharacterized LOC111114697,4756
NC_035788.1,30296055,30305806,30296055,30305801,111114700,XM_022453127.1,uncharacterized LOC111114700,9746
NC_035788.1,30296055,30305806,30296055,30305806,111114700,XM_022453128.1,uncharacterized LOC111114700,9751
NC_035788.1,82937024,82940724,82937024,82940724,111114703,XM_022453130.1,uncharacterized LOC111114703,3700
NC_035788.1,69526432,69529350,69526432,69529350,111114704,XM_022453131.1,uncharacterized LOC111114704,2918
NC_035788.1,83381467,83386008,83381467,83386008,111114707,XM_022453137.1,uncharacterized LOC111114707,4541
NC_035788.1,35914978,35930875,35914978,35929056,111114711,XM_022453145.1,uncharacterized LOC111114711,14078
NC_035788.1,35914978,35930875,35914978,35930875,111114711,XM_022453146.1,uncharacterized LOC111114711,15897
NC_035788.1,26855481,26866241,26855481,26866241,111114714,XM_022453150.1,uncharacterized LOC111114714,10760
NC_035788.1,26855481,26866241,26857875,26866241,111114714,XM_022453148.1,uncharacterized LOC111114714,8366
NC_035788.1,26855481,26866241,26857373,26866241,111114714,XM_022453149.1,uncharacterized LOC111114714,8868
NC_035788.1,26855481,26866241,26857365,26866241,111114714,XM_022453151.1,uncharacterized LOC111114714,8876
NC_035788.1,26851686,26855341,26851686,26855341,111114716,XM_022453152.1,uncharacterized LOC111114716,3655
NC_035788.1,26855808,26857454,26855808,26857454,111114717,XM_022453154.1,uncharacterized LOC111114717,1646
NC_035788.1,36854065,36863242,36854065,36863242,111114720,XM_022453157.1,uncharacterized LOC111114720,9177
NC_035788.1,12149998,12193946,12149998,12193946,111114722,XM_022453165.1,uncharacterized LOC111114722,43948
NC_035788.1,12940269,12946884,12940269,12946884,111114728,XM_022453178.1,uncharacterized LOC111114728,6615
NC_035788.1,12829042,12834459,12829042,12834459,111114729,XM_022453179.1,uncharacterized LOC111114729,5417
NC_035788.1,12305299,12320938,12305299,12320938,111114733,XM_022453189.1,uncharacterized LOC111114733,15639
NC_035788.1,13044922,13047440,13044922,13047440,111114735,XM_022453190.1,uncharacterized LOC111114735,2518
NC_035788.1,12999374,13001856,12999374,13001856,111114736,XM_022453192.1,uncharacterized LOC111114736,2482
NC_035788.1,12878600,12881227,12878600,12881227,111114737,XM_022453194.1,uncharacterized LOC111114737,2627
NC_035788.1,12961312,12965764,12961312,12965764,111114738,XM_022453195.1,uncharacterized LOC111114738,4452
NC_035788.1,12919931,12924296,12921582,12924296,111114739,XM_022453196.1,uncharacterized LOC111114739,2714
NC_035788.1,12919931,12924296,12919931,12924296,111114739,XM_022453197.1,uncharacterized LOC111114739,4365
NC_035788.1,12871303,12873530,12871303,12873530,111114741,XM_022453202.1,uncharacterized LOC111114741,2227
NC_035788.1,12577547,12580095,12577547,12580095,111114742,XM_022453203.1,uncharacterized LOC111114742,2548
NC_035788.1,12445352,12453474,12445352,12453474,111114746,XM_022453206.1,uncharacterized LOC111114746,8122
NC_035788.1,12553045,12566485,12554445,12566471,111114747,XM_022453208.1,uncharacterized LOC111114747,12026
NC_035788.1,12553045,12566485,12553045,12566470,111114747,XM_022453209.1,uncharacterized LOC111114747,13425
NC_035788.1,12627055,12636166,12627055,12636166,111114748,XM_022453210.1,uncharacterized LOC111114748,9111
NC_035788.1,12434997,12437946,12434997,12437946,111114751,XM_022453213.1,uncharacterized LOC111114751,2949
NC_035788.1,12367733,12370806,12367733,12370806,111114752,XM_022453214.1,uncharacterized LOC111114752,3073
NC_035788.1,12638370,12645841,12638370,12645841,111114754,XM_022453215.1,uncharacterized LOC111114754,7471
NC_035788.1,12478910,12487549,12478910,12481522,111114755,XM_022453216.1,uncharacterized LOC111114755,2612
NC_035788.1,12478910,12487549,12478910,12482880,111114755,XM_022453219.1,uncharacterized LOC111114755,3970
NC_035788.1,12478910,12487549,12478910,12487549,111114755,XM_022453217.1,uncharacterized LOC111114755,8639
NC_035788.1,12609284,12615859,12609284,12615859,111114757,XM_022453221.1,uncharacterized LOC111114757,6575
NC_035788.1,12225994,12246914,12225994,12246914,111114758,XM_022453223.1,uncharacterized LOC111114758,20920
NC_035788.1,12225994,12246914,12239507,12246914,111114758,XM_022453224.1,uncharacterized LOC111114758,7407
NC_035788.1,12694732,12697906,12694732,12697906,111114759,XM_022453225.1,uncharacterized LOC111114759,3174
NC_035788.1,12708014,12711392,12708014,12711392,111114760,XM_022453226.1,uncharacterized LOC111114760,3378
NC_035788.1,85710387,85712994,85710387,85712994,111114765,XM_022453228.1,uncharacterized LOC111114765,2607
NC_035780.1,50211758,50223692,50211758,50223692,111114781,XM_022453255.1,uncharacterized LOC111114781,11934
NC_035780.1,50211758,50223692,50211758,50216788,111114781,XM_022453262.1,uncharacterized LOC111114781,5030
NC_035788.1,37553890,37556302,37553890,37556302,111114788,XM_022453258.1,uncharacterized LOC111114788,2412
NC_035788.1,37551596,37553725,37551596,37553725,111114789,XM_022453259.1,uncharacterized LOC111114789,2129
NC_035788.1,2114636,2120807,2116471,2120807,111114793,XM_022453267.1,uncharacterized LOC111114793,4336
NC_035788.1,2114636,2120807,2114636,2120807,111114793,XM_022453268.1,uncharacterized LOC111114793,6171
NC_035788.1,93639881,93641351,93639881,93641351,111114800,XM_022453275.1,uncharacterized LOC111114800,1470
NC_035788.1,78848604,78851471,78848604,78851471,111114801,XM_022453276.1,uncharacterized LOC111114801,2867
NC_035788.1,58296493,58337884,58296493,58335821,111114802,XM_022453279.1,uncharacterized LOC111114802,39328
NC_035788.1,58296493,58337884,58296493,58336185,111114802,XM_022453280.1,uncharacterized LOC111114802,39692
NC_035788.1,58296493,58337884,58296493,58337884,111114802,XM_022453282.1,uncharacterized LOC111114802,41391
NC_035788.1,58361675,58474447,58361675,58474447,111114803,XM_022453284.1,uncharacterized LOC111114803,112772
NC_035788.1,58361675,58474447,58426075,58474440,111114803,XM_022453285.1,uncharacterized LOC111114803,48365
NC_035788.1,58361675,58474447,58423352,58474417,111114803,XM_022453283.1,uncharacterized LOC111114803,51065
NC_035788.1,58494763,58539958,58494763,58539958,111114804,XM_022453286.1,uncharacterized LOC111114804,45195
NC_035788.1,58341212,58342502,58341212,58342502,111114805,XM_022453287.1,uncharacterized LOC111114805,1290
NC_035780.1,47591110,47592862,47591110,47592862,111114806,XM_022453288.1,uncharacterized LOC111114806,1752
NC_035788.1,77608411,77609720,77608411,77609720,111114814,XM_022453290.1,uncharacterized LOC111114814,1309
NC_035788.1,75223105,75237107,75223131,75237107,111114816,XM_022453293.1,uncharacterized LOC111114816,13976
NC_035788.1,75223105,75237107,75223121,75237107,111114816,XM_022453294.1,uncharacterized LOC111114816,13986
NC_035788.1,75223105,75237107,75223105,75237107,111114816,XM_022453292.1,uncharacterized LOC111114816,14002
NC_035788.1,70961275,70963784,70961275,70963784,111114818,XM_022453296.1,uncharacterized LOC111114818,2509
NC_035788.1,94846064,94865076,94846064,94863314,111114819,XM_022453299.1,uncharacterized LOC111114819,17250
NC_035788.1,94846064,94865076,94846064,94865076,111114819,XM_022453297.1,uncharacterized LOC111114819,19012
NC_035788.1,23921627,23925750,23921627,23925750,111114822,XM_022453307.1,uncharacterized LOC111114822,4123
NC_035788.1,56730721,56831152,56730721,56831147,111114825,XM_022453310.1,uncharacterized LOC111114825,100426
NC_035788.1,56730721,56831152,56730721,56831152,111114825,XM_022453312.1,uncharacterized LOC111114825,100431
NC_035788.1,56730721,56831152,56730721,56807053,111114825,XM_022453316.1,uncharacterized LOC111114825,76332
NC_035788.1,56730721,56831152,56730721,56812883,111114825,XM_022453313.1,uncharacterized LOC111114825,82162
NC_035788.1,56730721,56831152,56730721,56813292,111114825,XM_022453315.1,uncharacterized LOC111114825,82571
NC_035788.1,56730721,56831152,56822251,56831152,111114825,XM_022453314.1,uncharacterized LOC111114825,8901
NC_035788.1,56730721,56831152,56738494,56831147,111114825,XM_022453311.1,uncharacterized LOC111114825,92653
NC_035780.1,32335802,32341712,32337915,32341712,111114826,XM_022453320.1,uncharacterized LOC111114826,3797
NC_035780.1,32335802,32341712,32335802,32341710,111114826,XM_022453328.1,uncharacterized LOC111114826,5908
NC_035788.1,72487744,72495010,72487744,72495010,111114828,XM_022453319.1,uncharacterized LOC111114828,7266
NC_035788.1,88320039,88322126,88320039,88322126,111114830,XM_022453322.1,uncharacterized LOC111114830,2087
NC_035788.1,71500062,71502915,71500062,71502915,111114833,XM_022453327.1,uncharacterized LOC111114833,2853
NC_035788.1,62636441,62646628,62636441,62646628,111114838,XM_022453337.1,uncharacterized LOC111114838,10187
NC_035788.1,75987769,75990242,75987769,75990242,111114847,XM_022453352.1,uncharacterized LOC111114847,2473
NC_035788.1,69535223,69556475,69535223,69556475,111114848,XM_022453354.1,uncharacterized LOC111114848,21252
NC_035788.1,17098903,17105911,17098903,17105911,111114849,XM_022453355.1,uncharacterized LOC111114849,7008
NC_035788.1,53692199,53713328,53692199,53713328,111114852,XM_022453357.1,uncharacterized LOC111114852,21129
NC_035788.1,48631043,48659190,48642761,48659190,111114855,XM_022453367.1,uncharacterized LOC111114855,16429
NC_035788.1,48631043,48659190,48634645,48659190,111114855,XM_022453366.1,uncharacterized LOC111114855,24545
NC_035788.1,48631043,48659190,48631043,48659190,111114855,XM_022453365.1,uncharacterized LOC111114855,28147
NC_035788.1,49203797,49215783,49203797,49215783,111114857,XM_022453370.1,uncharacterized LOC111114857,11986
NC_035788.1,48759253,48771429,48759253,48771429,111114858,XM_022453371.1,uncharacterized LOC111114858,12176
NC_035788.1,49250750,49257432,49250771,49257432,111114859,XM_022453374.1,uncharacterized LOC111114859,6661
NC_035788.1,49250750,49257432,49250768,49257432,111114859,XM_022453372.1,uncharacterized LOC111114859,6664
NC_035788.1,49250750,49257432,49250750,49257432,111114859,XM_022453373.1,uncharacterized LOC111114859,6682
NC_035788.1,48967236,48974931,48967236,48974931,111114860,XM_022453375.1,uncharacterized LOC111114860,7695
NC_035788.1,49265462,49299226,49265463,49299226,111114863,XM_022453382.1,uncharacterized LOC111114863,33763
NC_035788.1,49265462,49299226,49265462,49299226,111114863,XM_022453383.1,uncharacterized LOC111114863,33764
NC_035788.1,49030384,49034050,49030384,49034050,111114866,XM_022453388.1,uncharacterized LOC111114866,3666
NC_035788.1,48692026,48695804,48692026,48695804,111114867,XM_022453389.1,uncharacterized LOC111114867,3778
NC_035788.1,49257576,49260826,49257576,49260826,111114869,XM_022453392.1,uncharacterized LOC111114869,3250
NC_035788.1,22364455,22383280,22364455,22383280,111114878,XM_022453396.1,uncharacterized LOC111114878,18825
NC_035788.1,64673419,64681234,64673454,64681234,111114879,XM_022453398.1,uncharacterized LOC111114879,7780
NC_035788.1,64673419,64681234,64673419,64681229,111114879,XM_022453399.1,uncharacterized LOC111114879,7810
NC_035788.1,64673419,64681234,64673419,64681234,111114879,XM_022453397.1,uncharacterized LOC111114879,7815
NC_035788.1,24720639,24723149,24720639,24723149,111114880,XM_022453400.1,uncharacterized LOC111114880,2510
NC_035788.1,52058958,52066654,52058958,52066654,111114882,XM_022453403.1,uncharacterized LOC111114882,7696
NC_035788.1,71232540,71243259,71232541,71243259,111114886,XM_022453414.1,uncharacterized LOC111114886,10718
NC_035788.1,71232540,71243259,71232540,71243259,111114886,XM_022453415.1,uncharacterized LOC111114886,10719
NC_035788.1,78110911,78122606,78116743,78120816,111114887,XM_022453416.1,uncharacterized LOC111114887,4073
NC_035788.1,63532192,63537032,63532192,63537032,111114890,XM_022453418.1,uncharacterized LOC111114890,4840
NC_035788.1,79682939,79738431,79682939,79738431,111114897,XM_022453424.1,uncharacterized LOC111114897,55492
NC_035788.1,80710908,80716053,80710908,80716053,111114898,XM_022453425.1,uncharacterized LOC111114898,5145
NC_035788.1,79529756,79784272,79607536,79615687,111114900,XM_022453430.1,uncharacterized LOC111114900,8151
NC_035788.1,79529756,79784272,79529756,79615687,111114900,XM_022453431.1,uncharacterized LOC111114900,85931
NC_035788.1,79336362,79340425,79336362,79340425,111114903,XM_022453447.1,uncharacterized LOC111114903,4063
NC_035788.1,79619675,79621900,79619675,79621900,111114905,XM_022453449.1,uncharacterized LOC111114905,2225
NC_035788.1,79865674,79868093,79865674,79868093,111114906,XM_022453450.1,uncharacterized LOC111114906,2419
NC_035788.1,79912985,79915419,79912985,79915419,111114909,XM_022453452.1,uncharacterized LOC111114909,2434
NC_035788.1,79764367,79773368,79764375,79773368,111114910,XM_022453455.1,uncharacterized LOC111114910,8993
NC_035788.1,79764367,79773368,79764367,79773368,111114910,XM_022453453.1,uncharacterized LOC111114910,9001
NC_035788.1,79319186,79321211,79319186,79321211,111114912,XM_022453457.1,uncharacterized LOC111114912,2025
NC_035788.1,79205508,79207879,79205508,79207879,111114917,XM_022453461.1,uncharacterized LOC111114917,2371
NC_035788.1,80570483,80572623,80570483,80572623,111114919,XM_022453462.1,uncharacterized LOC111114919,2140
NC_035788.1,80116164,80118242,80116164,80118242,111114920,XM_022453463.1,uncharacterized LOC111114920,2078
NC_035788.1,79530217,79538051,79531752,79538051,111114921,XM_022453466.1,uncharacterized LOC111114921,6299
NC_035788.1,79530217,79538051,79530217,79538051,111114921,XM_022453465.1,uncharacterized LOC111114921,7834
NC_035788.1,79803711,79806136,79803711,79805725,111114922,XM_022453469.1,uncharacterized LOC111114922,2014
NC_035788.1,79803711,79806136,79803711,79806136,111114922,XM_022453468.1,uncharacterized LOC111114922,2425
NC_035788.1,80603468,80605439,80603468,80605439,111114923,XM_022453470.1,uncharacterized LOC111114923,1971
NC_035788.1,80635786,80637722,80635786,80637722,111114924,XM_022453471.1,uncharacterized LOC111114924,1936
NC_035788.1,80617689,80623347,80617691,80623317,111114925,XM_022453472.1,uncharacterized LOC111114925,5626
NC_035780.1,14673319,14678528,14673319,14677651,111114926,XM_022453485.1,uncharacterized LOC111114926,4332
NC_035780.1,14673319,14678528,14673319,14678528,111114926,XM_022453476.1,uncharacterized LOC111114926,5209
NC_035788.1,57311434,57315218,57311434,57315218,111114927,XM_022453473.1,uncharacterized LOC111114927,3784
NC_035788.1,79929969,79998629,79929969,79998568,111114932,XM_022453484.1,uncharacterized LOC111114932,68599
NC_035788.1,79929969,79998629,79929971,79998629,111114932,XM_022453483.1,uncharacterized LOC111114932,68658
NC_035788.1,79697467,79702031,79697467,79701862,111114933,XM_022453486.1,uncharacterized LOC111114933,4395
NC_035788.1,79697467,79702031,79697467,79702031,111114933,XM_022453487.1,uncharacterized LOC111114933,4564
NC_035788.1,80689497,80707316,80689497,80707316,111114934,XM_022453488.1,uncharacterized LOC111114934,17819
NC_035788.1,79323791,79330574,79327634,79330574,111114936,XM_022453490.1,uncharacterized LOC111114936,2940
NC_035788.1,79630121,79630993,79630121,79630993,111114941,XM_022453495.1,uncharacterized LOC111114941,872
NC_035788.1,67442825,67448514,67442825,67448514,111114965,XM_022453505.1,uncharacterized LOC111114965,5689
NC_035780.1,47318443,47329576,47318443,47329576,111114968,XM_022453511.1,uncharacterized LOC111114968,11133
NC_035788.1,59454578,59520437,59454578,59520437,111114969,XM_022453510.1,uncharacterized LOC111114969,65859
NC_035788.1,50147095,50191096,50147095,50159021,111114972,XM_022453514.1,uncharacterized LOC111114972,11926
NC_035788.1,50147095,50191096,50147095,50191096,111114972,XM_022453513.1,uncharacterized LOC111114972,44001
NC_035788.1,16644462,16651703,16644462,16651703,111114973,XM_022453515.1,uncharacterized LOC111114973,7241
NC_035788.1,49574327,49576151,49574327,49576151,111114974,XM_022453516.1,uncharacterized LOC111114974,1824
NC_035788.1,94190420,94218711,94190420,94218711,111114983,XM_022453529.1,uncharacterized LOC111114983,28291
NC_035788.1,94190420,94218711,94210210,94218711,111114983,XM_022453527.1,uncharacterized LOC111114983,8501
NC_035788.1,38555831,38560095,38555831,38560095,111114989,XM_022453543.1,uncharacterized LOC111114989,4264
NC_035788.1,38365631,38378021,38365631,38378021,111114990,XM_022453544.1,uncharacterized LOC111114990,12390
NC_035788.1,38714605,38842001,38714605,38842001,111114991,XM_022453546.1,uncharacterized LOC111114991,127396
NC_035788.1,38025472,38040944,38025472,38040944,111114992,XM_022453547.1,uncharacterized LOC111114992,15472
NC_035788.1,38467990,38480682,38467990,38480682,111114994,XM_022453550.1,uncharacterized LOC111114994,12692
NC_035788.1,38219758,38222191,38219758,38222191,111114995,XM_022453553.1,uncharacterized LOC111114995,2433
NC_035788.1,38622062,38645997,38622062,38645684,111115001,XM_022453566.1,uncharacterized LOC111115001,23622
NC_035788.1,38622062,38645997,38622063,38645997,111115001,XM_022453565.1,uncharacterized LOC111115001,23934
NC_035780.1,13379220,13388219,13379220,13383019,111115002,XM_022453570.1,uncharacterized LOC111115002,3799
NC_035780.1,13379220,13388219,13379220,13388219,111115002,XM_022453580.1,uncharacterized LOC111115002,8999
NC_035788.1,38949559,38956241,38949559,38956241,111115008,XM_022453579.1,uncharacterized LOC111115008,6682
NC_035788.1,38877690,38882426,38877690,38882426,111115009,XM_022453581.1,uncharacterized LOC111115009,4736
NC_035788.1,38494649,38526025,38494649,38526025,111115023,XM_022453598.1,uncharacterized LOC111115023,31376
NC_035788.1,38543613,38594117,38543613,38592763,111115025,XM_022453605.1,uncharacterized LOC111115025,49150
NC_035788.1,38543613,38594117,38543613,38592992,111115025,XM_022453602.1,uncharacterized LOC111115025,49379
NC_035788.1,38543613,38594117,38543613,38594117,111115025,XM_022453600.1,uncharacterized LOC111115025,50504
NC_035788.1,38398460,38403494,38398460,38399597,111115026,XM_022453606.1,uncharacterized LOC111115026,1137
NC_035788.1,38326417,38332324,38326417,38332324,111115027,XM_022453607.1,uncharacterized LOC111115027,5907
NC_035780.1,12593119,12598162,12593119,12598162,111115033,XM_022453608.1,uncharacterized LOC111115033,5043
NC_035788.1,92080272,92093771,92080272,92093771,111115043,XM_022453612.1,uncharacterized LOC111115043,13499
NC_035788.1,54468840,54485276,54468840,54485276,111115049,XM_022453623.1,uncharacterized LOC111115049,16436
NC_035788.1,70982371,70983887,70982371,70983887,111115051,XM_022453626.1,uncharacterized LOC111115051,1516
NC_035788.1,15150508,15153749,15150508,15153749,111115052,XM_022453627.1,uncharacterized LOC111115052,3241
NC_035788.1,24171951,24174113,24171951,24174113,111115054,XM_022453629.1,uncharacterized LOC111115054,2162
NC_035788.1,78505141,78507884,78505141,78507884,111115060,XM_022453636.1,uncharacterized LOC111115060,2743
NC_035788.1,16349437,16355697,16349437,16355697,111115061,XM_022453637.1,uncharacterized LOC111115061,6260
NC_035788.1,16322503,16341588,16322503,16341588,111115062,XM_022453638.1,uncharacterized LOC111115062,19085
NC_035788.1,16359846,16371970,16359846,16371970,111115063,XM_022453640.1,uncharacterized LOC111115063,12124
NC_035788.1,16286403,16309737,16286403,16309737,111115067,XM_022453647.1,uncharacterized LOC111115067,23334
NC_035788.1,66428336,66434000,66428336,66434000,111115074,XM_022453655.1,uncharacterized LOC111115074,5664
NC_035788.1,2859225,2870032,2859225,2870011,111115075,XM_022453657.1,uncharacterized LOC111115075,10786
NC_035788.1,2859225,2870032,2865169,2870032,111115075,XM_022453656.1,uncharacterized LOC111115075,4863
NC_035788.1,8979450,8983689,8979450,8983689,111115076,XM_022453658.1,uncharacterized LOC111115076,4239
NC_035780.1,39131357,39133366,39131357,39133366,111115077,XM_022453661.1,uncharacterized LOC111115077,2009
NC_035788.1,87546227,87554758,87546227,87554758,111115078,XM_022453659.1,uncharacterized LOC111115078,8531
NC_035788.1,70966390,70969223,70966390,70969223,111115086,XM_022453667.1,uncharacterized LOC111115086,2833
NC_035788.1,13400793,13403443,13400816,13403443,111115090,XM_022453671.1,uncharacterized LOC111115090,2627
NC_035788.1,13400793,13403443,13400793,13403443,111115090,XM_022453672.1,uncharacterized LOC111115090,2650
NC_035788.1,67491621,67498709,67491621,67498708,111115092,XM_022453676.1,uncharacterized LOC111115092,7087
NC_035788.1,67491621,67498709,67491621,67498709,111115092,XM_022453677.1,uncharacterized LOC111115092,7088
NC_035788.1,61035680,61044078,61035680,61044078,111115097,XM_022453686.1,uncharacterized LOC111115097,8398
NC_035788.1,82968095,82974387,82968095,82974387,111115101,XM_022453695.1,uncharacterized LOC111115101,6292
NC_035788.1,75656660,75673804,75656660,75673804,111115106,XM_022453707.1,uncharacterized LOC111115106,17144
NC_035788.1,98775537,98793125,98775537,98793110,111115107,XM_022453712.1,uncharacterized LOC111115107,17573
NC_035788.1,98775537,98793125,98775537,98793111,111115107,XM_022453714.1,uncharacterized LOC111115107,17574
NC_035788.1,98775537,98793125,98775537,98793112,111115107,XM_022453713.1,uncharacterized LOC111115107,17575
NC_035788.1,98775537,98793125,98775537,98793113,111115107,XM_022453709.1,uncharacterized LOC111115107,17576
NC_035788.1,98775537,98793125,98775537,98793114,111115107,XM_022453708.1,uncharacterized LOC111115107,17577
NC_035788.1,98775537,98793125,98775537,98793125,111115107,XM_022453715.1,uncharacterized LOC111115107,17588
NC_035780.1,5287066,5292105,5287066,5292105,111115108,XM_022453718.1,uncharacterized LOC111115108,5039
NC_035788.1,16862077,16871322,16862077,16871322,111115109,XM_022453716.1,uncharacterized LOC111115109,9245
NC_035788.1,56886246,56887554,56886246,56887554,111115111,XM_022453717.1,uncharacterized LOC111115111,1308
NC_035788.1,56881082,56882359,56881082,56882359,111115112,XM_022453719.1,uncharacterized LOC111115112,1277
NC_035788.1,69691917,69696268,69691917,69696268,111115115,XM_022453722.1,uncharacterized LOC111115115,4351
NC_035788.1,75289528,75295276,75289528,75295274,111115118,XM_022453725.1,uncharacterized LOC111115118,5746
NC_035788.1,75289528,75295276,75289528,75295276,111115118,XM_022453726.1,uncharacterized LOC111115118,5748
NC_035780.1,17297572,17317343,17297572,17317343,111115119,XM_022453731.1,uncharacterized LOC111115119,19771
NC_035788.1,69303525,69311644,69303525,69311609,111115120,XM_022453730.1,uncharacterized LOC111115120,8084
NC_035788.1,69303525,69311644,69303525,69311615,111115120,XM_022453729.1,uncharacterized LOC111115120,8090
NC_035788.1,69303525,69311644,69303525,69311640,111115120,XM_022453727.1,uncharacterized LOC111115120,8115
NC_035788.1,69303525,69311644,69303525,69311644,111115120,XM_022453728.1,uncharacterized LOC111115120,8119
NC_035788.1,77801715,77805610,77801715,77805610,111115127,XM_022453752.1,uncharacterized LOC111115127,3895
NC_035788.1,17776180,17787730,17776180,17787730,111115131,XM_022453756.1,uncharacterized LOC111115131,11550
NC_035788.1,75982264,75985057,75982264,75985057,111115133,XM_022453758.1,uncharacterized LOC111115133,2793
NC_035788.1,92454143,92456820,92454195,92456820,111115136,XM_022453764.1,uncharacterized LOC111115136,2625
NC_035788.1,92454143,92456820,92454143,92456820,111115136,XM_022453763.1,uncharacterized LOC111115136,2677
NC_035788.1,2122047,2126604,2122047,2126604,111115139,XM_022453771.1,uncharacterized LOC111115139,4557
NC_035788.1,95707731,95710219,95707731,95710219,111115144,XM_022453775.1,uncharacterized LOC111115144,2488
NC_035788.1,72457129,72458813,72457129,72458813,111115145,XM_022453777.1,uncharacterized LOC111115145,1684
NC_035788.1,37798507,37808393,37798507,37808393,111115148,XM_022453784.1,uncharacterized LOC111115148,9886
NC_035788.1,73182037,73184165,73182037,73184165,111115150,XM_022453787.1,uncharacterized LOC111115150,2128
NC_035788.1,32217614,32238041,32217614,32238041,111115154,XM_022453793.1,uncharacterized LOC111115154,20427
NC_035788.1,75647479,75650810,75647479,75650810,111115161,XM_022453802.1,uncharacterized LOC111115161,3331
NC_035788.1,24002671,24008240,24002671,24008240,111115163,XM_022453805.1,uncharacterized LOC111115163,5569
NC_035788.1,3703977,3707116,3703977,3707116,111115164,XM_022453806.1,uncharacterized LOC111115164,3139
NC_035788.1,4117714,4140617,4123722,4140617,111115168,XM_022453811.1,uncharacterized LOC111115168,16895
NC_035788.1,4117714,4140617,4117714,4140617,111115168,XM_022453810.1,uncharacterized LOC111115168,22903
NC_035788.1,19825701,19829632,19825701,19829632,111115170,XM_022453814.1,uncharacterized LOC111115170,3931
NC_035788.1,22054435,22063223,22054435,22063223,111115173,XM_022453817.1,uncharacterized LOC111115173,8788
NC_035788.1,40004696,40044548,40004708,40029561,111115175,XM_022453821.1,uncharacterized LOC111115175,24853
NC_035788.1,40004696,40044548,40004708,40044548,111115175,XM_022453818.1,uncharacterized LOC111115175,39840
NC_035788.1,40004696,40044548,40004696,40044548,111115175,XM_022453819.1,uncharacterized LOC111115175,39852
NC_035788.1,15155683,15158225,15155683,15158225,111115177,XM_022453822.1,uncharacterized LOC111115177,2542
NC_035788.1,19108872,19122178,19111056,19122178,111115178,XM_022453826.1,uncharacterized LOC111115178,11122
NC_035788.1,19108872,19122178,19108884,19122178,111115178,XM_022453825.1,uncharacterized LOC111115178,13294
NC_035788.1,19108872,19122178,19108872,19122178,111115178,XM_022453824.1,uncharacterized LOC111115178,13306
NC_035788.1,61188317,61190248,61188317,61190248,111115179,XM_022453827.1,uncharacterized LOC111115179,1931
NC_035788.1,1023680,1027978,1023680,1027978,111115181,XM_022453829.1,uncharacterized LOC111115181,4298
NC_035788.1,35549991,35554172,35549991,35552481,111115182,XM_022453832.1,uncharacterized LOC111115182,2490
NC_035788.1,35549991,35554172,35549991,35554172,111115182,XM_022453830.1,uncharacterized LOC111115182,4181
NC_035788.1,67189839,67195601,67189839,67195601,111115184,XM_022453834.1,uncharacterized LOC111115184,5762
NC_035788.1,2961108,2963297,2961108,2963297,111115186,XM_022453837.1,uncharacterized LOC111115186,2189
NC_035788.1,98742849,98751846,98742849,98751846,111115188,XM_022453840.1,uncharacterized LOC111115188,8997
NC_035788.1,68178760,68181933,68178760,68181933,111115189,XM_022453841.1,uncharacterized LOC111115189,3173
NC_035788.1,73250844,73266891,73250844,73266891,111115190,XM_022453842.1,uncharacterized LOC111115190,16047
NC_035788.1,61191825,61194722,61191825,61194722,111115191,XM_022453843.1,uncharacterized LOC111115191,2897
NC_035788.1,61051403,61056375,61051403,61056375,111115193,XM_022453847.1,uncharacterized LOC111115193,4972
NC_035788.1,16974352,16977867,16974352,16977867,111115197,XM_022453850.1,uncharacterized LOC111115197,3515
NC_035788.1,5330927,5338021,5330927,5338021,111115199,XM_022453855.1,uncharacterized LOC111115199,7094
NC_035788.1,23715777,23722409,23717766,23722409,111115200,XM_022453856.1,uncharacterized LOC111115200,4643
NC_035788.1,23715777,23722409,23717677,23722409,111115200,XM_022453857.1,uncharacterized LOC111115200,4732
NC_035780.1,39359121,39375303,39359121,39371358,111115203,XM_022453876.1,uncharacterized LOC111115203,12237
NC_035780.1,39359121,39375303,39359121,39375303,111115203,XM_022453871.1,uncharacterized LOC111115203,16182
NC_035788.1,54534508,54537902,54534508,54537902,111115208,XM_022453867.1,uncharacterized LOC111115208,3394
NC_035788.1,77685372,77696253,77685372,77696253,111115209,XM_022453868.1,uncharacterized LOC111115209,10881
NC_035788.1,77698259,77701307,77698259,77701307,111115210,XM_022453869.1,uncharacterized LOC111115210,3048
NC_035788.1,14646372,14648465,14646372,14648465,111115211,XM_022453870.1,uncharacterized LOC111115211,2093
NC_035788.1,21383540,21387429,21383540,21387429,111115212,XM_022453872.1,uncharacterized LOC111115212,3889
NC_035788.1,5085479,5089673,5085479,5089673,111115214,XM_022453873.1,uncharacterized LOC111115214,4194
NC_035788.1,5089683,5094681,5089683,5094681,111115215,XM_022453874.1,uncharacterized LOC111115215,4998
NC_035788.1,19903390,19904977,19903390,19904977,111115222,XM_022453882.1,uncharacterized LOC111115222,1587
NC_035788.1,24436238,24440527,24436238,24440527,111115223,XM_022453883.1,uncharacterized LOC111115223,4289
NC_035788.1,21905282,21914111,21905282,21914111,111115226,XM_022453885.1,uncharacterized LOC111115226,8829
NC_035788.1,3849676,3852437,3849676,3852437,111115228,XM_022453889.1,uncharacterized LOC111115228,2761
NC_035788.1,97666394,97670429,97666394,97670429,111115229,XM_022453890.1,uncharacterized LOC111115229,4035
NC_035788.1,88748258,88751750,88748258,88751750,111115233,XM_022453894.1,uncharacterized LOC111115233,3492
NC_035788.1,88620651,88623297,88620651,88623297,111115234,XM_022453895.1,uncharacterized LOC111115234,2646
NC_035788.1,88674999,88690287,88674999,88690287,111115235,XM_022453897.1,uncharacterized LOC111115235,15288
NC_035788.1,88674999,88690287,88674999,88677299,111115235,XM_022453898.1,uncharacterized LOC111115235,2300
NC_035788.1,88674999,88690287,88674999,88677353,111115235,XM_022453896.1,uncharacterized LOC111115235,2354
NC_035788.1,88735879,88739050,88735879,88739050,111115236,XM_022453899.1,uncharacterized LOC111115236,3171
NC_035788.1,88603337,88619394,88603337,88619394,111115237,XM_022453900.1,uncharacterized LOC111115237,16057
NC_035780.1,4153587,4165615,4153587,4165615,111115242,XM_022453908.1,uncharacterized LOC111115242,12028
NC_035788.1,67769123,67773605,67769123,67773605,111115244,XM_022453905.1,uncharacterized LOC111115244,4482
NC_035788.1,4201441,4203168,4201441,4203168,111115245,XM_022453906.1,uncharacterized LOC111115245,1727
NC_035788.1,18133299,18137566,18133299,18137566,111115250,XM_022453912.1,uncharacterized LOC111115250,4267
NC_035780.1,20392207,20399447,20392402,20399447,111115253,XM_022453928.1,uncharacterized LOC111115253,7045
NC_035780.1,20392207,20399447,20392298,20399447,111115253,XM_022453938.1,uncharacterized LOC111115253,7149
NC_035780.1,20392207,20399447,20392207,20399447,111115253,XM_022453920.1,uncharacterized LOC111115253,7240
NC_035788.1,5954958,5958140,5954958,5957808,111115255,XM_022453919.1,uncharacterized LOC111115255,2850
NC_035788.1,5954958,5958140,5955263,5958140,111115255,XM_022453918.1,uncharacterized LOC111115255,2877
NC_035788.1,5954958,5958140,5954958,5958132,111115255,XM_022453917.1,uncharacterized LOC111115255,3174
NC_035788.1,61691684,61704160,61691684,61704160,111115258,XM_022453925.1,uncharacterized LOC111115258,12476
NC_035788.1,33515273,33524425,33515273,33524425,111115261,XM_022453937.1,uncharacterized LOC111115261,9152
NC_035780.1,20389981,20391775,20389981,20391775,111115269,XM_022453951.1,uncharacterized LOC111115269,1794
NC_035788.1,34570019,34576034,34570019,34576034,111115270,XM_022453948.1,uncharacterized LOC111115270,6015
NC_035788.1,34161102,34172215,34161102,34172215,111115271,XM_022453949.1,uncharacterized LOC111115271,11113
NC_035788.1,34230830,34234240,34230830,34234240,111115273,XM_022453955.1,uncharacterized LOC111115273,3410
NC_035788.1,34457325,34459456,34457325,34459456,111115274,XM_022453956.1,uncharacterized LOC111115274,2131
NC_035788.1,34455052,34457242,34455052,34457242,111115279,XM_022453963.1,uncharacterized LOC111115279,2190
NC_035788.1,34336541,34341277,34336541,34341277,111115284,XM_022453969.1,uncharacterized LOC111115284,4736
NC_035788.1,34264610,34271410,34264610,34271410,111115286,XM_022453970.1,uncharacterized LOC111115286,6800
NC_035788.1,33592772,33595869,33592772,33595840,111115288,XM_022453978.1,uncharacterized LOC111115288,3068
NC_035788.1,33592772,33595869,33592772,33595869,111115288,XM_022453977.1,uncharacterized LOC111115288,3097
NC_035788.1,34702799,34706814,34702799,34706814,111115290,XM_022453980.1,uncharacterized LOC111115290,4015
NC_035788.1,34737377,34738898,34737377,34738898,111115293,XM_022453982.1,uncharacterized LOC111115293,1521
NC_035788.1,90267966,90272454,90267966,90272454,111115302,XM_022453996.1,uncharacterized LOC111115302,4488
NC_035780.1,4701559,4705850,4701559,4705850,111115318,XM_022454000.1,uncharacterized LOC111115318,4291
NC_035788.1,5153664,5160268,5153664,5160267,111115322,XM_022453999.1,uncharacterized LOC111115322,6603
NC_035788.1,5153664,5160268,5153664,5160268,111115322,XM_022454002.1,uncharacterized LOC111115322,6604
NC_035780.1,28421518,28423958,28421518,28423958,111115327,XM_022454013.1,uncharacterized LOC111115327,2440
NC_035788.1,27208672,27210936,27208672,27210936,111115328,XM_022454010.1,uncharacterized LOC111115328,2264
NC_035788.1,23801568,23805523,23801568,23805523,111115330,XM_022454012.1,uncharacterized LOC111115330,3955
NC_035788.1,26596923,26604735,26596923,26604735,111115332,XM_022454015.1,uncharacterized LOC111115332,7812
NC_035780.1,53739135,53745222,53739135,53745222,111115336,XM_022454025.1,uncharacterized LOC111115336,6087
NC_035788.1,83356366,83359261,83356366,83359261,111115339,XM_022454027.1,uncharacterized LOC111115339,2895
NC_035788.1,83193294,83196727,83193294,83196727,111115340,XM_022454028.1,uncharacterized LOC111115340,3433
NC_035788.1,31579716,31587274,31579716,31587274,111115344,XM_022454041.1,uncharacterized LOC111115344,7558
NC_035788.1,62575698,62582139,62575698,62582139,111115345,XM_022454042.1,uncharacterized LOC111115345,6441
NC_035788.1,15476503,15493865,15476503,15493865,111115347,XM_022454044.1,uncharacterized LOC111115347,17362
NC_035788.1,28851312,28853517,28851312,28853517,111115348,XM_022454045.1,uncharacterized LOC111115348,2205
NC_035788.1,30436304,30445225,30436304,30445225,111115351,XM_022454049.1,uncharacterized LOC111115351,8921
NC_035788.1,35448217,35453912,35448217,35453912,111115352,XM_022454050.1,uncharacterized LOC111115352,5695
NC_035788.1,8460543,8478614,8468004,8478614,111115353,XM_022454051.1,uncharacterized LOC111115353,10610
NC_035788.1,8460543,8478614,8467845,8478614,111115353,XM_022454055.1,uncharacterized LOC111115353,10769
NC_035788.1,8460543,8478614,8467844,8478614,111115353,XM_022454053.1,uncharacterized LOC111115353,10770
NC_035788.1,8460543,8478614,8460543,8478614,111115353,XM_022454052.1,uncharacterized LOC111115353,18071
NC_035788.1,796342,810076,796342,810076,111115354,XM_022454056.1,uncharacterized LOC111115354,13734
NC_035788.1,97378599,97386043,97378599,97386043,111115357,XM_022454061.1,uncharacterized LOC111115357,7444
NC_035788.1,66133622,66135239,66133622,66135239,111115358,XM_022454064.1,uncharacterized LOC111115358,1617
NC_035788.1,74993874,74998679,74993874,74998679,111115360,XM_022454066.1,uncharacterized LOC111115360,4805
NC_035788.1,9845144,9854043,9845144,9854043,111115361,XM_022454067.1,uncharacterized LOC111115361,8899
NC_035788.1,9853644,9857896,9854178,9857896,111115362,XM_022454069.1,uncharacterized LOC111115362,3718
NC_035788.1,9853644,9857896,9853644,9857896,111115362,XM_022454068.1,uncharacterized LOC111115362,4252
NC_035788.1,26730586,26739381,26730586,26739381,111115363,XM_022454070.1,uncharacterized LOC111115363,8795
NC_035788.1,58945941,58953629,58945941,58953629,111115366,XM_022454076.1,uncharacterized LOC111115366,7688
NC_035788.1,92431898,92435531,92432071,92435531,111115367,XM_022454078.1,uncharacterized LOC111115367,3460
NC_035788.1,92431898,92435531,92431898,92435531,111115367,XM_022454077.1,uncharacterized LOC111115367,3633
NC_035788.1,93548662,93550187,93548662,93550187,111115369,XM_022454081.1,uncharacterized LOC111115369,1525
NC_035788.1,69236561,69255801,69236561,69255801,111115370,XM_022454083.1,uncharacterized LOC111115370,19240
NC_035788.1,35185296,35187887,35185296,35187887,111115371,XM_022454084.1,uncharacterized LOC111115371,2591
NC_035788.1,76095969,76099740,76095969,76099740,111115372,XM_022454085.1,uncharacterized LOC111115372,3771
NC_035788.1,92387875,92405865,92387875,92405865,111115374,XM_022454090.1,uncharacterized LOC111115374,17990
NC_035788.1,21283013,21284513,21283013,21284513,111115375,XM_022454091.1,uncharacterized LOC111115375,1500
NC_035788.1,48626315,48630083,48626315,48630083,111115378,XM_022454093.1,uncharacterized LOC111115378,3768
NC_035788.1,61232308,61234278,61232308,61234278,111115379,XM_022454095.1,uncharacterized LOC111115379,1970
NC_035788.1,73639269,73641561,73639269,73641561,111115380,XM_022454096.1,uncharacterized LOC111115380,2292
NC_035788.1,76021042,76023956,76021042,76023956,111115381,XM_022454097.1,uncharacterized LOC111115381,2914
NC_035788.1,76023955,76028829,76023955,76028657,111115382,XM_022454099.1,uncharacterized LOC111115382,4702
NC_035788.1,76023955,76028829,76023955,76028829,111115382,XM_022454098.1,uncharacterized LOC111115382,4874
NC_035788.1,80752761,80760460,80752761,80760460,111115385,XM_022454102.1,uncharacterized LOC111115385,7699
NC_035788.1,1675498,1692290,1675498,1692290,111115393,XM_022454111.1,uncharacterized LOC111115393,16792
NC_035788.1,43304732,43309742,43304732,43309742,111115394,XM_022454112.1,uncharacterized LOC111115394,5010
NC_035788.1,40432504,40433108,40432504,40433108,111115395,XM_022454114.1,uncharacterized LOC111115395,604
NC_035788.1,56583961,56591049,56585284,56591049,111115396,XM_022454115.1,uncharacterized LOC111115396,5765
NC_035788.1,56583961,56591049,56583961,56591049,111115396,XM_022454116.1,uncharacterized LOC111115396,7088
NC_035788.1,80889745,80893246,80889745,80893246,111115399,XM_022454119.1,uncharacterized LOC111115399,3501
NC_035788.1,5627747,5635131,5627747,5635131,111115401,XM_022454121.1,uncharacterized LOC111115401,7384
NC_035788.1,62327706,62387743,62383353,62387743,111115402,XM_022454122.1,uncharacterized LOC111115402,4390
NC_035788.1,62550408,62551726,62550408,62551726,111115403,XM_022454123.1,uncharacterized LOC111115403,1318
NC_035788.1,22552443,22555109,22552443,22555109,111115404,XM_022454124.1,uncharacterized LOC111115404,2666
NC_035788.1,93346136,93352262,93346136,93352262,111115408,XM_022454128.1,uncharacterized LOC111115408,6126
NC_035788.1,55492837,55496010,55492837,55496010,111115410,XM_022454132.1,uncharacterized LOC111115410,3173
NC_035788.1,91368661,91371628,91368661,91371628,111115411,XM_022454133.1,uncharacterized LOC111115411,2967
NC_035788.1,94476296,94483101,94476296,94483101,111115412,XM_022454135.1,uncharacterized LOC111115412,6805
NC_035788.1,95365540,95370321,95365540,95370321,111115414,XM_022454137.1,uncharacterized LOC111115414,4781
NC_035788.1,28905988,28933739,28905988,28933739,111115418,XM_022454141.1,uncharacterized LOC111115418,27751
NC_035788.1,26631340,26646649,26631413,26646649,111115419,XM_022454146.1,uncharacterized LOC111115419,15236
NC_035788.1,26631340,26646649,26631344,26646649,111115419,XM_022454148.1,uncharacterized LOC111115419,15305
NC_035788.1,26631340,26646649,26631342,26646649,111115419,XM_022454147.1,uncharacterized LOC111115419,15307
NC_035788.1,26631340,26646649,26631341,26646649,111115419,XM_022454143.1,uncharacterized LOC111115419,15308
NC_035788.1,26631340,26646649,26631340,26646649,111115419,XM_022454145.1,uncharacterized LOC111115419,15309
NC_035788.1,64788105,64803461,64788105,64803461,111115422,XM_022454149.1,uncharacterized LOC111115422,15356
NC_035788.1,64788105,64803461,64788105,64792376,111115422,XM_022454151.1,uncharacterized LOC111115422,4271
NC_035788.1,64788105,64803461,64788105,64792381,111115422,XM_022454150.1,uncharacterized LOC111115422,4276
NC_035788.1,76053156,76075842,76053156,76075842,111115424,XM_022454154.1,uncharacterized LOC111115424,22686
NC_035788.1,76070400,76072065,76070400,76072065,111115425,XM_022454155.1,uncharacterized LOC111115425,1665
NC_035780.1,14572214,14585007,14572214,14584518,111115428,XM_022454277.1,uncharacterized LOC111115428,12304
NC_035780.1,14572214,14585007,14572214,14585007,111115428,XM_022454199.1,uncharacterized LOC111115428,12793
NC_035788.1,30582758,30589503,30582758,30589503,111115430,XM_022454162.1,uncharacterized LOC111115430,6745
NC_035788.1,94168510,94170576,94168510,94170576,111115431,XM_022454163.1,uncharacterized LOC111115431,2066
NC_035788.1,24311897,24331193,24312773,24331193,111115434,XM_022454165.1,uncharacterized LOC111115434,18420
NC_035780.1,46873107,46875760,46873107,46875760,111115436,XM_022454171.1,uncharacterized LOC111115436,2653
NC_035788.1,16842646,16847875,16842646,16847875,111115438,XM_022454170.1,uncharacterized LOC111115438,5229
NC_035788.1,53250383,53253063,53250383,53253063,111115440,XM_022454172.1,uncharacterized LOC111115440,2680
NC_035780.1,27165931,27166991,27165931,27166991,111115442,XM_022454183.1,uncharacterized LOC111115442,1060
NC_035788.1,77359762,77403928,77359762,77403928,111115444,XM_022454184.1,uncharacterized LOC111115444,44166
NC_035788.1,77386739,77389298,77386739,77389298,111115445,XM_022454185.1,uncharacterized LOC111115445,2559
NC_035788.1,5961885,5986403,5961885,5986403,111115450,XM_022454194.1,uncharacterized LOC111115450,24518
NC_035788.1,90282540,90288935,90282540,90288935,111115452,XM_022454198.1,uncharacterized LOC111115452,6395
NC_035788.1,88292935,88299906,88292935,88299904,111115453,XM_022454200.1,uncharacterized LOC111115453,6969
NC_035788.1,88292935,88299906,88292935,88299906,111115453,XM_022454201.1,uncharacterized LOC111115453,6971
NC_035788.1,40885594,40887157,40885594,40887157,111115454,XM_022454202.1,uncharacterized LOC111115454,1563
NC_035788.1,3933418,3935974,3933418,3935974,111115455,XM_022454203.1,uncharacterized LOC111115455,2556
NC_035788.1,16931495,16939597,16931495,16939597,111115457,XM_022454204.1,uncharacterized LOC111115457,8102
NC_035788.1,18450318,18454083,18450318,18454083,111115461,XM_022454213.1,uncharacterized LOC111115461,3765
NC_035788.1,59614410,59617787,59614410,59617787,111115466,XM_022454217.1,uncharacterized LOC111115466,3377
NC_035788.1,27537377,27562536,27537377,27562536,111115468,XM_022454220.1,uncharacterized LOC111115468,25159
NC_035788.1,27404538,27430695,27404538,27430695,111115469,XM_022454221.1,uncharacterized LOC111115469,26157
NC_035788.1,27615974,27637003,27615974,27637003,111115470,XM_022454222.1,uncharacterized LOC111115470,21029
NC_035788.1,27485042,27492061,27485042,27489117,111115474,XM_022454234.1,uncharacterized LOC111115474,4075
NC_035788.1,27485042,27492061,27487421,27492061,111115474,XM_022454232.1,uncharacterized LOC111115474,4640
NC_035788.1,27485042,27492061,27486413,27492061,111115474,XM_022454231.1,uncharacterized LOC111115474,5648
NC_035788.1,27485042,27492061,27485842,27492061,111115474,XM_022454230.1,uncharacterized LOC111115474,6219
NC_035788.1,27485042,27492061,27485042,27492061,111115474,XM_022454229.1,uncharacterized LOC111115474,7019
NC_035788.1,58553262,58562766,58553262,58560874,111115484,XM_022454242.1,uncharacterized LOC111115484,7612
NC_035788.1,58553262,58562766,58553262,58562766,111115484,XM_022454241.1,uncharacterized LOC111115484,9504
NC_035788.1,54568414,54572155,54568414,54572155,111115485,XM_022454243.1,uncharacterized LOC111115485,3741
NC_035788.1,47607670,47613522,47607670,47613522,111115486,XM_022454244.1,uncharacterized LOC111115486,5852
NC_035788.1,48621165,48624836,48621165,48624836,111115488,XM_022454246.1,uncharacterized LOC111115488,3671
NC_035788.1,44784337,44790247,44784337,44790247,111115489,XM_022454247.1,uncharacterized LOC111115489,5910
NC_035788.1,57153599,57158679,57153599,57158679,111115494,XM_022454251.1,uncharacterized LOC111115494,5080
NC_035788.1,40627873,40631038,40627873,40631038,111115497,XM_022454255.1,uncharacterized LOC111115497,3165
NC_035788.1,93775442,93778190,93775442,93777820,111115499,XM_022454256.1,uncharacterized LOC111115499,2378
NC_035788.1,93775442,93778190,93775442,93778190,111115499,XM_022454257.1,uncharacterized LOC111115499,2748
NC_035788.1,37145632,37173592,37145632,37173592,111115502,XM_022454264.1,uncharacterized LOC111115502,27960
NC_035788.1,73221423,73225332,73221423,73225332,111115504,XM_022454266.1,uncharacterized LOC111115504,3909
NC_035788.1,25476563,25482721,25476563,25482469,111115506,XM_022454272.1,uncharacterized LOC111115506,5906
NC_035788.1,25476563,25482721,25476563,25482473,111115506,XM_022454269.1,uncharacterized LOC111115506,5910
NC_035788.1,25476563,25482721,25476563,25482721,111115506,XM_022454270.1,uncharacterized LOC111115506,6158
NC_035788.1,25664558,25670683,25664558,25670683,111115509,XM_022454274.1,uncharacterized LOC111115509,6125
NC_035788.1,25470817,25488205,25470817,25488205,111115510,XM_022454275.1,uncharacterized LOC111115510,17388
NC_035788.1,1174965,1177891,1174965,1177891,111115515,XM_022454279.1,uncharacterized LOC111115515,2926
NC_035788.1,73196953,73202845,73196953,73202845,111115517,XM_022454280.1,uncharacterized LOC111115517,5892
NC_035788.1,27181209,27183804,27181209,27183804,111115518,XM_022454281.1,uncharacterized LOC111115518,2595
NC_035780.1,54562838,54563567,54562838,54563567,111115519,XM_022454285.1,uncharacterized LOC111115519,729
NC_035788.1,94153798,94161717,94153798,94161717,111115520,XM_022454282.1,uncharacterized LOC111115520,7919
NC_035788.1,83346969,83351289,83346969,83351289,111115522,XM_022454284.1,uncharacterized LOC111115522,4320
NC_035788.1,37628499,37633342,37628499,37633342,111115526,XM_022454289.1,uncharacterized LOC111115526,4843
NC_035780.1,44594114,44597368,44594114,44597368,111115529,XM_022454297.1,uncharacterized LOC111115529,3254
NC_035788.1,81102764,81107102,81102783,81107102,111115530,XM_022454294.1,uncharacterized LOC111115530,4319
NC_035788.1,81102764,81107102,81102764,81107102,111115530,XM_022454293.1,uncharacterized LOC111115530,4338
NC_035788.1,81094838,81102701,81094838,81098525,111115531,XM_022454296.1,uncharacterized LOC111115531,3687
NC_035788.1,81094838,81102701,81094838,81102673,111115531,XM_022454295.1,uncharacterized LOC111115531,7835
NC_035788.1,81094838,81102701,81094838,81102701,111115531,XM_022454298.1,uncharacterized LOC111115531,7863
NC_035788.1,78588455,78603489,78588455,78603489,111115536,XM_022454304.1,uncharacterized LOC111115536,15034
NC_035788.1,103148940,103150304,103148940,103150304,111115543,XM_022454313.1,uncharacterized LOC111115543,1364
NC_035788.1,58970608,58978052,58970608,58977624,111115544,XM_022454315.1,uncharacterized LOC111115544,7016
NC_035788.1,58970608,58978052,58970608,58978052,111115544,XM_022454314.1,uncharacterized LOC111115544,7444
NC_035788.1,26937804,26965475,26937804,26965452,111115545,XM_022454318.1,uncharacterized LOC111115545,27648
NC_035788.1,26937804,26965475,26937804,26965456,111115545,XM_022454316.1,uncharacterized LOC111115545,27652
NC_035788.1,26937804,26965475,26937804,26965475,111115545,XM_022454319.1,uncharacterized LOC111115545,27671
NC_035788.1,27108650,27110954,27108650,27110954,111115550,XM_022454328.1,uncharacterized LOC111115550,2304
NC_035788.1,103144995,103146359,103144995,103146359,111115557,XM_022454343.1,uncharacterized LOC111115557,1364
NC_035788.1,60121709,60124057,60121709,60124057,111115558,XM_022454344.1,uncharacterized LOC111115558,2348
NC_035788.1,14704277,14704621,14704277,14704621,111115560,XM_022454345.1,uncharacterized LOC111115560,344
NC_035788.1,22919831,22929806,22919831,22929806,111115563,XM_022454348.1,uncharacterized LOC111115563,9975
NC_035788.1,94679613,94684951,94679613,94684951,111115564,XM_022454349.1,uncharacterized LOC111115564,5338
NC_035788.1,62812187,62816726,62812187,62816726,111115565,XM_022454350.1,uncharacterized LOC111115565,4539
NC_035788.1,60150253,60152558,60150253,60152558,111115570,XM_022454356.1,uncharacterized LOC111115570,2305
NC_035788.1,73293536,73297750,73293536,73297750,111115572,XM_022454357.1,uncharacterized LOC111115572,4214
NC_035788.1,65231152,65272612,65231152,65272612,111115574,XM_022454358.1,uncharacterized LOC111115574,41460
NC_035780.1,39331919,39349603,39331919,39349603,111115576,XM_022454360.1,uncharacterized LOC111115576,17684
NC_035780.1,12860759,12862729,12860759,12862729,111115582,XM_022454373.1,uncharacterized LOC111115582,1970
NC_035788.1,70573921,70577818,70573921,70577818,111115583,XM_022454372.1,uncharacterized LOC111115583,3897
NC_035788.1,54526822,54529774,54526822,54529774,111115587,XM_022454377.1,uncharacterized LOC111115587,2952
NC_035788.1,54493270,54495800,54493270,54495800,111115588,XM_022454378.1,uncharacterized LOC111115588,2530
NC_035788.1,54498952,54502514,54498952,54502514,111115589,XM_022454379.1,uncharacterized LOC111115589,3562
NC_035788.1,53358944,53363494,53358944,53363494,111115592,XM_022454380.1,uncharacterized LOC111115592,4550
NC_035788.1,37137783,37145481,37137783,37145481,111115594,XM_022454382.1,uncharacterized LOC111115594,7698
NC_035788.1,76107723,76109050,76107723,76109050,111115596,XM_022454385.1,uncharacterized LOC111115596,1327
NC_035788.1,56904144,56915046,56904144,56915046,111115599,XM_022454391.1,uncharacterized LOC111115599,10902
NC_035788.1,56904144,56915046,56909849,56915046,111115599,XM_022454390.1,uncharacterized LOC111115599,5197
NC_035788.1,56904144,56915046,56909812,56915046,111115599,XM_022454389.1,uncharacterized LOC111115599,5234
NC_035788.1,99343438,99353383,99343438,99353383,111115601,XM_022454392.1,uncharacterized LOC111115601,9945
NC_035788.1,99350983,99352455,99350983,99352455,111115602,XM_022454393.1,uncharacterized LOC111115602,1472
NC_035788.1,73830083,73832901,73830083,73831937,111115604,XM_022454397.1,uncharacterized LOC111115604,1854
NC_035788.1,98278083,98290197,98278083,98290197,111115605,XM_022454399.1,uncharacterized LOC111115605,12114
NC_035788.1,68409855,68414167,68409855,68414167,111115606,XM_022454400.1,uncharacterized LOC111115606,4312
NC_035788.1,35475754,35486280,35475754,35486280,111115608,XM_022454403.1,uncharacterized LOC111115608,10526
NC_035788.1,62853823,62860217,62853823,62860217,111115610,XM_022454404.1,uncharacterized LOC111115610,6394
NC_035780.1,38527614,38531771,38527614,38531771,111115613,XM_022454423.1,uncharacterized LOC111115613,4157
NC_035788.1,88794062,88800292,88794062,88800292,111115618,XM_022454430.1,uncharacterized LOC111115618,6230
NC_035788.1,3669352,3671973,3669352,3671973,111115620,XM_022454431.1,uncharacterized LOC111115620,2621
NC_035788.1,74378182,74384972,74379835,74384972,111115623,XM_022454434.1,uncharacterized LOC111115623,5137
NC_035788.1,74378182,74384972,74378182,74384972,111115623,XM_022454435.1,uncharacterized LOC111115623,6790
NC_035788.1,103355524,103360224,103355525,103360224,111115627,XM_022454444.1,uncharacterized LOC111115627,4699
NC_035788.1,103355524,103360224,103355524,103360224,111115627,XM_022454443.1,uncharacterized LOC111115627,4700
NC_035788.1,70354783,70361107,70354783,70361107,111115628,XM_022454445.1,uncharacterized LOC111115628,6324
NC_035788.1,64850204,64856305,64850204,64856305,111115630,XM_022454447.1,uncharacterized LOC111115630,6101
NC_035788.1,74981186,74989766,74981332,74989766,111115632,XM_022454448.1,uncharacterized LOC111115632,8434
NC_035788.1,74981186,74989766,74981186,74989766,111115632,XM_022454449.1,uncharacterized LOC111115632,8580
NC_035788.1,37278789,37283384,37278789,37283384,111115634,XM_022454451.1,uncharacterized LOC111115634,4595
NC_035788.1,76777194,76782867,76777194,76782867,111115636,XM_022454454.1,uncharacterized LOC111115636,5673
NC_035788.1,90895366,90902928,90895366,90902928,111115637,XM_022454455.1,uncharacterized LOC111115637,7562
NC_035788.1,54387551,54390670,54387551,54390670,111115641,XM_022454460.1,uncharacterized LOC111115641,3119
NC_035788.1,59898608,59901214,59898608,59901214,111115644,XM_022454465.1,uncharacterized LOC111115644,2606
NC_035788.1,35160666,35167718,35160666,35167718,111115645,XM_022454466.1,uncharacterized LOC111115645,7052
NC_035788.1,15558854,15563395,15558854,15563395,111115646,XM_022454467.1,uncharacterized LOC111115646,4541
NC_035780.1,34545794,34552749,34545794,34552749,111115651,XM_022454476.1,uncharacterized LOC111115651,6955
NC_035788.1,824069,826247,824069,826247,111115653,XM_022454475.1,uncharacterized LOC111115653,2178
NC_035788.1,560846,568579,560846,568579,111115655,XM_022454478.1,uncharacterized LOC111115655,7733
NC_035788.1,74475684,74481117,74475684,74481117,111115656,XM_022454479.1,uncharacterized LOC111115656,5433
NC_035788.1,24086713,24112886,24086713,24112886,111115658,XM_022454483.1,uncharacterized LOC111115658,26173
NC_035780.1,63296179,63301503,63299019,63301503,111115659,XM_022454493.1,uncharacterized LOC111115659,2484
NC_035780.1,63296179,63301503,63296179,63301503,111115659,XM_022454487.1,uncharacterized LOC111115659,5324
NC_035788.1,58544779,58550495,58544779,58550494,111115670,XM_022454497.1,uncharacterized LOC111115670,5715
NC_035788.1,58544779,58550495,58544779,58550495,111115670,XM_022454495.1,uncharacterized LOC111115670,5716
NC_035788.1,62475553,62477873,62475553,62477873,111115671,XM_022454498.1,uncharacterized LOC111115671,2320
NC_035788.1,61502478,61508387,61502478,61508387,111115673,XM_022454500.1,uncharacterized LOC111115673,5909
NC_035788.1,390252,399467,396160,399467,111115674,XM_022454501.1,uncharacterized LOC111115674,3307
NC_035788.1,390252,399467,390252,399467,111115674,XM_022454502.1,uncharacterized LOC111115674,9215
NC_035788.1,5281195,5298493,5281195,5298493,111115677,XM_022454503.1,uncharacterized LOC111115677,17298
NC_035788.1,49334417,49341824,49334417,49341824,111115684,XM_022454512.1,uncharacterized LOC111115684,7407
NC_035788.1,88305786,88307802,88305786,88307802,111115685,XM_022454513.1,uncharacterized LOC111115685,2016
NC_035788.1,88310904,88313010,88310904,88313010,111115686,XM_022454514.1,uncharacterized LOC111115686,2106
NC_035788.1,88315763,88317864,88315763,88317864,111115687,XM_022454515.1,uncharacterized LOC111115687,2101
NC_035788.1,53823936,53828945,53823936,53828945,111115689,XM_022454517.1,uncharacterized LOC111115689,5009
NC_035788.1,22312120,22314061,22312120,22314061,111115691,XM_022454520.1,uncharacterized LOC111115691,1941
NC_035788.1,23854240,23862459,23856827,23862459,111115704,XM_022454534.1,uncharacterized LOC111115704,5632
NC_035788.1,23854240,23862459,23854240,23862459,111115704,XM_022454535.1,uncharacterized LOC111115704,8219
NC_035788.1,11989738,11993807,11989738,11993807,111115705,XM_022454536.1,uncharacterized LOC111115705,4069
NC_035788.1,92513092,92519075,92513092,92519075,111115708,XM_022454540.1,uncharacterized LOC111115708,5983
NC_035788.1,3419311,3428436,3419311,3428436,111115709,XM_022454541.1,uncharacterized LOC111115709,9125
NC_035788.1,8223306,8225053,8223606,8225053,111115711,XM_022454543.1,uncharacterized LOC111115711,1447
NC_035788.1,8223306,8225053,8223306,8225053,111115711,XM_022454542.1,uncharacterized LOC111115711,1747
NC_035788.1,80942126,80959890,80942126,80959890,111115712,XM_022454544.1,uncharacterized LOC111115712,17764
NC_035788.1,80935130,80945713,80935130,80945713,111115713,XM_022454546.1,uncharacterized LOC111115713,10583
NC_035788.1,23896976,23907709,23896976,23907709,111115717,XM_022454550.1,uncharacterized LOC111115717,10733
NC_035788.1,54193985,54202124,54193985,54201739,111115718,XM_022454553.1,uncharacterized LOC111115718,7754
NC_035788.1,54193985,54202124,54193986,54202124,111115718,XM_022454552.1,uncharacterized LOC111115718,8138
NC_035788.1,63360754,63361785,63360754,63361785,111115722,XM_022454558.1,uncharacterized LOC111115722,1031
NC_035788.1,85525646,85526769,85525646,85526769,111115723,XM_022454559.1,uncharacterized LOC111115723,1123
NC_035788.1,31623059,31625637,31623059,31625637,111115727,XM_022454563.1,uncharacterized LOC111115727,2578
NC_035788.1,57949977,57955539,57949977,57955539,111115730,XM_022454565.1,uncharacterized LOC111115730,5562
NC_035788.1,58137145,58144335,58137145,58144335,111115731,XM_022454567.1,uncharacterized LOC111115731,7190
NC_035788.1,58243363,58246902,58243363,58246902,111115732,XM_022454569.1,uncharacterized LOC111115732,3539
NC_035788.1,57883316,57886792,57883316,57886792,111115733,XM_022454570.1,uncharacterized LOC111115733,3476
NC_035788.1,57986818,57990054,57986818,57990054,111115734,XM_022454571.1,uncharacterized LOC111115734,3236
NC_035788.1,57944884,57948145,57944884,57948145,111115735,XM_022454572.1,uncharacterized LOC111115735,3261
NC_035788.1,58051334,58054737,58051334,58054737,111115736,XM_022454573.1,uncharacterized LOC111115736,3403
NC_035780.1,16929011,16930462,16929011,16930422,111115737,XM_022454585.1,uncharacterized LOC111115737,1411
NC_035780.1,16929011,16930462,16929011,16930462,111115737,XM_022454577.1,uncharacterized LOC111115737,1451
NC_035788.1,58174965,58177567,58174965,58177567,111115738,XM_022454574.1,uncharacterized LOC111115738,2602
NC_035788.1,58226905,58228975,58226905,58228975,111115739,XM_022454575.1,uncharacterized LOC111115739,2070
NC_035788.1,58239097,58242162,58239225,58242162,111115746,XM_022454590.1,uncharacterized LOC111115746,2937
NC_035788.1,58239097,58242162,58239097,58242162,111115746,XM_022454589.1,uncharacterized LOC111115746,3065
NC_035788.1,57919509,57925551,57922725,57925551,111115747,XM_022454593.1,uncharacterized LOC111115747,2826
NC_035788.1,57919509,57925551,57919509,57923395,111115747,XM_022454592.1,uncharacterized LOC111115747,3886
NC_035788.1,57993388,58005645,57993388,58005645,111115749,XM_022454594.1,uncharacterized LOC111115749,12257
NC_035788.1,58133320,58137038,58133320,58137038,111115750,XM_022454595.1,uncharacterized LOC111115750,3718
NC_035788.1,58048987,58063649,58048987,58063649,111115753,XM_022454599.1,uncharacterized LOC111115753,14662
NC_035788.1,30159750,30165572,30161887,30165572,111115761,XM_022454603.1,uncharacterized LOC111115761,3685
NC_035788.1,2381338,2385607,2381338,2385607,111115763,XM_022454604.1,uncharacterized LOC111115763,4269
NC_035780.1,43909715,43929647,43909886,43929647,111115766,XM_022454616.1,uncharacterized LOC111115766,19761
NC_035780.1,43909715,43929647,43909715,43929647,111115766,XM_022454610.1,uncharacterized LOC111115766,19932
NC_035788.1,5945190,5949200,5945190,5949200,111115773,XM_022454613.1,uncharacterized LOC111115773,4010
NC_035788.1,91978270,91980779,91978270,91980779,111115777,XM_022454620.1,uncharacterized LOC111115777,2509
NC_035788.1,84568997,84577195,84568997,84577195,111115779,XM_022454622.1,uncharacterized LOC111115779,8198
NC_035788.1,84463318,84475261,84463318,84475261,111115780,XM_022454623.1,uncharacterized LOC111115780,11943
NC_035788.1,84463318,84475261,84463318,84473081,111115780,XM_022454624.1,uncharacterized LOC111115780,9763
NC_035788.1,64778367,64780693,64778367,64780693,111115783,XM_022454626.1,uncharacterized LOC111115783,2326
NC_035788.1,94461727,94471291,94461727,94471291,111115785,XM_022454628.1,uncharacterized LOC111115785,9564
NC_035788.1,94455134,94461628,94455134,94461628,111115786,XM_022454629.1,uncharacterized LOC111115786,6494
NC_035788.1,74331935,74337544,74331935,74337544,111115788,XM_022454630.1,uncharacterized LOC111115788,5609
NC_035788.1,92592596,92611207,92592596,92611207,111115793,XM_022454636.1,uncharacterized LOC111115793,18611
NC_035788.1,54248529,54260716,54248529,54260716,111115796,XM_022454656.1,uncharacterized LOC111115796,12187
NC_035788.1,103133847,103136408,103133847,103136408,111115799,XM_022454660.1,uncharacterized LOC111115799,2561
NC_035780.1,37652768,37654778,37652768,37654778,111115800,XM_022454664.1,uncharacterized LOC111115800,2010
NC_035788.1,67819822,67825573,67819822,67825573,111115802,XM_022454662.1,uncharacterized LOC111115802,5751
NC_035788.1,5344763,5364202,5344763,5364202,111115805,XM_022454665.1,uncharacterized LOC111115805,19439
NC_035788.1,15232643,15245231,15232643,15245231,111115807,XM_022454669.1,uncharacterized LOC111115807,12588
NC_035780.1,42914113,42917060,42914113,42917060,111115811,XM_022454674.1,uncharacterized LOC111115811,2947
NC_035788.1,8928996,8931725,8929600,8931725,111115814,XM_022454673.1,uncharacterized LOC111115814,2125
NC_035788.1,8928996,8931725,8928996,8931725,111115814,XM_022454675.1,uncharacterized LOC111115814,2729
NC_035788.1,50101525,50104877,50101525,50104877,111115817,XM_022454680.1,uncharacterized LOC111115817,3352
NC_035788.1,40045289,40046933,40045289,40046933,111115818,XM_022454681.1,uncharacterized LOC111115818,1644
NC_035780.1,33763065,33764731,33763065,33764731,111115821,XM_022454687.1,uncharacterized LOC111115821,1666
NC_035788.1,5775339,5786899,5775339,5786899,111115823,XM_022454684.1,uncharacterized LOC111115823,11560
NC_035788.1,59737711,59740287,59737711,59740287,111115827,XM_022454689.1,uncharacterized LOC111115827,2576
NC_035788.1,9936428,9937813,9936428,9937813,111115830,XM_022454691.1,uncharacterized LOC111115830,1385
NC_035788.1,69792795,69804340,69792795,69804340,111115831,XM_022454692.1,uncharacterized LOC111115831,11545
NC_035788.1,69799594,69803792,69799594,69803792,111115833,XM_022454693.1,uncharacterized LOC111115833,4198
NC_035788.1,34985737,35056560,34985737,35056560,111115834,XM_022454694.1,uncharacterized LOC111115834,70823
NC_035788.1,81281033,81285671,81281033,81285671,111115836,XM_022454698.1,uncharacterized LOC111115836,4638
NC_035788.1,5695704,5702918,5695704,5702918,111115837,XM_022454699.1,uncharacterized LOC111115837,7214
NC_035788.1,4836722,4845634,4836722,4845634,111115839,XM_022454701.1,uncharacterized LOC111115839,8912
NC_035788.1,91115048,91121553,91115048,91121553,111115845,XM_022454725.1,uncharacterized LOC111115845,6505
NC_035788.1,90996208,91000229,90996208,91000229,111115846,XM_022454726.1,uncharacterized LOC111115846,4021
NC_035788.1,91208105,91210671,91208105,91210671,111115848,XM_022454728.1,uncharacterized LOC111115848,2566
NC_035788.1,91172272,91174783,91172272,91174783,111115849,XM_022454729.1,uncharacterized LOC111115849,2511
NC_035788.1,91271159,91273688,91271208,91273688,111115850,XM_022454731.1,uncharacterized LOC111115850,2480
NC_035788.1,91271159,91273688,91271159,91273688,111115850,XM_022454730.1,uncharacterized LOC111115850,2529
NC_035788.1,91249878,91254234,91249878,91253535,111115851,XM_022454733.1,uncharacterized LOC111115851,3657
NC_035788.1,91249878,91254234,91249878,91253974,111115851,XM_022454734.1,uncharacterized LOC111115851,4096
NC_035788.1,91249878,91254234,91249878,91254234,111115851,XM_022454735.1,uncharacterized LOC111115851,4356
NC_035788.1,91325644,91332813,91325644,91332813,111115852,XM_022454736.1,uncharacterized LOC111115852,7169
NC_035788.1,90941021,90948222,90941021,90948222,111115853,XM_022454737.1,uncharacterized LOC111115853,7201
NC_035788.1,90992066,90993591,90992066,90993591,111115854,XM_022454738.1,uncharacterized LOC111115854,1525
NC_035780.1,45282489,45309067,45282489,45309053,111115857,XM_022454751.1,uncharacterized LOC111115857,26564
NC_035780.1,45282489,45309067,45282489,45309067,111115857,XM_022454744.1,uncharacterized LOC111115857,26578
NC_035788.1,90960459,90974573,90960459,90974573,111115859,XM_022454742.1,uncharacterized LOC111115859,14114
NC_035788.1,91286343,91294356,91286343,91294356,111115860,XM_022454743.1,uncharacterized LOC111115860,8013
NC_035788.1,91352364,91355660,91352364,91355660,111115862,XM_022454746.1,uncharacterized LOC111115862,3296
NC_035788.1,91266577,91270829,91266577,91270829,111115864,XM_022454748.1,uncharacterized LOC111115864,4252
NC_035788.1,91342027,91349971,91342027,91349971,111115865,XM_022454749.1,uncharacterized LOC111115865,7944
NC_035788.1,93090181,93098140,93090181,93098140,111115867,XM_022454750.1,uncharacterized LOC111115867,7959
NC_035788.1,54458991,54462622,54458991,54462622,111115870,XM_022454755.1,uncharacterized LOC111115870,3631
NC_035780.1,21390802,21473282,21390802,21473282,111115873,XM_022454773.1,uncharacterized LOC111115873,82480
NC_035788.1,92327898,92329772,92327898,92329772,111115874,XM_022454760.1,uncharacterized LOC111115874,1874
NC_035788.1,56175979,56227050,56175979,56227041,111115876,XM_022454764.1,uncharacterized LOC111115876,51062
NC_035788.1,56175979,56227050,56175979,56227050,111115876,XM_022454762.1,uncharacterized LOC111115876,51071
NC_035788.1,764478,768977,764478,768977,111115877,XM_022454766.1,uncharacterized LOC111115877,4499
NC_035788.1,19819218,19821175,19819218,19821175,111115880,XM_022454778.1,uncharacterized LOC111115880,1957
NC_035788.1,98075696,98079277,98075696,98079277,111115881,XM_022454779.1,uncharacterized LOC111115881,3581
NC_035788.1,95723613,95738825,95727600,95738825,111115885,XM_022454784.1,uncharacterized LOC111115885,11225
NC_035788.1,95723613,95738825,95723613,95738825,111115885,XM_022454785.1,uncharacterized LOC111115885,15212
NC_035788.1,91363022,91365638,91363022,91365638,111115886,XM_022454786.1,uncharacterized LOC111115886,2616
NC_035780.1,21493281,21528955,21493281,21528955,111115889,XM_022454793.1,uncharacterized LOC111115889,35674
NC_035788.1,75259902,75263932,75259902,75263932,111115891,XM_022454794.1,uncharacterized LOC111115891,4030
NC_035788.1,98508121,98509875,98508121,98509875,111115893,XM_022454795.1,uncharacterized LOC111115893,1754
NC_035788.1,51537564,51543987,51537564,51543987,111115896,XM_022454807.1,uncharacterized LOC111115896,6423
NC_035788.1,17800246,17824939,17808009,17822047,111115900,XM_022454812.1,uncharacterized LOC111115900,14038
NC_035788.1,102359698,102387583,102359698,102387583,111115901,XM_022454814.1,uncharacterized LOC111115901,27885
NC_035788.1,90423782,90425922,90423782,90425922,111115903,XM_022454816.1,uncharacterized LOC111115903,2140
NC_035788.1,72553249,72560146,72553249,72560146,111115906,XM_022454819.1,uncharacterized LOC111115906,6897
NC_035780.1,21520391,21524607,21520391,21522036,111115907,XM_022454823.1,uncharacterized LOC111115907,1645
NC_035780.1,21520391,21524607,21520391,21524607,111115907,XM_022454832.1,uncharacterized LOC111115907,4216
NC_035788.1,31643607,31650465,31643607,31650465,111115909,XM_022454822.1,uncharacterized LOC111115909,6858
NC_035788.1,77933855,77970603,77933855,77951351,111115912,XM_022454828.1,uncharacterized LOC111115912,17496
NC_035788.1,77933855,77970603,77933855,77970603,111115912,XM_022454827.1,uncharacterized LOC111115912,36748
NC_035788.1,77933855,77970603,77933855,77940110,111115912,XM_022454829.1,uncharacterized LOC111115912,6255
NC_035788.1,9740125,9741478,9740125,9741478,111115913,XM_022454830.1,uncharacterized LOC111115913,1353
NC_035788.1,1902056,1909417,1902056,1909417,111115915,XM_022454833.1,uncharacterized LOC111115915,7361
NC_035788.1,49588194,49638290,49625030,49627556,111115920,XM_022454838.1,uncharacterized LOC111115920,2526
NC_035788.1,49588194,49638290,49625020,49627556,111115920,XM_022454840.1,uncharacterized LOC111115920,2536
NC_035788.1,49588194,49638290,49624984,49627556,111115920,XM_022454837.1,uncharacterized LOC111115920,2572
NC_035788.1,49588194,49638290,49588194,49624547,111115920,XM_022454848.1,uncharacterized LOC111115920,36353
NC_035788.1,49588194,49638290,49588194,49624841,111115920,XM_022454846.1,uncharacterized LOC111115920,36647
NC_035788.1,49588194,49638290,49588194,49627556,111115920,XM_022454841.1,uncharacterized LOC111115920,39362
NC_035788.1,49588194,49638290,49588194,49638290,111115920,XM_022454836.1,uncharacterized LOC111115920,50096
NC_035780.1,860083,865303,860083,865303,111115921,XM_022454956.1,uncharacterized LOC111115921,5220
NC_035788.1,61484005,61496911,61484005,61496911,111115926,XM_022454850.1,uncharacterized LOC111115926,12906
NC_035780.1,3752583,3757797,3752583,3757797,111115930,XM_022454856.1,uncharacterized LOC111115930,5214
NC_035788.1,22865683,22870052,22865683,22870052,111115934,XM_022454858.1,uncharacterized LOC111115934,4369
NC_035788.1,63551648,63555027,63551648,63555027,111115935,XM_022454859.1,uncharacterized LOC111115935,3379
NC_035788.1,75022115,75035849,75022115,75035849,111115936,XM_022454860.1,uncharacterized LOC111115936,13734
NC_035788.1,64300291,64311352,64300372,64311352,111115949,XM_022454876.1,uncharacterized LOC111115949,10980
NC_035788.1,64300291,64311352,64307707,64311352,111115949,XM_022454877.1,uncharacterized LOC111115949,3645
NC_035788.1,64300291,64311352,64300291,64305386,111115949,XM_022454875.1,uncharacterized LOC111115949,5095
NC_035788.1,35130709,35134465,35130709,35134465,111115954,XM_022454881.1,uncharacterized LOC111115954,3756
NC_035788.1,51669493,51674383,51669503,51674383,111115955,XM_022454883.1,uncharacterized LOC111115955,4880
NC_035788.1,51669493,51674383,51669493,51674383,111115955,XM_022454882.1,uncharacterized LOC111115955,4890
NC_035788.1,84819535,84824638,84819535,84824638,111115956,XM_022454884.1,uncharacterized LOC111115956,5103
NC_035788.1,84851598,84856587,84851598,84856587,111115957,XM_022454885.1,uncharacterized LOC111115957,4989
NC_035788.1,84838869,84840611,84838869,84840611,111115958,XM_022454886.1,uncharacterized LOC111115958,1742
NC_035788.1,75723074,75725757,75723074,75725757,111115961,XM_022454887.1,uncharacterized LOC111115961,2683
NC_035788.1,75739333,75749032,75739333,75744912,111115962,XM_022454892.1,uncharacterized LOC111115962,5579
NC_035788.1,75739333,75749032,75739333,75746785,111115962,XM_022454891.1,uncharacterized LOC111115962,7452
NC_035788.1,75739333,75749032,75739333,75747992,111115962,XM_022454889.1,uncharacterized LOC111115962,8659
NC_035788.1,75739333,75749032,75739333,75749032,111115962,XM_022454888.1,uncharacterized LOC111115962,9699
NC_035788.1,75749794,75762070,75749794,75762070,111115964,XM_022454894.1,uncharacterized LOC111115964,12276
NC_035788.1,75699360,75707466,75699360,75707466,111115966,XM_022454896.1,uncharacterized LOC111115966,8106
NC_035780.1,62700363,62705071,62700363,62705071,111115968,XM_022454902.1,uncharacterized LOC111115968,4708
NC_035788.1,103030078,103031979,103030078,103031979,111115970,XM_022454901.1,uncharacterized LOC111115970,1901
NC_035788.1,17979719,17982510,17979719,17982510,111115971,XM_022454903.1,uncharacterized LOC111115971,2791
NC_035788.1,77667600,77670590,77667600,77670590,111115974,XM_022454910.1,uncharacterized LOC111115974,2990
NC_035788.1,77662683,77667471,77663068,77667471,111115976,XM_022454912.1,uncharacterized LOC111115976,4403
NC_035788.1,77662683,77667471,77662683,77667471,111115976,XM_022454911.1,uncharacterized LOC111115976,4788
NC_035788.1,54230226,54240230,54230226,54240229,111115979,XM_022454917.1,uncharacterized LOC111115979,10003
NC_035788.1,54230226,54240230,54230226,54240230,111115979,XM_022454919.1,uncharacterized LOC111115979,10004
NC_035788.1,54230226,54240230,54230568,54240229,111115979,XM_022454918.1,uncharacterized LOC111115979,9661
NC_035780.1,3879644,3900475,3879644,3900471,111115980,XM_022454929.1,uncharacterized LOC111115980,20827
NC_035780.1,3879644,3900475,3879644,3900475,111115980,XM_022454938.1,uncharacterized LOC111115980,20831
NC_035788.1,24267572,24280492,24267572,24280492,111115982,XM_022454932.1,uncharacterized LOC111115982,12920
NC_035788.1,24267572,24280492,24267572,24269135,111115982,XM_022454933.1,uncharacterized LOC111115982,1563
NC_035788.1,24267572,24280492,24267572,24272474,111115982,XM_022454931.1,uncharacterized LOC111115982,4902
NC_035788.1,24267572,24280492,24267572,24272496,111115982,XM_022454930.1,uncharacterized LOC111115982,4924
NC_035788.1,30691350,30693629,30691350,30693629,111115988,XM_022454940.1,uncharacterized LOC111115988,2279
NC_035788.1,64653241,64658835,64653241,64658835,111115989,XM_022454941.1,uncharacterized LOC111115989,5594
NC_035788.1,16177374,16180769,16177374,16180769,111115990,XM_022454942.1,uncharacterized LOC111115990,3395
NC_035788.1,95596226,95599366,95596226,95599366,111115991,XM_022454943.1,uncharacterized LOC111115991,3140
NC_035788.1,67985719,67995676,67985719,67991163,111115995,XM_022454950.1,uncharacterized LOC111115995,5444
NC_035788.1,67985719,67995676,67985719,67991521,111115995,XM_022454951.1,uncharacterized LOC111115995,5802
NC_035788.1,67985719,67995676,67985719,67991961,111115995,XM_022454947.1,uncharacterized LOC111115995,6242
NC_035788.1,67985719,67995676,67985719,67992979,111115995,XM_022454952.1,uncharacterized LOC111115995,7260
NC_035788.1,67985719,67995676,67985719,67995676,111115995,XM_022454948.1,uncharacterized LOC111115995,9957
NC_035788.1,88766260,88779055,88768205,88779055,111115998,XM_022454954.1,uncharacterized LOC111115998,10850
NC_035788.1,88766260,88779055,88766260,88779055,111115998,XM_022454955.1,uncharacterized LOC111115998,12795
NC_035788.1,88766260,88779055,88775529,88779055,111115998,XM_022454953.1,uncharacterized LOC111115998,3526
NC_035788.1,37849733,37852093,37849733,37852093,111116002,XM_022454959.1,uncharacterized LOC111116002,2360
NC_035780.1,47575383,47576510,47575383,47576510,111116004,XM_022454974.1,uncharacterized LOC111116004,1127
NC_035788.1,34852058,34860482,34852058,34860482,111116006,XM_022454973.1,uncharacterized LOC111116006,8424
NC_035788.1,80900470,80901440,80900470,80901440,111116009,XM_022454976.1,uncharacterized LOC111116009,970
NC_035788.1,52503210,52515816,52503210,52515555,111116011,XM_022454977.1,uncharacterized LOC111116011,12345
NC_035788.1,52503210,52515816,52503210,52515765,111116011,XM_022454978.1,uncharacterized LOC111116011,12555
NC_035788.1,52503210,52515816,52503210,52515816,111116011,XM_022454979.1,uncharacterized LOC111116011,12606
NC_035788.1,74546842,74553437,74546842,74553437,111116014,XM_022454981.1,uncharacterized LOC111116014,6595
NC_035788.1,13361169,13362820,13361169,13362820,111116015,XM_022454982.1,uncharacterized LOC111116015,1651
NC_035788.1,3491569,3493092,3491569,3493092,111116016,XM_022454983.1,uncharacterized LOC111116016,1523
NC_035788.1,84149834,84179119,84149834,84179119,111116021,XM_022454987.1,uncharacterized LOC111116021,29285
NC_035788.1,50698408,50699746,50698408,50699746,111116023,XM_022454989.1,uncharacterized LOC111116023,1338
NC_035788.1,5899022,5912836,5899022,5912836,111116025,XM_022454990.1,uncharacterized LOC111116025,13814
NC_035788.1,92300849,92304531,92300849,92304531,111116026,XM_022454991.1,uncharacterized LOC111116026,3682
NC_035788.1,35754789,35765128,35754789,35765128,111116028,XM_022454993.1,uncharacterized LOC111116028,10339
NC_035788.1,31814265,31816111,31814265,31816111,111116032,XM_022454998.1,uncharacterized LOC111116032,1846
NC_035780.1,3603654,3635803,3603654,3635803,111116034,XM_022455003.1,uncharacterized LOC111116034,32149
NC_035788.1,35503818,35520056,35503818,35520056,111116036,XM_022455002.1,uncharacterized LOC111116036,16238
NC_035788.1,1584307,1598636,1584307,1595526,111116037,XM_022455004.1,uncharacterized LOC111116037,11219
NC_035788.1,73742753,73748609,73742753,73748609,111116039,XM_022455006.1,uncharacterized LOC111116039,5856
NC_035788.1,30669161,30672127,30669161,30672127,111116041,XM_022455008.1,uncharacterized LOC111116041,2966
NC_035780.1,3605677,3608565,3605677,3608565,111116043,XM_022455016.1,uncharacterized LOC111116043,2888
NC_035780.1,34315410,34344745,34315410,34344745,111116044,XM_022455031.1,uncharacterized LOC111116044,29335
NC_035788.1,83616932,83620653,83616932,83620653,111116052,XM_022455035.1,uncharacterized LOC111116052,3721
NC_035788.1,74157672,74159985,74157672,74159985,111116057,XM_022455044.1,uncharacterized LOC111116057,2313
NC_035788.1,3658593,3664338,3658593,3664338,111116058,XM_022455045.1,uncharacterized LOC111116058,5745
NC_035788.1,69287503,69300411,69287503,69300411,111116066,XM_022455053.1,uncharacterized LOC111116066,12908
NC_035788.1,66322240,66327725,66322240,66327725,111116068,XM_022455055.1,uncharacterized LOC111116068,5485
NC_035788.1,12038706,12041675,12038706,12041570,111116071,XM_022455057.1,uncharacterized LOC111116071,2864
NC_035788.1,12035679,12042420,12035679,12042420,111116072,XM_022455058.1,uncharacterized LOC111116072,6741
NC_035788.1,12043888,12048064,12043888,12048064,111116073,XM_022455059.1,uncharacterized LOC111116073,4176
NC_035788.1,18589679,18593495,18589679,18593495,111116074,XM_022455060.1,uncharacterized LOC111116074,3816
NC_035788.1,83386052,83388239,83386052,83388239,111116078,XM_022455062.1,uncharacterized LOC111116078,2187
NC_035788.1,2325527,2327167,2325527,2327167,111116079,XM_022455063.1,uncharacterized LOC111116079,1640
NC_035788.1,92668646,92687442,92668646,92687442,111116081,XM_022455066.1,uncharacterized LOC111116081,18796
NC_035788.1,32183677,32186725,32183677,32186725,111116084,XM_022455069.1,uncharacterized LOC111116084,3048
NC_035780.1,35452505,35458102,35452505,35458102,111116086,XM_022455076.1,uncharacterized LOC111116086,5597
NC_035788.1,100105355,100134708,100105355,100134708,111116087,XM_022455072.1,uncharacterized LOC111116087,29353
NC_035788.1,99815144,100032219,99815144,100032219,111116088,XM_022455074.1,uncharacterized LOC111116088,217075
NC_035788.1,99815144,100032219,99815144,99838640,111116088,XM_022455079.1,uncharacterized LOC111116088,23496
NC_035788.1,99815144,100032219,99815144,99841685,111116088,XM_022455078.1,uncharacterized LOC111116088,26541
NC_035788.1,99815144,100032219,99815144,99842377,111116088,XM_022455077.1,uncharacterized LOC111116088,27233
NC_035788.1,99660446,99686946,99660446,99686946,111116089,XM_022455080.1,uncharacterized LOC111116089,26500
NC_035788.1,99429905,99444226,99429905,99444226,111116095,XM_022455086.1,uncharacterized LOC111116095,14321
NC_035788.1,99846329,99876292,99846329,99876292,111116096,XM_022455088.1,uncharacterized LOC111116096,29963
NC_035788.1,99373255,99382397,99373255,99382397,111116097,XM_022455089.1,uncharacterized LOC111116097,9142
NC_035788.1,99446826,99456160,99446832,99453059,111116098,XM_022455094.1,uncharacterized LOC111116098,6227
NC_035788.1,99446826,99456160,99447978,99456160,111116098,XM_022455093.1,uncharacterized LOC111116098,8182
NC_035788.1,99446826,99456160,99446828,99456160,111116098,XM_022455092.1,uncharacterized LOC111116098,9332
NC_035788.1,99446826,99456160,99446827,99456160,111116098,XM_022455090.1,uncharacterized LOC111116098,9333
NC_035788.1,99446826,99456160,99446826,99456160,111116098,XM_022455095.1,uncharacterized LOC111116098,9334
NC_035788.1,99414093,99423204,99414093,99423204,111116099,XM_022455097.1,uncharacterized LOC111116099,9111
NC_035788.1,99933007,99936180,99933007,99936180,111116105,XM_022455104.1,uncharacterized LOC111116105,3173
NC_035788.1,100010101,100016587,100010101,100016587,111116106,XM_022455105.1,uncharacterized LOC111116106,6486
NC_035788.1,99556249,99558173,99556249,99558173,111116108,XM_022455107.1,uncharacterized LOC111116108,1924
NC_035788.1,37556870,37558982,37556870,37558982,111116122,XM_022455110.1,uncharacterized LOC111116122,2112
NC_035788.1,71913219,71943356,71913219,71943356,111116123,XM_022455112.1,uncharacterized LOC111116123,30137
NC_035788.1,36488588,36500623,36488588,36500623,111116131,XM_022455131.1,uncharacterized LOC111116131,12035
NC_035788.1,36983938,36988794,36983938,36988794,111116132,XM_022455132.1,uncharacterized LOC111116132,4856
NC_035788.1,57663668,57672981,57663668,57672605,111116136,XM_022455139.1,uncharacterized LOC111116136,8937
NC_035788.1,57663668,57672981,57663668,57672981,111116136,XM_022455137.1,uncharacterized LOC111116136,9313
NC_035788.1,57697096,57698593,57697096,57698593,111116138,XM_022455141.1,uncharacterized LOC111116138,1497
NC_035788.1,53742423,53746102,53742423,53746102,111116140,XM_022455143.1,uncharacterized LOC111116140,3679
NC_035788.1,55508144,55588953,55508144,55588953,111116144,XM_022455145.1,uncharacterized LOC111116144,80809
NC_035788.1,78805476,78809860,78805476,78809860,111116160,XM_022455160.1,uncharacterized LOC111116160,4384
NC_035788.1,59624245,59626852,59624245,59626680,111116161,XM_022455162.1,uncharacterized LOC111116161,2435
NC_035788.1,59624245,59626852,59624247,59626852,111116161,XM_022455161.1,uncharacterized LOC111116161,2605
NC_035788.1,59621701,59624215,59621701,59624215,111116162,XM_022455163.1,uncharacterized LOC111116162,2514
NC_035788.1,64819128,64823170,64819128,64823170,111116163,XM_022455165.1,uncharacterized LOC111116163,4042
NC_035788.1,66047051,66058156,66047051,66058156,111116168,XM_022455169.1,uncharacterized LOC111116168,11105
NC_035788.1,101671445,101676101,101671445,101676101,111116169,XM_022455170.1,uncharacterized LOC111116169,4656
NC_035780.1,4382243,4388459,4382243,4388459,111116170,XM_022455174.1,uncharacterized LOC111116170,6216
NC_035788.1,16985508,16986692,16985508,16986692,111116171,XM_022455171.1,uncharacterized LOC111116171,1184
NC_035788.1,25013136,25015631,25013136,25015631,111116175,XM_022455175.1,uncharacterized LOC111116175,2495
NC_035788.1,91553608,91575816,91553608,91575531,111116176,XM_022455178.1,uncharacterized LOC111116176,21923
NC_035788.1,91553608,91575816,91553608,91575532,111116176,XM_022455176.1,uncharacterized LOC111116176,21924
NC_035788.1,91553608,91575816,91553608,91575816,111116176,XM_022455177.1,uncharacterized LOC111116176,22208
NC_035780.1,34140016,34143986,34140016,34143986,111116190,XM_022455181.1,uncharacterized LOC111116190,3970
NC_035789.1,3518006,3536135,3518006,3533776,111116193,XM_022455180.1,uncharacterized LOC111116193,15770
NC_035789.1,3518006,3536135,3518006,3536135,111116193,XM_022455179.1,uncharacterized LOC111116193,18129
NC_035789.1,3516348,3518126,3516348,3518126,111116194,XM_022455182.1,uncharacterized LOC111116194,1778
NC_035789.1,8207620,8225292,8207620,8225292,111116195,XM_022455183.1,uncharacterized LOC111116195,17672
NC_035789.1,28383893,28391537,28383893,28391537,111116196,XM_022455184.1,uncharacterized LOC111116196,7644
NC_035789.1,28379405,28383899,28380774,28383899,111116197,XM_022455185.1,uncharacterized LOC111116197,3125
NC_035789.1,28379405,28383899,28379405,28383899,111116197,XM_022455186.1,uncharacterized LOC111116197,4494
NC_035780.1,62456533,62466799,62456553,62466799,111116201,XM_022455198.1,uncharacterized LOC111116201,10246
NC_035780.1,62456533,62466799,62456533,62466799,111116201,XM_022455189.1,uncharacterized LOC111116201,10266
NC_035789.1,12997466,13001717,12997466,13001717,111116206,XM_022455190.1,uncharacterized LOC111116206,4251
NC_035789.1,4458535,4462052,4458535,4462052,111116207,XM_022455191.1,uncharacterized LOC111116207,3517
NC_035789.1,19712945,19715867,19712945,19715867,111116208,XM_022455192.1,uncharacterized LOC111116208,2922
NC_035789.1,8118403,8124886,8118422,8124886,111116218,XM_022455201.1,uncharacterized LOC111116218,6464
NC_035789.1,8118403,8124886,8118403,8124886,111116218,XM_022455202.1,uncharacterized LOC111116218,6483
NC_035789.1,16470374,16471138,16470374,16471138,111116221,XM_022455204.1,uncharacterized LOC111116221,764
NC_035789.1,11653992,11654690,11653992,11654690,111116222,XM_022455205.1,uncharacterized LOC111116222,698
NC_035789.1,7056115,7058776,7056115,7058776,111116223,XM_022455206.1,uncharacterized LOC111116223,2661
NC_035789.1,7065429,7066616,7065429,7066616,111116224,XM_022455208.1,uncharacterized LOC111116224,1187
NC_035789.1,7073288,7078313,7073288,7078313,111116225,XM_022455209.1,uncharacterized LOC111116225,5025
NC_035789.1,7169815,7173749,7169815,7173749,111116226,XM_022455210.1,uncharacterized LOC111116226,3934
NC_035789.1,7352634,7354224,7352634,7354224,111116228,XM_022455211.1,uncharacterized LOC111116228,1590
NC_035789.1,7811024,7811981,7811024,7811981,111116240,XM_022455225.1,uncharacterized LOC111116240,957
NC_035789.1,8019709,8030501,8019709,8030501,111116241,XM_022455226.1,uncharacterized LOC111116241,10792
NC_035789.1,8181327,8187153,8181327,8187153,111116243,XM_022455228.1,uncharacterized LOC111116243,5826
NC_035789.1,8232106,8242795,8232106,8242795,111116244,XM_022455230.1,uncharacterized LOC111116244,10689
NC_035789.1,8302516,8321301,8302516,8321301,111116245,XM_022455231.1,uncharacterized LOC111116245,18785
NC_035789.1,8335684,8361481,8335684,8361481,111116246,XM_022455232.1,uncharacterized LOC111116246,25797
NC_035789.1,8734855,8735541,8734855,8735541,111116252,XM_022455239.1,uncharacterized LOC111116252,686
NC_035780.1,20837339,20843047,20838824,20843047,111116258,XM_022455246.1,uncharacterized LOC111116258,4223
NC_035780.1,20837339,20843047,20837339,20843047,111116258,XM_022455261.1,uncharacterized LOC111116258,5708
NC_035789.1,9171058,9172081,9171058,9172081,111116260,XM_022455245.1,uncharacterized LOC111116260,1023
NC_035789.1,9213831,9221244,9213831,9221244,111116261,XM_022455247.1,uncharacterized LOC111116261,7413
NC_035789.1,9255771,9256484,9255771,9256484,111116262,XM_022455248.1,uncharacterized LOC111116262,713
NC_035789.1,9889566,9891512,9889566,9891512,111116267,XM_022455254.1,uncharacterized LOC111116267,1946
NC_035789.1,9971180,9975486,9971180,9975486,111116268,XM_022455255.1,uncharacterized LOC111116268,4306
NC_035789.1,10090734,10091426,10090734,10091426,111116269,XM_022455256.1,uncharacterized LOC111116269,692
NC_035789.1,10345723,10357496,10345723,10357496,111116272,XM_022455259.1,uncharacterized LOC111116272,11773
NC_035789.1,10481266,10492057,10481266,10492057,111116274,XM_022455262.1,uncharacterized LOC111116274,10791
NC_035789.1,10525032,10530234,10525032,10530234,111116276,XM_022455264.1,uncharacterized LOC111116276,5202
NC_035789.1,10620339,10621064,10620339,10621064,111116277,XM_022455265.1,uncharacterized LOC111116277,725
NC_035789.1,10760670,10761362,10760670,10761362,111116278,XM_022455266.1,uncharacterized LOC111116278,692
NC_035789.1,10929396,10933792,10929396,10933792,111116282,XM_022455270.1,uncharacterized LOC111116282,4396
NC_035789.1,10956125,10961761,10956125,10961761,111116283,XM_022455271.1,uncharacterized LOC111116283,5636
NC_035789.1,10984642,11004065,10984642,11004065,111116284,XM_022455272.1,uncharacterized LOC111116284,19423
NC_035780.1,54982592,54985419,54982592,54985419,111116286,XM_022455277.1,uncharacterized LOC111116286,2827
NC_035789.1,11721463,11721867,11721463,11721867,111116292,XM_022455280.1,uncharacterized LOC111116292,404
NC_035789.1,12126007,12129700,12126007,12129700,111116295,XM_022455283.1,uncharacterized LOC111116295,3693
NC_035789.1,12248744,12251284,12248744,12251284,111116297,XM_022455284.1,uncharacterized LOC111116297,2540
NC_035789.1,12251415,12252683,12251415,12252683,111116298,XM_022455285.1,uncharacterized LOC111116298,1268
NC_035789.1,12312900,12314432,12312900,12314432,111116300,XM_022455287.1,uncharacterized LOC111116300,1532
NC_035789.1,12435306,12436421,12435306,12436421,111116304,XM_022455290.1,uncharacterized LOC111116304,1115
NC_035789.1,12485331,12525387,12485331,12525387,111116305,XM_022455291.1,uncharacterized LOC111116305,40056
NC_035789.1,12645520,12653072,12645520,12653072,111116306,XM_022455292.1,uncharacterized LOC111116306,7552
NC_035789.1,12784826,12785849,12784826,12785849,111116308,XM_022455294.1,uncharacterized LOC111116308,1023
NC_035789.1,12802192,12809091,12802192,12809091,111116309,XM_022455295.1,uncharacterized LOC111116309,6899
NC_035789.1,12897136,12902202,12897136,12902202,111116310,XM_022455296.1,uncharacterized LOC111116310,5066
NC_035789.1,12928026,12930725,12928026,12930725,111116314,XM_022455298.1,uncharacterized LOC111116314,2699
NC_035789.1,13003769,13006731,13003769,13006731,111116317,XM_022455302.1,uncharacterized LOC111116317,2962
NC_035789.1,13010943,13013027,13010943,13013027,111116318,XM_022455303.1,uncharacterized LOC111116318,2084
NC_035789.1,13013538,13023837,13013538,13023837,111116319,XM_022455304.1,uncharacterized LOC111116319,10299
NC_035789.1,13170200,13175091,13170200,13175091,111116321,XM_022455306.1,uncharacterized LOC111116321,4891
NC_035789.1,13232870,13236363,13232870,13236363,111116323,XM_022455307.1,uncharacterized LOC111116323,3493
NC_035789.1,13572104,13583664,13572104,13583664,111116325,XM_022455309.1,uncharacterized LOC111116325,11560
NC_035789.1,13605073,13607032,13605073,13607032,111116327,XM_022455312.1,uncharacterized LOC111116327,1959
NC_035789.1,13608099,13609673,13608099,13609673,111116328,XM_022455313.1,uncharacterized LOC111116328,1574
NC_035789.1,13664593,13667679,13664593,13667679,111116331,XM_022455315.1,uncharacterized LOC111116331,3086
NC_035789.1,13868121,13876706,13868121,13876706,111116334,XM_022455317.1,uncharacterized LOC111116334,8585
NC_035789.1,14078632,14081772,14078632,14081772,111116336,XM_022455320.1,uncharacterized LOC111116336,3140
NC_035789.1,14085883,14086395,14085883,14086395,111116337,XM_022455321.1,uncharacterized LOC111116337,512
NC_035789.1,14211255,14213945,14211255,14213945,111116340,XM_022455324.1,uncharacterized LOC111116340,2690
NC_035780.1,12900773,12904466,12900773,12904466,111116341,XM_022455328.1,uncharacterized LOC111116341,3693
NC_035789.1,14236010,14237083,14236010,14237083,111116342,XM_022455325.1,uncharacterized LOC111116342,1073
NC_035789.1,14251986,14255678,14251986,14255678,111116344,XM_022455327.1,uncharacterized LOC111116344,3692
NC_035789.1,14294683,14300080,14294683,14300080,111116346,XM_022455330.1,uncharacterized LOC111116346,5397
NC_035789.1,14433362,14442341,14433362,14442341,111116348,XM_022455333.1,uncharacterized LOC111116348,8979
NC_035789.1,14549596,14551586,14549596,14551586,111116349,XM_022455334.1,uncharacterized LOC111116349,1990
NC_035789.1,14553778,14566313,14553778,14566313,111116350,XM_022455335.1,uncharacterized LOC111116350,12535
NC_035789.1,14616497,14620156,14616497,14620156,111116351,XM_022455336.1,uncharacterized LOC111116351,3659
NC_035789.1,14670700,14673481,14670700,14673481,111116355,XM_022455339.1,uncharacterized LOC111116355,2781
NC_035789.1,14876789,14885995,14876789,14885995,111116356,XM_022455341.1,uncharacterized LOC111116356,9206
NC_035789.1,14902490,14903965,14902490,14903965,111116357,XM_022455342.1,uncharacterized LOC111116357,1475
NC_035789.1,14956569,14959692,14956569,14959692,111116359,XM_022455344.1,uncharacterized LOC111116359,3123
NC_035789.1,15044019,15046066,15044019,15046066,111116361,XM_022455346.1,uncharacterized LOC111116361,2047
NC_035789.1,15107819,15115597,15107819,15115597,111116362,XM_022455347.1,uncharacterized LOC111116362,7778
NC_035789.1,15231687,15249766,15231687,15249766,111116363,XM_022455349.1,uncharacterized LOC111116363,18079
NC_035789.1,15442569,15445795,15442569,15445795,111116365,XM_022455351.1,uncharacterized LOC111116365,3226
NC_035789.1,15588787,15593215,15588787,15593215,111116366,XM_022455352.1,uncharacterized LOC111116366,4428
NC_035789.1,15625192,15637989,15625192,15637989,111116367,XM_022455353.1,uncharacterized LOC111116367,12797
NC_035789.1,15642165,15646024,15642165,15646024,111116368,XM_022455354.1,uncharacterized LOC111116368,3859
NC_035789.1,15646894,15650416,15646894,15650416,111116369,XM_022455356.1,uncharacterized LOC111116369,3522
NC_035789.1,15755233,15756096,15755233,15756096,111116370,XM_022455357.1,uncharacterized LOC111116370,863
NC_035789.1,15756198,15759760,15756198,15759760,111116371,XM_022455358.1,uncharacterized LOC111116371,3562
NC_035789.1,16051160,16056729,16051160,16056729,111116374,XM_022455362.1,uncharacterized LOC111116374,5569
NC_035789.1,16112183,16113310,16112183,16113310,111116377,XM_022455365.1,uncharacterized LOC111116377,1127
NC_035789.1,16351376,16354761,16351376,16354761,111116382,XM_022455370.1,uncharacterized LOC111116382,3385
NC_035789.1,16400299,16401360,16400299,16401360,111116383,XM_022455371.1,uncharacterized LOC111116383,1061
NC_035789.1,16490600,16493761,16490600,16493761,111116384,XM_022455372.1,uncharacterized LOC111116384,3161
NC_035789.1,16557507,16559721,16557507,16559721,111116385,XM_022455373.1,uncharacterized LOC111116385,2214
NC_035789.1,16565140,16567707,16565140,16567707,111116386,XM_022455375.1,uncharacterized LOC111116386,2567
NC_035789.1,16588327,16589529,16588327,16589529,111116387,XM_022455376.1,uncharacterized LOC111116387,1202
NC_035789.1,16590622,16640465,16590622,16640465,111116388,XM_022455377.1,uncharacterized LOC111116388,49843
NC_035789.1,16661046,16661972,16661046,16661972,111116389,XM_022455378.1,uncharacterized LOC111116389,926
NC_035789.1,16789686,16790624,16789686,16790624,111116392,XM_022455382.1,uncharacterized LOC111116392,938
NC_035789.1,16818971,16820579,16818971,16820579,111116394,XM_022455384.1,uncharacterized LOC111116394,1608
NC_035789.1,17160922,17163712,17160922,17163712,111116396,XM_022455386.1,uncharacterized LOC111116396,2790
NC_035789.1,17234856,17239794,17234856,17239794,111116397,XM_022455387.1,uncharacterized LOC111116397,4938
NC_035789.1,17263546,17264479,17263546,17264479,111116398,XM_022455388.1,uncharacterized LOC111116398,933
NC_035789.1,17614451,17616341,17614451,17616341,111116401,XM_022455392.1,uncharacterized LOC111116401,1890
NC_035789.1,17709469,17709792,17709469,17709792,111116404,XM_022455395.1,uncharacterized LOC111116404,323
NC_035789.1,18155909,18176603,18155909,18176603,111116408,XM_022455400.1,uncharacterized LOC111116408,20694
NC_035789.1,18200063,18210571,18200063,18210571,111116409,XM_022455401.1,uncharacterized LOC111116409,10508
NC_035789.1,18211592,18212239,18211592,18212239,111116410,XM_022455402.1,uncharacterized LOC111116410,647
NC_035789.1,18259531,18265902,18259531,18265902,111116414,XM_022455405.1,uncharacterized LOC111116414,6371
NC_035789.1,18340171,18342423,18340171,18342423,111116415,XM_022455406.1,uncharacterized LOC111116415,2252
NC_035789.1,18405431,18410055,18405431,18410055,111116416,XM_022455407.1,uncharacterized LOC111116416,4624
NC_035789.1,18544228,18546563,18544228,18546563,111116417,XM_022455408.1,uncharacterized LOC111116417,2335
NC_035789.1,18784415,18787960,18784415,18787960,111116419,XM_022455410.1,uncharacterized LOC111116419,3545
NC_035789.1,18788873,18791238,18788873,18791238,111116420,XM_022455412.1,uncharacterized LOC111116420,2365
NC_035789.1,18793193,18794509,18793193,18794509,111116421,XM_022455413.1,uncharacterized LOC111116421,1316
NC_035789.1,18906467,18914210,18906467,18914210,111116423,XM_022455415.1,uncharacterized LOC111116423,7743
NC_035789.1,19031941,19036739,19031941,19036739,111116424,XM_022455416.1,uncharacterized LOC111116424,4798
NC_035789.1,19046451,19047350,19046451,19047350,111116425,XM_022455417.1,uncharacterized LOC111116425,899
NC_035789.1,19137965,19146050,19137965,19146050,111116427,XM_022455420.1,uncharacterized LOC111116427,8085
NC_035789.1,19282223,19290190,19282223,19290190,111116429,XM_022455422.1,uncharacterized LOC111116429,7967
NC_035789.1,19294224,19297444,19294224,19297444,111116430,XM_022455423.1,uncharacterized LOC111116430,3220
NC_035789.1,19511409,19516581,19511409,19516581,111116431,XM_022455425.1,uncharacterized LOC111116431,5172
NC_035789.1,19564264,19570190,19564264,19570190,111116434,XM_022455428.1,uncharacterized LOC111116434,5926
NC_035789.1,19591745,19593820,19591745,19593820,111116435,XM_022455429.1,uncharacterized LOC111116435,2075
NC_035789.1,19593828,19597046,19593828,19597046,111116436,XM_022455431.1,uncharacterized LOC111116436,3218
NC_035789.1,19639645,19645780,19639645,19645780,111116437,XM_022455432.1,uncharacterized LOC111116437,6135
NC_035789.1,19878882,19888048,19878882,19888048,111116441,XM_022455436.1,uncharacterized LOC111116441,9166
NC_035789.1,19935214,19935844,19935214,19935844,111116442,XM_022455439.1,uncharacterized LOC111116442,630
NC_035789.1,19964772,19970900,19964772,19970900,111116443,XM_022455440.1,uncharacterized LOC111116443,6128
NC_035789.1,20065147,20068335,20065147,20068335,111116444,XM_022455441.1,uncharacterized LOC111116444,3188
NC_035789.1,20131720,20132625,20131720,20132625,111116445,XM_022455442.1,uncharacterized LOC111116445,905
NC_035789.1,20165813,20167656,20165813,20167656,111116446,XM_022455443.1,uncharacterized LOC111116446,1843
NC_035789.1,20470296,20471441,20470296,20471441,111116447,XM_022455444.1,uncharacterized LOC111116447,1145
NC_035789.1,20502657,20505524,20502657,20505524,111116448,XM_022455445.1,uncharacterized LOC111116448,2867
NC_035780.1,41775985,41782479,41775985,41782479,111116449,XM_022455448.1,uncharacterized LOC111116449,6494
NC_035789.1,20505240,20506280,20505240,20506280,111116450,XM_022455446.1,uncharacterized LOC111116450,1040
NC_035789.1,20578360,20585538,20578360,20585538,111116452,XM_022455449.1,uncharacterized LOC111116452,7178
NC_035789.1,20601558,20608447,20601558,20608447,111116453,XM_022455450.1,uncharacterized LOC111116453,6889
NC_035789.1,20634994,20638151,20634994,20638151,111116454,XM_022455451.1,uncharacterized LOC111116454,3157
NC_035789.1,20676857,20677402,20676857,20677402,111116455,XM_022455452.1,uncharacterized LOC111116455,545
NC_035789.1,20691948,20692843,20691948,20692843,111116456,XM_022455453.1,uncharacterized LOC111116456,895
NC_035789.1,20696539,20697780,20696539,20697780,111116457,XM_022455454.1,uncharacterized LOC111116457,1241
NC_035780.1,16900031,16902860,16900031,16902860,111116459,XM_022455458.1,uncharacterized LOC111116459,2829
NC_035789.1,20703416,20708129,20703416,20708129,111116460,XM_022455456.1,uncharacterized LOC111116460,4713
NC_035789.1,20739325,20742263,20739325,20742263,111116461,XM_022455457.1,uncharacterized LOC111116461,2938
NC_035789.1,21108231,21109700,21108231,21109700,111116466,XM_022455463.1,uncharacterized LOC111116466,1469
NC_035789.1,21109878,21111321,21109878,21111321,111116468,XM_022455464.1,uncharacterized LOC111116468,1443
NC_035789.1,21365026,21366901,21365026,21366901,111116470,XM_022455466.1,uncharacterized LOC111116470,1875
NC_035789.1,21569576,21570259,21569576,21570259,111116471,XM_022455468.1,uncharacterized LOC111116471,683
NC_035789.1,21611568,21617673,21611568,21617673,111116473,XM_022455470.1,uncharacterized LOC111116473,6105
NC_035789.1,21617474,21619366,21617474,21619366,111116474,XM_022455471.1,uncharacterized LOC111116474,1892
NC_035789.1,21708787,21720536,21708787,21720536,111116475,XM_022455472.1,uncharacterized LOC111116475,11749
NC_035789.1,21787630,21789570,21787630,21789570,111116478,XM_022455474.1,uncharacterized LOC111116478,1940
NC_035789.1,21824394,21826590,21824394,21826590,111116481,XM_022455478.1,uncharacterized LOC111116481,2196
NC_035789.1,21873322,21874076,21873322,21874076,111116485,XM_022455481.1,uncharacterized LOC111116485,754
NC_035780.1,13202913,13207276,13202913,13207276,111116486,XM_022455485.1,uncharacterized LOC111116486,4363
NC_035789.1,22476261,22522552,22476261,22522552,111116490,XM_022455486.1,uncharacterized LOC111116490,46291
NC_035789.1,23624362,23634676,23624362,23634676,111116495,XM_022455490.1,uncharacterized LOC111116495,10314
NC_035789.1,23780179,23784679,23780179,23784679,111116496,XM_022455491.1,uncharacterized LOC111116496,4500
NC_035780.1,848082,854748,848082,854748,111116497,XM_022455495.1,uncharacterized LOC111116497,6666
NC_035789.1,23939912,23940316,23939912,23940316,111116500,XM_022455494.1,uncharacterized LOC111116500,404
NC_035789.1,23976198,23996226,23976198,23996226,111116503,XM_022455498.1,uncharacterized LOC111116503,20028
NC_035789.1,24153803,24154363,24153803,24154363,111116506,XM_022455501.1,uncharacterized LOC111116506,560
NC_035789.1,24173314,24176824,24173314,24176824,111116507,XM_022455502.1,uncharacterized LOC111116507,3510
NC_035789.1,24644380,24662624,24644380,24662624,111116513,XM_022455507.1,uncharacterized LOC111116513,18244
NC_035789.1,24993147,24993572,24993147,24993572,111116516,XM_022455510.1,uncharacterized LOC111116516,425
NC_035789.1,25215427,25215945,25215427,25215945,111116521,XM_022455514.1,uncharacterized LOC111116521,518
NC_035789.1,25711079,25715112,25711079,25715112,111116524,XM_022455518.1,uncharacterized LOC111116524,4033
NC_035789.1,25738028,25745671,25738028,25745671,111116526,XM_022455520.1,uncharacterized LOC111116526,7643
NC_035789.1,26359373,26360718,26359373,26360718,111116529,XM_022455524.1,uncharacterized LOC111116529,1345
NC_035789.1,26412644,26448698,26412644,26448698,111116530,XM_022455525.1,uncharacterized LOC111116530,36054
NC_035789.1,26480250,26525476,26480250,26525476,111116531,XM_022455526.1,uncharacterized LOC111116531,45226
NC_035789.1,26675905,26756775,26675905,26756775,111116532,XM_022455527.1,uncharacterized LOC111116532,80870
NC_035789.1,26797502,26825854,26797502,26825854,111116534,XM_022455529.1,uncharacterized LOC111116534,28352
NC_035789.1,26933567,26965746,26933567,26965746,111116535,XM_022455530.1,uncharacterized LOC111116535,32179
NC_035789.1,27179883,27181176,27179883,27181176,111116536,XM_022455532.1,uncharacterized LOC111116536,1293
NC_035789.1,27570445,27572407,27570445,27572407,111116540,XM_022455535.1,uncharacterized LOC111116540,1962
NC_035789.1,27592562,27596675,27592562,27596675,111116541,XM_022455536.1,uncharacterized LOC111116541,4113
NC_035789.1,27602930,27603940,27602930,27603940,111116543,XM_022455540.1,uncharacterized LOC111116543,1010
NC_035789.1,27610787,27612223,27610787,27612223,111116544,XM_022455541.1,uncharacterized LOC111116544,1436
NC_035789.1,27807109,27811529,27807109,27811529,111116545,XM_022455542.1,uncharacterized LOC111116545,4420
NC_035789.1,28042796,28045896,28042796,28045896,111116547,XM_022455544.1,uncharacterized LOC111116547,3100
NC_035789.1,28052767,28063498,28052767,28063498,111116548,XM_022455546.1,uncharacterized LOC111116548,10731
NC_035789.1,28069740,28085292,28069740,28085292,111116549,XM_022455547.1,uncharacterized LOC111116549,15552
NC_035789.1,28337513,28347059,28337513,28347059,111116550,XM_022455548.1,uncharacterized LOC111116550,9546
NC_035789.1,28731969,28768084,28731969,28768084,111116555,XM_022455553.1,uncharacterized LOC111116555,36115
NC_035789.1,28788280,28824534,28788280,28824534,111116556,XM_022455554.1,uncharacterized LOC111116556,36254
NC_035789.1,28830560,28873230,28830560,28873230,111116557,XM_022455555.1,uncharacterized LOC111116557,42670
NC_035789.1,29190515,29193406,29190515,29193406,111116562,XM_022455561.1,uncharacterized LOC111116562,2891
NC_035789.1,29550149,29552451,29550149,29552451,111116566,XM_022455565.1,uncharacterized LOC111116566,2302
NC_035789.1,29608660,29610852,29608660,29610852,111116567,XM_022455566.1,uncharacterized LOC111116567,2192
NC_035789.1,29626245,29647802,29626245,29647802,111116568,XM_022455568.1,uncharacterized LOC111116568,21557
NC_035789.1,29682848,29684696,29682848,29684696,111116569,XM_022455569.1,uncharacterized LOC111116569,1848
NC_035789.1,29724920,29726569,29724920,29726569,111116571,XM_022455571.1,uncharacterized LOC111116571,1649
NC_035789.1,29832282,29833401,29832282,29833401,111116572,XM_022455572.1,uncharacterized LOC111116572,1119
NC_035789.1,29991014,29992135,29991014,29992135,111116575,XM_022455576.1,uncharacterized LOC111116575,1121
NC_035789.1,29997365,30002566,29997365,30002566,111116577,XM_022455578.1,uncharacterized LOC111116577,5201
NC_035789.1,30741065,30742662,30741065,30742662,111116584,XM_022455584.1,uncharacterized LOC111116584,1597
NC_035789.1,31016606,31017837,31016606,31017837,111116587,XM_022455587.1,uncharacterized LOC111116587,1231
NC_035789.1,7870316,7875079,7870316,7875079,111116593,XM_022455594.1,uncharacterized LOC111116593,4763
NC_035789.1,31374433,31376726,31374433,31376726,111116594,XM_022455595.1,uncharacterized LOC111116594,2293
NC_035780.1,14122004,14129673,14122040,14129673,111116597,XM_022455607.1,uncharacterized LOC111116597,7633
NC_035780.1,14122004,14129673,14122004,14129673,111116597,XM_022455601.1,uncharacterized LOC111116597,7669
NC_035789.1,31545014,31545547,31545014,31545547,111116598,XM_022455598.1,uncharacterized LOC111116598,533
NC_035789.1,31625990,31647047,31625990,31647047,111116599,XM_022455599.1,uncharacterized LOC111116599,21057
NC_035789.1,31773842,31796890,31773842,31796890,111116600,XM_022455600.1,uncharacterized LOC111116600,23048
NC_035789.1,31818044,31823835,31818044,31823835,111116601,XM_022455602.1,uncharacterized LOC111116601,5791
NC_035789.1,31898333,31907977,31898333,31907977,111116602,XM_022455603.1,uncharacterized LOC111116602,9644
NC_035789.1,32359936,32362590,32359936,32362590,111116603,XM_022455604.1,uncharacterized LOC111116603,2654
NC_035789.1,32435313,32439178,32435313,32439178,111116604,XM_022455605.1,uncharacterized LOC111116604,3865
NC_035789.1,32447081,32447884,32447081,32447884,111116605,XM_022455606.1,uncharacterized LOC111116605,803
NC_035789.1,32455885,32459752,32455885,32459752,111116606,XM_022455608.1,uncharacterized LOC111116606,3867
NC_035789.1,28312153,28333204,28312153,28333204,111116610,XM_022455611.1,uncharacterized LOC111116610,21051
NC_035789.1,15857730,15859506,15857730,15859506,111116611,XM_022455612.1,uncharacterized LOC111116611,1776
NC_035789.1,30379282,30382244,30379282,30382244,111116612,XM_022455613.1,uncharacterized LOC111116612,2962
NC_035789.1,19902821,19904908,19902821,19904908,111116620,XM_022455618.1,uncharacterized LOC111116620,2087
NC_035789.1,6284612,6288908,6284612,6288906,111116629,XM_022455627.1,uncharacterized LOC111116629,4294
NC_035789.1,6284612,6288908,6284612,6288908,111116629,XM_022455628.1,uncharacterized LOC111116629,4296
NC_035789.1,2366889,2372436,2366889,2372436,111116640,XM_022455643.1,uncharacterized LOC111116640,5547
NC_035789.1,2373987,2376022,2373987,2376022,111116641,XM_022455644.1,uncharacterized LOC111116641,2035
NC_035789.1,30960557,30961769,30960557,30961769,111116644,XM_022455648.1,uncharacterized LOC111116644,1212
NC_035789.1,19623295,19628767,19623295,19628767,111116652,XM_022455652.1,uncharacterized LOC111116652,5472
NC_035789.1,11034107,11038484,11034107,11038484,111116657,XM_022455653.1,uncharacterized LOC111116657,4377
NC_035789.1,16818101,16818823,16818101,16818823,111116662,XM_022455660.1,uncharacterized LOC111116662,722
NC_035789.1,12314100,12315661,12314100,12315661,111116666,XM_022455662.1,uncharacterized LOC111116666,1561
NC_035789.1,10413776,10418380,10413776,10418380,111116676,XM_022455671.1,uncharacterized LOC111116676,4604
NC_035789.1,22592850,22596250,22592850,22596250,111116679,XM_022455673.1,uncharacterized LOC111116679,3400
NC_035780.1,14251742,14255328,14251742,14255328,111116682,XM_022455677.1,uncharacterized LOC111116682,3586
NC_035789.1,21532496,21538055,21532496,21538055,111116687,XM_022455678.1,uncharacterized LOC111116687,5559
NC_035789.1,29683099,29687344,29683099,29687344,111116689,XM_022455680.1,uncharacterized LOC111116689,4245
NC_035780.1,14167520,14175330,14167520,14175330,111116694,XM_022455685.1,uncharacterized LOC111116694,7810
NC_035789.1,10949853,10953952,10949853,10953952,111116695,XM_022455682.1,uncharacterized LOC111116695,4099
NC_035789.1,7,7043,413,7043,111116696,XM_022455684.1,uncharacterized LOC111116696,6630
NC_035789.1,7,7043,7,7043,111116696,XM_022455683.1,uncharacterized LOC111116696,7036
NC_035789.1,7193177,7196822,7193177,7196822,111116698,XM_022455688.1,uncharacterized LOC111116698,3645
NC_035789.1,26318670,26329445,26318670,26329445,111116703,XM_022455690.1,uncharacterized LOC111116703,10775
NC_035789.1,26318670,26329445,26319890,26325956,111116703,XM_022455691.1,uncharacterized LOC111116703,6066
NC_035789.1,26318670,26329445,26319889,26325992,111116703,XM_022455692.1,uncharacterized LOC111116703,6103
NC_035789.1,26318670,26329445,26319888,26329445,111116703,XM_022455689.1,uncharacterized LOC111116703,9557
NC_035780.1,14294260,14303133,14294260,14303133,111116704,XM_022455694.1,uncharacterized LOC111116704,8873
NC_035789.1,14763995,14768104,14763995,14768104,111116708,XM_022455696.1,uncharacterized LOC111116708,4109
NC_035789.1,30906038,30907323,30906038,30907323,111116709,XM_022455697.1,uncharacterized LOC111116709,1285
NC_035789.1,15753662,15754612,15753662,15754612,111116711,XM_022455700.1,uncharacterized LOC111116711,950
NC_035789.1,19496672,19499946,19497002,19499946,111116713,XM_022455702.1,uncharacterized LOC111116713,2944
NC_035789.1,19496672,19499946,19496672,19499946,111116713,XM_022455701.1,uncharacterized LOC111116713,3274
NC_035789.1,4282267,4286798,4282267,4286798,111116715,XM_022455704.1,uncharacterized LOC111116715,4531
NC_035789.1,26095360,26111594,26095360,26111594,111116716,XM_022455705.1,uncharacterized LOC111116716,16234
NC_035789.1,21710981,21714143,21710981,21714143,111116717,XM_022455707.1,uncharacterized LOC111116717,3162
NC_035789.1,21709148,21711458,21709148,21711458,111116718,XM_022455708.1,uncharacterized LOC111116718,2310
NC_035789.1,16978811,16989445,16978811,16989445,111116721,XM_022455710.1,uncharacterized LOC111116721,10634
NC_035780.1,14177177,14185871,14177714,14185871,111116724,XM_022455721.1,uncharacterized LOC111116724,8157
NC_035780.1,14177177,14185871,14177177,14185871,111116724,XM_022455715.1,uncharacterized LOC111116724,8694
NC_035789.1,4064087,4070005,4064087,4070005,111116726,XM_022455714.1,uncharacterized LOC111116726,5918
NC_035789.1,14417887,14421150,14417887,14421150,111116728,XM_022455716.1,uncharacterized LOC111116728,3263
NC_035789.1,14414791,14417907,14414791,14417907,111116729,XM_022455717.1,uncharacterized LOC111116729,3116
NC_035789.1,5402834,5404324,5402834,5404324,111116733,XM_022455722.1,uncharacterized LOC111116733,1490
NC_035789.1,438329,441160,438329,441160,111116734,XM_022455723.1,uncharacterized LOC111116734,2831
NC_035789.1,19722559,19725520,19722559,19725520,111116735,XM_022455724.1,uncharacterized LOC111116735,2961
NC_035789.1,3913814,3930011,3913814,3930011,111116737,XM_022455725.1,uncharacterized LOC111116737,16197
NC_035789.1,20777055,20780180,20777055,20780180,111116739,XM_022455727.1,uncharacterized LOC111116739,3125
NC_035789.1,20773677,20776671,20773677,20776368,111116741,XM_022455728.1,uncharacterized LOC111116741,2691
NC_035789.1,10060679,10062674,10060679,10062674,111116743,XM_022455729.1,uncharacterized LOC111116743,1995
NC_035789.1,7183101,7189427,7183101,7189427,111116744,XM_022455732.1,uncharacterized LOC111116744,6326
NC_035789.1,14221114,14228498,14224115,14228498,111116747,XM_022455740.1,uncharacterized LOC111116747,4383
NC_035789.1,14221114,14228498,14224097,14228498,111116747,XM_022455739.1,uncharacterized LOC111116747,4401
NC_035789.1,14221114,14228498,14221114,14228489,111116747,XM_022455734.1,uncharacterized LOC111116747,7375
NC_035789.1,14221114,14228498,14221114,14228498,111116747,XM_022455735.1,uncharacterized LOC111116747,7384
NC_035780.1,14289553,14293770,14289553,14293770,111116753,XM_022455753.1,uncharacterized LOC111116753,4217
NC_035789.1,26998611,27005495,26998611,27004422,111116758,XM_022455754.1,uncharacterized LOC111116758,5811
NC_035789.1,26998611,27005495,26998611,27005495,111116758,XM_022455755.1,uncharacterized LOC111116758,6884
NC_035789.1,7783718,7805235,7793429,7805235,111116762,XM_022455758.1,uncharacterized LOC111116762,11806
NC_035789.1,7783718,7805235,7783718,7805235,111116762,XM_022455757.1,uncharacterized LOC111116762,21517
NC_035789.1,16376224,16379316,16376224,16379316,111116766,XM_022455763.1,uncharacterized LOC111116766,3092
NC_035789.1,19155881,19162446,19159140,19162446,111116769,XM_022455766.1,uncharacterized LOC111116769,3306
NC_035789.1,19155881,19162446,19157305,19162446,111116769,XM_022455769.1,uncharacterized LOC111116769,5141
NC_035789.1,19155881,19162446,19155882,19162446,111116769,XM_022455770.1,uncharacterized LOC111116769,6564
NC_035789.1,19155881,19162446,19155881,19162446,111116769,XM_022455767.1,uncharacterized LOC111116769,6565
NC_035789.1,16525413,16527030,16525413,16527030,111116770,XM_022455771.1,uncharacterized LOC111116770,1617
NC_035789.1,31954067,31967678,31954067,31967678,111116774,XM_022455772.1,uncharacterized LOC111116774,13611
NC_035789.1,28414662,28424389,28414662,28424389,111116775,XM_022455774.1,uncharacterized LOC111116775,9727
NC_035789.1,7002906,7008019,7002906,7008019,111116777,XM_022455777.1,uncharacterized LOC111116777,5113
NC_035789.1,11914585,11916093,11914585,11916093,111116780,XM_022455781.1,uncharacterized LOC111116780,1508
NC_035789.1,11911282,11914321,11911282,11914321,111116781,XM_022455783.1,uncharacterized LOC111116781,3039
NC_035789.1,26466,39338,26466,39338,111116782,XM_022455784.1,uncharacterized LOC111116782,12872
NC_035789.1,4828681,4839143,4828681,4839143,111116783,XM_022455785.1,uncharacterized LOC111116783,10462
NC_035789.1,10396869,10405887,10396869,10405887,111116784,XM_022455786.1,uncharacterized LOC111116784,9018
NC_035780.1,30058299,30061941,30058299,30061933,111116791,XM_022455802.1,uncharacterized LOC111116791,3634
NC_035780.1,30058299,30061941,30058299,30061941,111116791,XM_022455812.1,uncharacterized LOC111116791,3642
NC_035789.1,31936667,31939431,31937382,31939430,111116793,XM_022455805.1,uncharacterized LOC111116793,2048
NC_035789.1,31936667,31939431,31936835,31939431,111116793,XM_022455806.1,uncharacterized LOC111116793,2596
NC_035789.1,31936667,31939431,31936667,31939430,111116793,XM_022455804.1,uncharacterized LOC111116793,2763
NC_035789.1,10066095,10080059,10068990,10080059,111116794,XM_022455808.1,uncharacterized LOC111116794,11069
NC_035789.1,10066095,10080059,10066095,10080059,111116794,XM_022455807.1,uncharacterized LOC111116794,13964
NC_035789.1,15419295,15427065,15419295,15427065,111116796,XM_022455815.1,uncharacterized LOC111116796,7770
NC_035789.1,19021150,19022146,19021150,19022146,111116797,XM_022455816.1,uncharacterized LOC111116797,996
NC_035789.1,24666273,24684931,24666273,24684931,111116798,XM_022455817.1,uncharacterized LOC111116798,18658
NC_035789.1,30407017,30410251,30407017,30410251,111116799,XM_022455818.1,uncharacterized LOC111116799,3234
NC_035789.1,30399922,30403607,30399922,30403607,111116800,XM_022455819.1,uncharacterized LOC111116800,3685
NC_035789.1,30412625,30417269,30412625,30417269,111116802,XM_022455820.1,uncharacterized LOC111116802,4644
NC_035789.1,12331313,12335749,12331313,12335749,111116805,XM_022455825.1,uncharacterized LOC111116805,4436
NC_035789.1,14856003,14859127,14856003,14859127,111116807,XM_022455826.1,uncharacterized LOC111116807,3124
NC_035789.1,14726421,14729496,14726421,14729496,111116808,XM_022455827.1,uncharacterized LOC111116808,3075
NC_035789.1,18342881,18346429,18342881,18346429,111116810,XM_022455829.1,uncharacterized LOC111116810,3548
NC_035789.1,15076518,15077140,15076518,15077140,111116813,XM_022455830.1,uncharacterized LOC111116813,622
NC_035789.1,30963025,30970335,30963025,30970335,111116817,XM_022455837.1,uncharacterized LOC111116817,7310
NC_035789.1,7865124,7870149,7865124,7870149,111116818,XM_022455838.1,uncharacterized LOC111116818,5025
NC_035789.1,8566543,8599810,8566543,8599810,111116819,XM_022455839.1,uncharacterized LOC111116819,33267
NC_035789.1,23489681,23493920,23489681,23493920,111116827,XM_022455845.1,uncharacterized LOC111116827,4239
NC_035789.1,23493984,23499393,23493986,23499393,111116828,XM_022455846.1,uncharacterized LOC111116828,5407
NC_035789.1,23493984,23499393,23493984,23499393,111116828,XM_022455847.1,uncharacterized LOC111116828,5409
NC_035789.1,5583117,5589097,5583120,5589097,111116840,XM_022455855.1,uncharacterized LOC111116840,5977
NC_035789.1,5583117,5589097,5583118,5589097,111116840,XM_022455853.1,uncharacterized LOC111116840,5979
NC_035789.1,5583117,5589097,5583117,5589097,111116840,XM_022455854.1,uncharacterized LOC111116840,5980
NC_035789.1,6599485,6605179,6599485,6605179,111116841,XM_022455859.1,uncharacterized LOC111116841,5694
NC_035789.1,4119706,4123050,4119706,4123050,111116842,XM_022455860.1,uncharacterized LOC111116842,3344
NC_035789.1,32455028,32455837,32455028,32455837,111116846,XM_022455871.1,uncharacterized LOC111116846,809
NC_035789.1,10457607,10464494,10457609,10464494,111116851,XM_022455874.1,uncharacterized LOC111116851,6885
NC_035789.1,10457607,10464494,10457607,10464494,111116851,XM_022455875.1,uncharacterized LOC111116851,6887
NC_035789.1,15406793,15408020,15406793,15408020,111116853,XM_022455878.1,uncharacterized LOC111116853,1227
NC_035789.1,30948728,30950099,30948728,30950099,111116855,XM_022455879.1,uncharacterized LOC111116855,1371
NC_035789.1,30936350,30937718,30936350,30937718,111116856,XM_022455880.1,uncharacterized LOC111116856,1368
NC_035789.1,4486990,4489720,4486990,4489720,111116857,XM_022455881.1,uncharacterized LOC111116857,2730
NC_035789.1,6715927,6724884,6715927,6724884,111116858,XM_022455882.1,uncharacterized LOC111116858,8957
NC_035780.1,48270728,48279314,48270743,48279314,111116860,XM_022455895.1,uncharacterized LOC111116860,8571
NC_035780.1,48270728,48279314,48270728,48279314,111116860,XM_022455887.1,uncharacterized LOC111116860,8586
NC_035789.1,9282628,9289958,9284100,9289957,111116861,XM_022455883.1,uncharacterized LOC111116861,5857
NC_035789.1,9282628,9289958,9284100,9289958,111116861,XM_022455885.1,uncharacterized LOC111116861,5858
NC_035789.1,9282628,9289958,9282628,9289957,111116861,XM_022455884.1,uncharacterized LOC111116861,7329
NC_035789.1,31927839,31933986,31927839,31933986,111116862,XM_022455886.1,uncharacterized LOC111116862,6147
NC_035789.1,26175545,26193551,26175545,26193537,111116864,XM_022455891.1,uncharacterized LOC111116864,17992
NC_035789.1,26175545,26193551,26175545,26193551,111116864,XM_022455890.1,uncharacterized LOC111116864,18006
NC_035789.1,19890165,19899531,19890165,19899531,111116865,XM_022455892.1,uncharacterized LOC111116865,9366
NC_035789.1,10791614,10802799,10791614,10802799,111116866,XM_022455893.1,uncharacterized LOC111116866,11185
NC_035789.1,29764170,29769200,29764956,29768609,111116868,XM_022455896.1,uncharacterized LOC111116868,3653
NC_035789.1,29764170,29769200,29764956,29769200,111116868,XM_022455898.1,uncharacterized LOC111116868,4244
NC_035789.1,11607059,11610134,11607059,11610134,111116871,XM_022455915.1,uncharacterized LOC111116871,3075
NC_035789.1,3700697,3705857,3700697,3705857,111116873,XM_022455916.1,uncharacterized LOC111116873,5160
NC_035789.1,29388645,29400490,29388646,29400490,111116883,XM_022455933.1,uncharacterized LOC111116883,11844
NC_035789.1,29388645,29400490,29388645,29400490,111116883,XM_022455934.1,uncharacterized LOC111116883,11845
NC_035789.1,29266151,29280983,29266711,29280983,111116888,XM_022455941.1,uncharacterized LOC111116888,14272
NC_035789.1,29266151,29280983,29266151,29280983,111116888,XM_022455939.1,uncharacterized LOC111116888,14832
NC_035789.1,29186646,29190582,29186646,29190582,111116889,XM_022455942.1,uncharacterized LOC111116889,3936
NC_035789.1,29208296,29215216,29208296,29215216,111116893,XM_022455953.1,uncharacterized LOC111116893,6920
NC_035789.1,11490764,11497219,11490764,11497219,111116904,XM_022455956.1,uncharacterized LOC111116904,6455
NC_035789.1,2518652,2522683,2518652,2522683,111116911,XM_022455966.1,uncharacterized LOC111116911,4031
NC_035789.1,19872364,19877173,19873558,19877173,111116912,XM_022455967.1,uncharacterized LOC111116912,3615
NC_035789.1,19872364,19877173,19872364,19877173,111116912,XM_022455968.1,uncharacterized LOC111116912,4809
NC_035789.1,20989575,20994578,20989575,20994578,111116914,XM_022455970.1,uncharacterized LOC111116914,5003
NC_035789.1,20453592,20458849,20455156,20458007,111116917,XM_022455971.1,uncharacterized LOC111116917,2851
NC_035789.1,20453592,20458849,20455156,20458509,111116917,XM_022455973.1,uncharacterized LOC111116917,3353
NC_035789.1,20453592,20458849,20455156,20458849,111116917,XM_022455974.1,uncharacterized LOC111116917,3693
NC_035789.1,21611726,21612430,21611726,21612430,111116921,XM_022455980.1,uncharacterized LOC111116921,704
NC_035789.1,8425430,8434265,8425430,8434265,111116922,XM_022455981.1,uncharacterized LOC111116922,8835
NC_035789.1,16691007,16695037,16691007,16695037,111116924,XM_022455982.1,uncharacterized LOC111116924,4030
NC_035780.1,50318409,50319689,50318409,50319689,111116925,XM_022455987.1,uncharacterized LOC111116925,1280
NC_035789.1,7731269,7740722,7731269,7740722,111116928,XM_022455986.1,uncharacterized LOC111116928,9453
NC_035789.1,7719053,7725023,7719053,7725023,111116929,XM_022455988.1,uncharacterized LOC111116929,5970
NC_035789.1,3898175,3902587,3898175,3902587,111116932,XM_022455992.1,uncharacterized LOC111116932,4412
NC_035789.1,25709217,25710848,25709217,25710848,111116934,XM_022455996.1,uncharacterized LOC111116934,1631
NC_035789.1,5484819,5498555,5484819,5498555,111116935,XM_022455997.1,uncharacterized LOC111116935,13736
NC_035789.1,30135627,30140744,30135627,30140744,111116936,XM_022455998.1,uncharacterized LOC111116936,5117
NC_035789.1,31561228,31587576,31561228,31587576,111116940,XM_022456000.1,uncharacterized LOC111116940,26348
NC_035789.1,31592350,31598896,31592356,31598896,111116941,XM_022456002.1,uncharacterized LOC111116941,6540
NC_035789.1,31592350,31598896,31592350,31598896,111116941,XM_022456001.1,uncharacterized LOC111116941,6546
NC_035789.1,14103961,14110563,14104057,14110563,111116945,XM_022456004.1,uncharacterized LOC111116945,6506
NC_035789.1,14103961,14110563,14103961,14110563,111116945,XM_022456003.1,uncharacterized LOC111116945,6602
NC_035789.1,14160217,14161088,14160217,14161088,111116946,XM_022456005.1,uncharacterized LOC111116946,871
NC_035780.1,24864255,24870541,24865674,24870540,111116948,XM_022456009.1,uncharacterized LOC111116948,4866
NC_035780.1,24864255,24870541,24864255,24870541,111116948,XM_022456013.1,uncharacterized LOC111116948,6286
NC_035789.1,11860056,11861843,11860056,11861843,111116949,XM_022456006.1,uncharacterized LOC111116949,1787
NC_035789.1,14986462,14991278,14986462,14991278,111116950,XM_022456007.1,uncharacterized LOC111116950,4816
NC_035789.1,32442380,32443400,32442380,32443400,111116951,XM_022456008.1,uncharacterized LOC111116951,1020
NC_035789.1,17594686,17603718,17599148,17603718,111116960,XM_022456015.1,uncharacterized LOC111116960,4570
NC_035789.1,17594686,17603718,17594686,17603718,111116960,XM_022456014.1,uncharacterized LOC111116960,9032
NC_035789.1,20304044,20309263,20304044,20309263,111116972,XM_022456029.1,uncharacterized LOC111116972,5219
NC_035789.1,20159269,20164766,20161403,20164766,111116973,XM_022456031.1,uncharacterized LOC111116973,3363
NC_035789.1,20159269,20164766,20159269,20164766,111116973,XM_022456030.1,uncharacterized LOC111116973,5497
NC_035789.1,20182766,20190829,20182766,20190829,111116975,XM_022456032.1,uncharacterized LOC111116975,8063
NC_035789.1,514040,527150,514040,527150,111116981,XM_022456034.1,uncharacterized LOC111116981,13110
NC_035789.1,514040,527150,520781,527150,111116981,XM_022456035.1,uncharacterized LOC111116981,6369
NC_035789.1,529442,532752,530703,532752,111116982,XM_022456036.1,uncharacterized LOC111116982,2049
NC_035789.1,529442,532752,529442,532752,111116982,XM_022456037.1,uncharacterized LOC111116982,3310
NC_035789.1,498257,502272,498257,502272,111116983,XM_022456038.1,uncharacterized LOC111116983,4015
NC_035789.1,560864,561767,560864,561767,111116985,XM_022456045.1,uncharacterized LOC111116985,903
NC_035789.1,10698678,10726685,10702452,10726685,111116988,XM_022456048.1,uncharacterized LOC111116988,24233
NC_035789.1,10698678,10726685,10698678,10726685,111116988,XM_022456046.1,uncharacterized LOC111116988,28007
NC_035789.1,24215319,24223196,24215319,24223196,111116998,XM_022456061.1,uncharacterized LOC111116998,7877
NC_035780.1,38033087,38035308,38033087,38035308,111117025,XM_022456088.1,uncharacterized LOC111117025,2221
NC_035789.1,31212245,31249656,31212245,31223921,111117027,XM_022456087.1,uncharacterized LOC111117027,11676
NC_035789.1,31243754,31247485,31243754,31247485,111117028,XM_022456089.1,uncharacterized LOC111117028,3731
NC_035789.1,31247718,31249594,31247718,31249594,111117030,XM_022456093.1,uncharacterized LOC111117030,1876
NC_035789.1,9487085,9510498,9487085,9510498,111117031,XM_022456094.1,uncharacterized LOC111117031,23413
NC_035789.1,4233338,4254551,4233338,4254531,111117040,XM_022456105.1,uncharacterized LOC111117040,21193
NC_035789.1,4233338,4254551,4251243,4254534,111117040,XM_022456103.1,uncharacterized LOC111117040,3291
NC_035789.1,4233338,4254551,4251243,4254551,111117040,XM_022456102.1,uncharacterized LOC111117040,3308
NC_035789.1,4233338,4254551,4233338,4237634,111117040,XM_022456104.1,uncharacterized LOC111117040,4296
NC_035789.1,4233338,4254551,4233338,4238938,111117040,XM_022456106.1,uncharacterized LOC111117040,5600
NC_035789.1,4212455,4223633,4212455,4223633,111117042,XM_022456107.1,uncharacterized LOC111117042,11178
NC_035789.1,3365883,3368594,3365883,3368594,111117053,XM_022456124.1,uncharacterized LOC111117053,2711
NC_035789.1,3410093,3411212,3410093,3411212,111117054,XM_022456126.1,uncharacterized LOC111117054,1119
NC_035789.1,3400127,3401536,3400127,3401536,111117055,XM_022456127.1,uncharacterized LOC111117055,1409
NC_035789.1,3352317,3354332,3352317,3354332,111117056,XM_022456128.1,uncharacterized LOC111117056,2015
NC_035789.1,4395034,4413051,4395034,4413051,111117059,XM_022456129.1,uncharacterized LOC111117059,18017
NC_035789.1,10186250,10200583,10186250,10200583,111117060,XM_022456130.1,uncharacterized LOC111117060,14333
NC_035789.1,9844421,9857278,9844421,9857278,111117062,XM_022456132.1,uncharacterized LOC111117062,12857
NC_035789.1,9844421,9857278,9852824,9857278,111117062,XM_022456133.1,uncharacterized LOC111117062,4454
NC_035789.1,9762417,9767993,9762417,9767993,111117064,XM_022456137.1,uncharacterized LOC111117064,5576
NC_035789.1,9735271,9743015,9735274,9743015,111117065,XM_022456139.1,uncharacterized LOC111117065,7741
NC_035789.1,9735271,9743015,9735271,9743015,111117065,XM_022456138.1,uncharacterized LOC111117065,7744
NC_035789.1,9745460,9757343,9745460,9756857,111117070,XM_022456145.1,uncharacterized LOC111117070,11397
NC_035789.1,9745460,9757343,9745460,9757341,111117070,XM_022456144.1,uncharacterized LOC111117070,11881
NC_035789.1,9745460,9757343,9745460,9757342,111117070,XM_022456146.1,uncharacterized LOC111117070,11882
NC_035789.1,9745460,9757343,9745460,9757343,111117070,XM_022456147.1,uncharacterized LOC111117070,11883
NC_035780.1,22574410,22576247,22574410,22576247,111117071,XM_022456151.1,uncharacterized LOC111117071,1837
NC_035789.1,9865517,9880709,9865517,9880709,111117072,XM_022456148.1,uncharacterized LOC111117072,15192
NC_035789.1,9704262,9705579,9704262,9705579,111117073,XM_022456149.1,uncharacterized LOC111117073,1317
NC_035789.1,9691941,9693558,9691941,9693558,111117074,XM_022456150.1,uncharacterized LOC111117074,1617
NC_035789.1,31679987,31691272,31679987,31691272,111117082,XM_022456152.1,uncharacterized LOC111117082,11285
NC_035789.1,31717321,31744522,31717322,31738081,111117083,XM_022456158.1,uncharacterized LOC111117083,20759
NC_035789.1,31717321,31744522,31717321,31741382,111117083,XM_022456153.1,uncharacterized LOC111117083,24061
NC_035789.1,31717321,31744522,31717322,31744522,111117083,XM_022456157.1,uncharacterized LOC111117083,27200
NC_035789.1,31717321,31744522,31717321,31744522,111117083,XM_022456154.1,uncharacterized LOC111117083,27201
NC_035789.1,31695720,31711719,31695721,31706523,111117085,XM_022456162.1,uncharacterized LOC111117085,10802
NC_035789.1,31695720,31711719,31695721,31708259,111117085,XM_022456164.1,uncharacterized LOC111117085,12538
NC_035789.1,31695720,31711719,31695721,31708888,111117085,XM_022456163.1,uncharacterized LOC111117085,13167
NC_035789.1,31695720,31711719,31695721,31711719,111117085,XM_022456161.1,uncharacterized LOC111117085,15998
NC_035789.1,31695720,31711719,31695720,31711719,111117085,XM_022456159.1,uncharacterized LOC111117085,15999
NC_035789.1,31726066,31728264,31726066,31728161,111117087,XM_022456168.1,uncharacterized LOC111117087,2095
NC_035789.1,31726066,31728264,31726079,31728264,111117087,XM_022456167.1,uncharacterized LOC111117087,2185
NC_035789.1,31653125,31660067,31653125,31660067,111117088,XM_022456169.1,uncharacterized LOC111117088,6942
NC_035789.1,31723271,31725664,31723271,31725664,111117089,XM_022456170.1,uncharacterized LOC111117089,2393
NC_035789.1,22048583,22052051,22048583,22052051,111117094,XM_022456175.1,uncharacterized LOC111117094,3468
NC_035789.1,22043961,22048727,22044255,22048727,111117095,XM_022456177.1,uncharacterized LOC111117095,4472
NC_035789.1,22043961,22048727,22043961,22048727,111117095,XM_022456176.1,uncharacterized LOC111117095,4766
NC_035789.1,19438427,19442414,19438427,19442414,111117107,XM_022456194.1,uncharacterized LOC111117107,3987
NC_035789.1,19436346,19439351,19436346,19439351,111117108,XM_022456195.1,uncharacterized LOC111117108,3005
NC_035789.1,19443024,19446780,19443024,19446780,111117109,XM_022456196.1,uncharacterized LOC111117109,3756
NC_035789.1,32005655,32055645,32005655,32055645,111117112,XM_022456197.1,uncharacterized LOC111117112,49990
NC_035789.1,32061660,32087445,32061660,32087445,111117113,XM_022456200.1,uncharacterized LOC111117113,25785
NC_035789.1,32264001,32266544,32264001,32266544,111117115,XM_022456201.1,uncharacterized LOC111117115,2543
NC_035789.1,32089577,32091502,32089577,32091502,111117120,XM_022456207.1,uncharacterized LOC111117120,1925
NC_035789.1,32127495,32138520,32127495,32138520,111117122,XM_022456209.1,uncharacterized LOC111117122,11025
NC_035789.1,278930,282528,278930,282528,111117129,XM_022456211.1,uncharacterized LOC111117129,3598
NC_035789.1,504216,508502,504216,508502,111117130,XM_022456212.1,uncharacterized LOC111117130,4286
NC_035789.1,580123,581826,580123,581826,111117131,XM_022456213.1,uncharacterized LOC111117131,1703
NC_035789.1,698041,699168,698041,699168,111117135,XM_022456217.1,uncharacterized LOC111117135,1127
NC_035789.1,756842,761483,756842,761483,111117138,XM_022456219.1,uncharacterized LOC111117138,4641
NC_035789.1,774934,777017,774934,777017,111117143,XM_022456224.1,uncharacterized LOC111117143,2083
NC_035789.1,824412,831044,824412,831044,111117144,XM_022456225.1,uncharacterized LOC111117144,6632
NC_035789.1,961750,962733,961750,962733,111117145,XM_022456226.1,uncharacterized LOC111117145,983
NC_035789.1,962910,964064,962910,964064,111117146,XM_022456227.1,uncharacterized LOC111117146,1154
NC_035789.1,965076,976847,965076,976847,111117147,XM_022456228.1,uncharacterized LOC111117147,11771
NC_035789.1,1024293,1035624,1024293,1035624,111117149,XM_022456230.1,uncharacterized LOC111117149,11331
NC_035789.1,26966253,26971259,26967581,26971259,111117153,XM_022456236.1,uncharacterized LOC111117153,3678
NC_035789.1,26966253,26971259,26966253,26971259,111117153,XM_022456234.1,uncharacterized LOC111117153,5006
NC_035789.1,1191564,1243903,1191564,1243903,111117154,XM_022456237.1,uncharacterized LOC111117154,52339
NC_035789.1,1305050,1336490,1305050,1336490,111117155,XM_022456238.1,uncharacterized LOC111117155,31440
NC_035789.1,1351994,1386000,1351994,1386000,111117157,XM_022456239.1,uncharacterized LOC111117157,34006
NC_035789.1,1539130,1540667,1539130,1540667,111117158,XM_022456240.1,uncharacterized LOC111117158,1537
NC_035789.1,2522609,2525439,2522609,2525439,111117163,XM_022456244.1,uncharacterized LOC111117163,2830
NC_035789.1,25161446,25163459,25161446,25163459,111117166,XM_022456248.1,uncharacterized LOC111117166,2013
NC_035789.1,2807754,2811516,2807754,2811516,111117174,XM_022456254.1,uncharacterized LOC111117174,3762
NC_035789.1,10648046,10659441,10648046,10659441,111117175,XM_022456255.1,uncharacterized LOC111117175,11395
NC_035789.1,17187139,17188458,17187139,17188458,111117179,XM_022456258.1,uncharacterized LOC111117179,1319
NC_035789.1,17146152,17149179,17146152,17149179,111117180,XM_022456259.1,uncharacterized LOC111117180,3027
NC_035789.1,2904387,2904932,2904387,2904932,111117182,XM_022456260.1,uncharacterized LOC111117182,545
NC_035789.1,2952100,2952645,2952100,2952645,111117186,XM_022456263.1,uncharacterized LOC111117186,545
NC_035789.1,2957114,2959078,2957114,2959078,111117187,XM_022456264.1,uncharacterized LOC111117187,1964
NC_035789.1,3092250,3096206,3092250,3096206,111117198,XM_022456270.1,uncharacterized LOC111117198,3956
NC_035789.1,3152120,3155000,3152120,3155000,111117199,XM_022456271.1,uncharacterized LOC111117199,2880
NC_035789.1,3214206,3215582,3214206,3215582,111117201,XM_022456273.1,uncharacterized LOC111117201,1376
NC_035789.1,8713393,8718895,8713393,8718895,111117203,XM_022456276.1,uncharacterized LOC111117203,5502
NC_035789.1,8690366,8695110,8690366,8695110,111117206,XM_022456281.1,uncharacterized LOC111117206,4744
NC_035789.1,8669376,8676058,8669441,8676058,111117207,XM_022456282.1,uncharacterized LOC111117207,6617
NC_035789.1,8669376,8676058,8669376,8676058,111117207,XM_022456283.1,uncharacterized LOC111117207,6682
NC_035789.1,3224685,3225083,3224685,3225083,111117215,XM_022456287.1,uncharacterized LOC111117215,398
NC_035789.1,3284373,3286193,3284373,3286193,111117217,XM_022456289.1,uncharacterized LOC111117217,1820
NC_035789.1,3344951,3348050,3344951,3348050,111117218,XM_022456290.1,uncharacterized LOC111117218,3099
NC_035789.1,3415007,3418142,3415007,3418142,111117219,XM_022456291.1,uncharacterized LOC111117219,3135
NC_035789.1,3478888,3481972,3478888,3481972,111117220,XM_022456292.1,uncharacterized LOC111117220,3084
NC_035789.1,4085182,4085988,4085182,4085988,111117227,XM_022456298.1,uncharacterized LOC111117227,806
NC_035789.1,4131066,4131485,4131066,4131485,111117229,XM_022456299.1,uncharacterized LOC111117229,419
NC_035789.1,4165987,4167677,4165987,4167677,111117230,XM_022456300.1,uncharacterized LOC111117230,1690
NC_035789.1,4182947,4184437,4182947,4184437,111117232,XM_022456302.1,uncharacterized LOC111117232,1490
NC_035789.1,4262986,4263405,4262986,4263405,111117233,XM_022456303.1,uncharacterized LOC111117233,419
NC_035789.1,4514674,4515924,4514674,4515924,111117238,XM_022456308.1,uncharacterized LOC111117238,1250
NC_035789.1,4561713,4563750,4561713,4563750,111117240,XM_022456310.1,uncharacterized LOC111117240,2037
NC_035789.1,15089506,15093764,15089506,15093764,111117241,XM_022456311.1,uncharacterized LOC111117241,4258
NC_035789.1,15093751,15097466,15093751,15097466,111117242,XM_022456312.1,uncharacterized LOC111117242,3715
NC_035789.1,4674299,4678198,4674299,4678198,111117245,XM_022456314.1,uncharacterized LOC111117245,3899
NC_035789.1,4771562,4772128,4771562,4772128,111117246,XM_022456315.1,uncharacterized LOC111117246,566
NC_035789.1,4792652,4795321,4792652,4795321,111117247,XM_022456316.1,uncharacterized LOC111117247,2669
NC_035789.1,30456141,30459948,30456141,30459948,111117251,XM_022456321.1,uncharacterized LOC111117251,3807
NC_035789.1,5058150,5059409,5058150,5059409,111117253,XM_022456323.1,uncharacterized LOC111117253,1259
NC_035789.1,5227114,5228459,5227114,5228459,111117255,XM_022456325.1,uncharacterized LOC111117255,1345
NC_035789.1,5470645,5480609,5470645,5480609,111117258,XM_022456327.1,uncharacterized LOC111117258,9964
NC_035789.1,6332267,6382614,6332267,6382614,111117268,XM_022456335.1,uncharacterized LOC111117268,50347
NC_035789.1,6539265,6540452,6539265,6540452,111117269,XM_022456336.1,uncharacterized LOC111117269,1187
NC_035789.1,6551486,6551908,6551486,6551908,111117270,XM_022456337.1,uncharacterized LOC111117270,422
NC_035789.1,6557570,6558913,6557570,6558913,111117271,XM_022456338.1,uncharacterized LOC111117271,1343
NC_035789.1,6564017,6566974,6564017,6566974,111117272,XM_022456339.1,uncharacterized LOC111117272,2957
NC_035789.1,6625419,6627592,6625419,6627592,111117274,XM_022456340.1,uncharacterized LOC111117274,2173
NC_035789.1,6653378,6694949,6653378,6694949,111117275,XM_022456341.1,uncharacterized LOC111117275,41571
NC_035789.1,6729788,6730543,6729788,6730543,111117276,XM_022456342.1,uncharacterized LOC111117276,755
NC_035789.1,3155464,3158924,3155464,3158924,111117282,XM_022456349.1,uncharacterized LOC111117282,3460
NC_035789.1,3217518,3218808,3217518,3218808,111117283,XM_022456350.1,uncharacterized LOC111117283,1290
NC_035789.1,3158953,3161236,3158953,3161236,111117284,XM_022456351.1,uncharacterized LOC111117284,2283
NC_035789.1,3216398,3217326,3216398,3217326,111117285,XM_022456352.1,uncharacterized LOC111117285,928
NC_035789.1,2850680,2857783,2850680,2857783,111117287,XM_022456353.1,uncharacterized LOC111117287,7103
NC_035789.1,19310350,19312858,19310350,19312858,111117292,XM_022456355.1,uncharacterized LOC111117292,2508
NC_035789.1,27372176,27377534,27372176,27373713,111117293,XM_022456357.1,uncharacterized LOC111117293,1537
NC_035789.1,27372176,27377534,27374250,27377534,111117293,XM_022456356.1,uncharacterized LOC111117293,3284
NC_035789.1,4681683,4685141,4681683,4685141,111117296,XM_022456358.1,uncharacterized LOC111117296,3458
NC_035789.1,4630879,4636548,4630879,4636548,111117297,XM_022456359.1,uncharacterized LOC111117297,5669
NC_035789.1,4573015,4575591,4573391,4575591,111117298,XM_022456361.1,uncharacterized LOC111117298,2200
NC_035789.1,4573015,4575591,4573015,4575591,111117298,XM_022456360.1,uncharacterized LOC111117298,2576
NC_035789.1,6872646,6879541,6872646,6879541,111117311,XM_022456375.1,uncharacterized LOC111117311,6895
NC_035789.1,15825031,15827387,15825031,15827387,111117313,XM_022456376.1,uncharacterized LOC111117313,2356
NC_035789.1,2724021,2726586,2724021,2726586,111117317,XM_022456381.1,uncharacterized LOC111117317,2565
NC_035789.1,2699968,2724598,2699968,2724500,111117318,XM_022456382.1,uncharacterized LOC111117318,24532
NC_035789.1,2699968,2724598,2699968,2724598,111117318,XM_022456383.1,uncharacterized LOC111117318,24630
NC_035789.1,2714211,2721236,2714211,2721236,111117320,XM_022456384.1,uncharacterized LOC111117320,7025
NC_035789.1,23379468,23407354,23379469,23401309,111117323,XM_022456387.1,uncharacterized LOC111117323,21840
NC_035789.1,23379468,23407354,23379468,23407354,111117323,XM_022456386.1,uncharacterized LOC111117323,27886
NC_035780.1,27009723,27011524,27009723,27011524,111117332,XM_022456765.1,uncharacterized LOC111117332,1801
NC_035789.1,26686457,26703797,26688007,26703797,111117340,XM_022456420.1,uncharacterized LOC111117340,15790
NC_035789.1,26686457,26703797,26686457,26703797,111117340,XM_022456419.1,uncharacterized LOC111117340,17340
NC_035789.1,8810901,8819627,8810901,8819627,111117344,XM_022456426.1,uncharacterized LOC111117344,8726
NC_035789.1,24747609,24757450,24747609,24757450,111117348,XM_022456433.1,uncharacterized LOC111117348,9841
NC_035789.1,31070790,31093189,31078189,31093189,111117354,XM_022456448.1,uncharacterized LOC111117354,15000
NC_035789.1,31070790,31093189,31073418,31093189,111117354,XM_022456449.1,uncharacterized LOC111117354,19771
NC_035789.1,31070790,31093189,31073322,31093189,111117354,XM_022456450.1,uncharacterized LOC111117354,19867
NC_035789.1,31070790,31093189,31070790,31093189,111117354,XM_022456446.1,uncharacterized LOC111117354,22399
NC_035789.1,31025459,31028040,31025459,31028040,111117357,XM_022456452.1,uncharacterized LOC111117357,2581
NC_035789.1,31033077,31035788,31033077,31035788,111117361,XM_022456456.1,uncharacterized LOC111117361,2711
NC_035789.1,13006830,13009816,13007138,13009816,111117363,XM_022456459.1,uncharacterized LOC111117363,2678
NC_035789.1,13006830,13009816,13006830,13009816,111117363,XM_022456458.1,uncharacterized LOC111117363,2986
NC_035789.1,26770370,26790154,26778619,26790154,111117364,XM_022456462.1,uncharacterized LOC111117364,11535
NC_035789.1,26770370,26790154,26770370,26790154,111117364,XM_022456463.1,uncharacterized LOC111117364,19784
NC_035789.1,28469701,28537570,28469701,28537570,111117367,XM_022456466.1,uncharacterized LOC111117367,67869
NC_035789.1,4006738,4034265,4006738,4029751,111117369,XM_022456470.1,uncharacterized LOC111117369,23013
NC_035789.1,4006738,4034265,4006738,4029753,111117369,XM_022456469.1,uncharacterized LOC111117369,23015
NC_035789.1,4006738,4034265,4006738,4034265,111117369,XM_022456468.1,uncharacterized LOC111117369,27527
NC_035789.1,7385766,7407734,7385766,7407734,111117372,XM_022456472.1,uncharacterized LOC111117372,21968
NC_035789.1,7437189,7439881,7437189,7439881,111117373,XM_022456473.1,uncharacterized LOC111117373,2692
NC_035789.1,7447377,7449975,7447377,7449975,111117374,XM_022456474.1,uncharacterized LOC111117374,2598
NC_035789.1,7363469,7366649,7363469,7366599,111117376,XM_022456478.1,uncharacterized LOC111117376,3130
NC_035789.1,7363469,7366649,7363469,7366649,111117376,XM_022456477.1,uncharacterized LOC111117376,3180
NC_035789.1,7588650,7590099,7588650,7590099,111117381,XM_022456484.1,uncharacterized LOC111117381,1449
NC_035789.1,2729531,2741246,2731201,2741246,111117385,XM_022456490.1,uncharacterized LOC111117385,10045
NC_035789.1,2729531,2741246,2729531,2740012,111117385,XM_022456487.1,uncharacterized LOC111117385,10481
NC_035789.1,2729531,2741246,2729531,2741239,111117385,XM_022456488.1,uncharacterized LOC111117385,11708
NC_035789.1,2729531,2741246,2731866,2741246,111117385,XM_022456489.1,uncharacterized LOC111117385,9380
NC_035789.1,9421037,9425992,9421037,9425992,111117386,XM_022456491.1,uncharacterized LOC111117386,4955
NC_035789.1,9427924,9439218,9428035,9439218,111117388,XM_022456493.1,uncharacterized LOC111117388,11183
NC_035789.1,9427924,9439218,9427924,9439218,111117388,XM_022456492.1,uncharacterized LOC111117388,11294
NC_035789.1,9427924,9439218,9429551,9439218,111117388,XM_022456494.1,uncharacterized LOC111117388,9667
NC_035789.1,9425985,9428015,9425985,9428015,111117389,XM_022456495.1,uncharacterized LOC111117389,2030
NC_035789.1,3939279,3976443,3939279,3965786,111117393,XM_022456499.1,uncharacterized LOC111117393,26507
NC_035789.1,3939279,3976443,3939279,3976443,111117393,XM_022456500.1,uncharacterized LOC111117393,37164
NC_035789.1,23303347,23312270,23303347,23312270,111117395,XM_022456503.1,uncharacterized LOC111117395,8923
NC_035789.1,23273677,23298432,23273677,23298432,111117398,XM_022456506.1,uncharacterized LOC111117398,24755
NC_035780.1,35902314,35903528,35902314,35903528,111117407,XM_022456559.1,uncharacterized LOC111117407,1214
NC_035789.1,25821500,25828663,25821515,25828663,111117410,XM_022456528.1,uncharacterized LOC111117410,7148
NC_035789.1,25821500,25828663,25821500,25828663,111117410,XM_022456527.1,uncharacterized LOC111117410,7163
NC_035789.1,25801457,25807195,25801457,25807195,111117411,XM_022456529.1,uncharacterized LOC111117411,5738
NC_035789.1,3621332,3625217,3621332,3625217,111117421,XM_022456547.1,uncharacterized LOC111117421,3885
NC_035789.1,3645871,3647504,3645871,3647504,111117430,XM_022456554.1,uncharacterized LOC111117430,1633
NC_035789.1,18456771,18459968,18456771,18459968,111117432,XM_022456557.1,uncharacterized LOC111117432,3197
NC_035789.1,26200566,26271294,26200566,26271294,111117437,XM_022456563.1,uncharacterized LOC111117437,70728
NC_035789.1,30272540,30279793,30272540,30279793,111117438,XM_022456565.1,uncharacterized LOC111117438,7253
NC_035789.1,5454183,5465908,5454183,5465908,111117445,XM_022456570.1,uncharacterized LOC111117445,11725
NC_035789.1,7999651,8005400,7999651,8005400,111117446,XM_022456571.1,uncharacterized LOC111117446,5749
NC_035789.1,8007759,8016710,8011087,8016710,111117447,XM_022456576.1,uncharacterized LOC111117447,5623
NC_035789.1,8007759,8016710,8008291,8016710,111117447,XM_022456574.1,uncharacterized LOC111117447,8419
NC_035789.1,8007759,8016710,8007759,8016710,111117447,XM_022456573.1,uncharacterized LOC111117447,8951
NC_035789.1,43895,110891,43895,110891,111117454,XM_022456579.1,uncharacterized LOC111117454,66996
NC_035789.1,7759408,7762310,7759408,7762310,111117458,XM_022456593.1,uncharacterized LOC111117458,2902
NC_035789.1,8364660,8367133,8364660,8367133,111117459,XM_022456594.1,uncharacterized LOC111117459,2473
NC_035789.1,24842357,24843993,24842357,24843993,111117463,XM_022456598.1,uncharacterized LOC111117463,1636
NC_035789.1,6772819,6779438,6772819,6779438,111117464,XM_022456599.1,uncharacterized LOC111117464,6619
NC_035789.1,7320680,7327620,7320684,7327554,111117466,XM_022456602.1,uncharacterized LOC111117466,6870
NC_035789.1,7320680,7327620,7320680,7327620,111117466,XM_022456601.1,uncharacterized LOC111117466,6940
NC_035789.1,4413256,4425062,4413256,4425062,111117471,XM_022456608.1,uncharacterized LOC111117471,11806
NC_035789.1,20825783,20827993,20825790,20827993,111117480,XM_022456618.1,uncharacterized LOC111117480,2203
NC_035789.1,20825783,20827993,20825783,20827993,111117480,XM_022456619.1,uncharacterized LOC111117480,2210
NC_035789.1,9273841,9278228,9273841,9278228,111117481,XM_022456620.1,uncharacterized LOC111117481,4387
NC_035789.1,4036462,4039659,4036462,4039659,111117483,XM_022456621.1,uncharacterized LOC111117483,3197
NC_035789.1,10301397,10310230,10301397,10310230,111117486,XM_022456623.1,uncharacterized LOC111117486,8833
NC_035789.1,3341167,3342289,3341167,3342289,111117489,XM_022456626.1,uncharacterized LOC111117489,1122
NC_035789.1,8155220,8176496,8155220,8176496,111117490,XM_022456627.1,uncharacterized LOC111117490,21276
NC_035789.1,8132579,8148792,8132579,8148787,111117491,XM_022456629.1,uncharacterized LOC111117491,16208
NC_035789.1,8132579,8148792,8132580,8148792,111117491,XM_022456628.1,uncharacterized LOC111117491,16212
NC_035780.1,52079874,52085012,52079874,52085012,111117492,XM_022456665.1,uncharacterized LOC111117492,5138
NC_035789.1,9330002,9357489,9330019,9344655,111117496,XM_022456632.1,uncharacterized LOC111117496,14636
NC_035789.1,9330002,9357489,9330004,9357489,111117496,XM_022456631.1,uncharacterized LOC111117496,27485
NC_035789.1,9330002,9357489,9331999,9337079,111117496,XM_022456635.1,uncharacterized LOC111117496,5080
NC_035789.1,9330002,9357489,9330002,9337079,111117496,XM_022456633.1,uncharacterized LOC111117496,7077
NC_035789.1,9330002,9357489,9348791,9357489,111117496,XM_022456634.1,uncharacterized LOC111117496,8698
NC_035789.1,2803659,2806407,2803659,2806407,111117499,XM_022456637.1,uncharacterized LOC111117499,2748
NC_035789.1,8720506,8723591,8720506,8723531,111117507,XM_022456651.1,uncharacterized LOC111117507,3025
NC_035789.1,8720506,8723591,8720506,8723537,111117507,XM_022456650.1,uncharacterized LOC111117507,3031
NC_035789.1,8720506,8723591,8720506,8723591,111117507,XM_022456649.1,uncharacterized LOC111117507,3085
NC_035789.1,16773596,16774975,16773596,16774975,111117509,XM_022456652.1,uncharacterized LOC111117509,1379
NC_035789.1,15011336,15013706,15011336,15013706,111117510,XM_022456653.1,uncharacterized LOC111117510,2370
NC_035789.1,3714298,3720921,3714298,3720921,111117512,XM_022456655.1,uncharacterized LOC111117512,6623
NC_035789.1,10388646,10390418,10388646,10390418,111117515,XM_022456658.1,uncharacterized LOC111117515,1772
NC_035789.1,10389575,10392013,10389575,10392003,111117516,XM_022456661.1,uncharacterized LOC111117516,2428
NC_035789.1,10389575,10392013,10389581,10392013,111117516,XM_022456660.1,uncharacterized LOC111117516,2432
NC_035789.1,10389575,10392013,10389575,10392013,111117516,XM_022456659.1,uncharacterized LOC111117516,2438
NC_035789.1,31970308,31982955,31970308,31982658,111117517,XM_022456662.1,uncharacterized LOC111117517,12350
NC_035789.1,31970308,31982955,31970308,31982955,111117517,XM_022456663.1,uncharacterized LOC111117517,12647
NC_035789.1,16246992,16250518,16246992,16250518,111117520,XM_022456666.1,uncharacterized LOC111117520,3526
NC_035789.1,346793,348612,346793,348612,111117521,XM_022456667.1,uncharacterized LOC111117521,1819
NC_035789.1,18633012,18643425,18633012,18643425,111117522,XM_022456668.1,uncharacterized LOC111117522,10413
NC_035789.1,12822447,12826247,12822546,12826247,111117524,XM_022456670.1,uncharacterized LOC111117524,3701
NC_035789.1,12822447,12826247,12822447,12826247,111117524,XM_022456669.1,uncharacterized LOC111117524,3800
NC_035789.1,20471766,20474455,20471766,20474455,111117525,XM_022456674.1,uncharacterized LOC111117525,2689
NC_035789.1,14648121,14650191,14648121,14650191,111117530,XM_022456677.1,uncharacterized LOC111117530,2070
NC_035789.1,3331200,3332613,3331200,3332613,111117531,XM_022456678.1,uncharacterized LOC111117531,1413
NC_035789.1,21488143,21491178,21488143,21491178,111117538,XM_022456693.1,uncharacterized LOC111117538,3035
NC_035789.1,22406384,22430912,22406384,22420898,111117543,XM_022456694.1,uncharacterized LOC111117543,14514
NC_035789.1,22406384,22430912,22406384,22430912,111117543,XM_022456695.1,uncharacterized LOC111117543,24528
NC_035789.1,15511521,15518097,15511521,15518097,111117544,XM_022456696.1,uncharacterized LOC111117544,6576
NC_035789.1,10544535,10551227,10544535,10551227,111117545,XM_022456697.1,uncharacterized LOC111117545,6692
NC_035789.1,13463518,13469501,13463518,13469501,111117546,XM_022456698.1,uncharacterized LOC111117546,5983
NC_035789.1,29689367,29692463,29689367,29692463,111117554,XM_022456702.1,uncharacterized LOC111117554,3096
NC_035789.1,15454796,15459080,15455141,15459080,111117557,XM_022456706.1,uncharacterized LOC111117557,3939
NC_035789.1,15454796,15459080,15454796,15459080,111117557,XM_022456705.1,uncharacterized LOC111117557,4284
NC_035789.1,5284711,5286543,5284711,5286543,111117558,XM_022456707.1,uncharacterized LOC111117558,1832
NC_035789.1,31806640,31814114,31808400,31814114,111117566,XM_022456713.1,uncharacterized LOC111117566,5714
NC_035789.1,18268096,18297091,18268096,18286138,111117584,XM_022456738.1,uncharacterized LOC111117584,18042
NC_035789.1,18268096,18297091,18268096,18287192,111117584,XM_022456736.1,uncharacterized LOC111117584,19096
NC_035789.1,18268096,18297091,18268096,18297091,111117584,XM_022456737.1,uncharacterized LOC111117584,28995
NC_035789.1,18280074,18282974,18280074,18282974,111117586,XM_022456739.1,uncharacterized LOC111117586,2900
NC_035789.1,19802588,19809323,19802588,19809323,111117588,XM_022456741.1,uncharacterized LOC111117588,6735
NC_035789.1,31917788,31925469,31917788,31925469,111117592,XM_022456745.1,uncharacterized LOC111117592,7681
NC_035789.1,11943909,11948857,11943909,11948857,111117593,XM_022456747.1,uncharacterized LOC111117593,4948
NC_035789.1,10407560,10411306,10407560,10411306,111117596,XM_022456749.1,uncharacterized LOC111117596,3746
NC_035789.1,14060200,14064254,14060200,14064254,111117601,XM_022456755.1,uncharacterized LOC111117601,4054
NC_035789.1,7265132,7274561,7265132,7274561,111117604,XM_022456757.1,uncharacterized LOC111117604,9429
NC_035789.1,15069575,15072492,15069575,15072492,111117605,XM_022456758.1,uncharacterized LOC111117605,2917
NC_035789.1,27115364,27121057,27115364,27121057,111117606,XM_022456759.1,uncharacterized LOC111117606,5693
NC_035789.1,9513446,9537443,9513446,9537443,111117611,XM_022456763.1,uncharacterized LOC111117611,23997
NC_035789.1,30449997,30453077,30449997,30453077,111117615,XM_022456767.1,uncharacterized LOC111117615,3080
NC_035789.1,360188,378258,360188,378257,111117616,XM_022456768.1,uncharacterized LOC111117616,18069
NC_035789.1,360188,378258,360188,378258,111117616,XM_022456769.1,uncharacterized LOC111117616,18070
NC_035789.1,7643895,7648138,7643895,7648138,111117619,XM_022456773.1,uncharacterized LOC111117619,4243
NC_035789.1,7641094,7643900,7641094,7643900,111117620,XM_022456774.1,uncharacterized LOC111117620,2806
NC_035789.1,3776118,3784598,3776118,3784598,111117622,XM_022456775.1,uncharacterized LOC111117622,8480
NC_035789.1,21491266,21494922,21491266,21494922,111117626,XM_022456778.1,uncharacterized LOC111117626,3656
NC_035789.1,9197513,9206157,9197513,9206157,111117629,XM_022456780.1,uncharacterized LOC111117629,8644
NC_035789.1,5509500,5525221,5513868,5525221,111117630,XM_022456784.1,uncharacterized LOC111117630,11353
NC_035789.1,5509500,5525221,5509500,5525221,111117630,XM_022456783.1,uncharacterized LOC111117630,15721
NC_035789.1,2771032,2773768,2771498,2773768,111117631,XM_022456785.1,uncharacterized LOC111117631,2270
NC_035789.1,2771032,2773768,2771032,2773768,111117631,XM_022456786.1,uncharacterized LOC111117631,2736
NC_035789.1,25448419,25493654,25448419,25493654,111117632,XM_022456787.1,uncharacterized LOC111117632,45235
NC_035789.1,25609787,25660455,25609787,25660455,111117633,XM_022456788.1,uncharacterized LOC111117633,50668
NC_035781.1,6460078,6463268,6460078,6463268,111117642,XM_022456801.1,uncharacterized LOC111117642,3190
NC_035789.1,31173512,31175712,31173512,31175712,111117646,XM_022456803.1,uncharacterized LOC111117646,2200
NC_035789.1,14481695,14487652,14481695,14487652,111117649,XM_022456806.1,uncharacterized LOC111117649,5957
NC_035789.1,3882691,3889579,3882691,3889569,111117652,XM_022456812.1,uncharacterized LOC111117652,6878
NC_035789.1,16130915,16132593,16130915,16132593,111117654,XM_022456814.1,uncharacterized LOC111117654,1678
NC_035789.1,444229,447418,444229,447418,111117655,XM_022456816.1,uncharacterized LOC111117655,3189
NC_035789.1,21695354,21697049,21695357,21697049,111117659,XM_022456820.1,uncharacterized LOC111117659,1692
NC_035789.1,21695354,21697049,21695354,21697049,111117659,XM_022456819.1,uncharacterized LOC111117659,1695
NC_035789.1,16275926,16280387,16275926,16280387,111117662,XM_022456821.1,uncharacterized LOC111117662,4461
NC_035789.1,19100983,19104119,19100983,19104119,111117664,XM_022456823.1,uncharacterized LOC111117664,3136
NC_035789.1,23615154,23621986,23615154,23621986,111117674,XM_022456841.1,uncharacterized LOC111117674,6832
NC_035789.1,18819913,18824596,18819913,18824596,111117676,XM_022456842.1,uncharacterized LOC111117676,4683
NC_035789.1,22579390,22582501,22579390,22582501,111117677,XM_022456843.1,uncharacterized LOC111117677,3111
NC_035789.1,18116567,18122938,18116567,18122938,111117680,XM_022456846.1,uncharacterized LOC111117680,6371
NC_035789.1,14863181,14876010,14863181,14876010,111117682,XM_022456848.1,uncharacterized LOC111117682,12829
NC_035789.1,10452714,10456563,10452714,10456563,111117683,XM_022456849.1,uncharacterized LOC111117683,3849
NC_035781.1,20232316,20241152,20232316,20241152,111117686,XM_022456854.1,uncharacterized LOC111117686,8836
NC_035789.1,7340684,7345472,7340684,7345472,111117688,XM_022456852.1,uncharacterized LOC111117688,4788
NC_035789.1,12957807,12962920,12957807,12962920,111117692,XM_022456857.1,uncharacterized LOC111117692,5113
NC_035789.1,20736633,20739302,20736807,20739302,111117694,XM_022456860.1,uncharacterized LOC111117694,2495
NC_035789.1,20736633,20739302,20736633,20739302,111117694,XM_022456859.1,uncharacterized LOC111117694,2669
NC_035789.1,11505374,11507690,11505374,11507690,111117698,XM_022456862.1,uncharacterized LOC111117698,2316
NC_035789.1,12067094,12068350,12067094,12068350,111117699,XM_022456864.1,uncharacterized LOC111117699,1256
NC_035789.1,7660638,7667991,7660638,7667991,111117700,XM_022456866.1,uncharacterized LOC111117700,7353
NC_035789.1,10277849,10279106,10277849,10279106,111117703,XM_022456869.1,uncharacterized LOC111117703,1257
NC_035789.1,2233618,2244535,2233618,2244521,111117705,XM_022456871.1,uncharacterized LOC111117705,10903
NC_035789.1,2233618,2244535,2233618,2244535,111117705,XM_022456872.1,uncharacterized LOC111117705,10917
NC_035789.1,15560653,15562284,15560653,15562284,111117706,XM_022456875.1,uncharacterized LOC111117706,1631
NC_035789.1,25046026,25049116,25046080,25049116,111117707,XM_022456878.1,uncharacterized LOC111117707,3036
NC_035789.1,25046026,25049116,25046026,25049116,111117707,XM_022456877.1,uncharacterized LOC111117707,3090
NC_035789.1,25063608,25065851,25063608,25065851,111117708,XM_022456879.1,uncharacterized LOC111117708,2243
NC_035789.1,25050927,25052852,25050927,25052852,111117709,XM_022456880.1,uncharacterized LOC111117709,1925
NC_035781.1,9822279,9843878,9822279,9843878,111117711,XM_022456907.1,uncharacterized LOC111117711,21599
NC_035789.1,447494,451703,447494,451703,111117712,XM_022456882.1,uncharacterized LOC111117712,4209
NC_035789.1,15358216,15360911,15358216,15360911,111117713,XM_022456883.1,uncharacterized LOC111117713,2695
NC_035789.1,27463572,27466190,27463572,27466190,111117719,XM_022456888.1,uncharacterized LOC111117719,2618
NC_035789.1,27466324,27468445,27466324,27468445,111117720,XM_022456889.1,uncharacterized LOC111117720,2121
NC_035789.1,16432765,16437451,16432765,16437451,111117725,XM_022456898.1,uncharacterized LOC111117725,4686
NC_035789.1,8737326,8746753,8737326,8746753,111117728,XM_022456903.1,uncharacterized LOC111117728,9427
NC_035789.1,932549,956929,932549,956929,111117734,XM_022456915.1,uncharacterized LOC111117734,24380
NC_035789.1,1089890,1128132,1089890,1128132,111117735,XM_022456920.1,uncharacterized LOC111117735,38242
NC_035789.1,1089890,1128132,1089890,1097416,111117735,XM_022456925.1,uncharacterized LOC111117735,7526
NC_035789.1,1089890,1128132,1089890,1097723,111117735,XM_022456919.1,uncharacterized LOC111117735,7833
NC_035789.1,1089890,1128132,1089890,1097724,111117735,XM_022456918.1,uncharacterized LOC111117735,7834
NC_035789.1,1089890,1128132,1089890,1097725,111117735,XM_022456917.1,uncharacterized LOC111117735,7835
NC_035789.1,1929518,2035169,1929518,1939728,111117736,XM_022456930.1,uncharacterized LOC111117736,10210
NC_035789.1,1929518,2035169,1929518,1939755,111117736,XM_022456929.1,uncharacterized LOC111117736,10237
NC_035789.1,1929518,2035169,1929518,2035169,111117736,XM_022456932.1,uncharacterized LOC111117736,105651
NC_035789.1,1929518,2035169,1973135,1984238,111117736,XM_022456926.1,uncharacterized LOC111117736,11103
NC_035789.1,1929518,2035169,1929518,2026319,111117736,XM_022456928.1,uncharacterized LOC111117736,96801
NC_035781.1,17215614,17218220,17215614,17218220,111117737,XM_022456931.1,uncharacterized LOC111117737,2606
NC_035789.1,821514,1211632,821514,1211632,111117739,XM_022456937.1,uncharacterized LOC111117739,390118
NC_035789.1,821514,1211632,1162389,1211632,111117739,XM_022456940.1,uncharacterized LOC111117739,49243
NC_035789.1,821514,1211632,1161541,1211632,111117739,XM_022456936.1,uncharacterized LOC111117739,50091
NC_035789.1,821514,1211632,1203220,1211632,111117739,XM_022456938.1,uncharacterized LOC111117739,8412
NC_035789.1,821514,1211632,1203213,1211632,111117739,XM_022456942.1,uncharacterized LOC111117739,8419
NC_035789.1,1560386,1821361,1806233,1817063,111117740,XM_022456944.1,uncharacterized LOC111117740,10830
NC_035789.1,1560386,1821361,1603167,1617080,111117740,XM_022456945.1,uncharacterized LOC111117740,13913
NC_035789.1,1560386,1821361,1603167,1617089,111117740,XM_022456947.1,uncharacterized LOC111117740,13922
NC_035789.1,1560386,1821361,1560386,1577336,111117740,XM_022456952.1,uncharacterized LOC111117740,16950
NC_035789.1,1560386,1821361,1603167,1620391,111117740,XM_022456946.1,uncharacterized LOC111117740,17224
NC_035789.1,1560386,1821361,1560437,1817069,111117740,XM_022456951.1,uncharacterized LOC111117740,256632
NC_035789.1,1560386,1821361,1767256,1817064,111117740,XM_022456943.1,uncharacterized LOC111117740,49808
NC_035789.1,1560386,1821361,1560441,1617089,111117740,XM_022456948.1,uncharacterized LOC111117740,56648
NC_035789.1,1880767,1941436,1880767,1892550,111117742,XM_022456959.1,uncharacterized LOC111117742,11783
NC_035789.1,1880767,1941436,1880767,1892715,111117742,XM_022456953.1,uncharacterized LOC111117742,11948
NC_035789.1,1880767,1941436,1880767,1915274,111117742,XM_022456957.1,uncharacterized LOC111117742,34507
NC_035789.1,1880767,1941436,1880767,1916029,111117742,XM_022456963.1,uncharacterized LOC111117742,35262
NC_035789.1,1880767,1941436,1880767,1916127,111117742,XM_022456962.1,uncharacterized LOC111117742,35360
NC_035789.1,1880767,1941436,1880767,1917441,111117742,XM_022456964.1,uncharacterized LOC111117742,36674
NC_035789.1,1880767,1941436,1888361,1892715,111117742,XM_022456954.1,uncharacterized LOC111117742,4354
NC_035789.1,1880767,1941436,1880767,1941436,111117742,XM_022456958.1,uncharacterized LOC111117742,60669
NC_035789.1,738214,790684,773591,790684,111117745,XM_022456968.1,uncharacterized LOC111117745,17093
NC_035789.1,738214,790684,772954,790684,111117745,XM_022456966.1,uncharacterized LOC111117745,17730
NC_035789.1,738214,790684,772853,790684,111117745,XM_022456967.1,uncharacterized LOC111117745,17831
NC_035789.1,738214,790684,741485,790684,111117745,XM_022456965.1,uncharacterized LOC111117745,49199
NC_035789.1,738214,790684,738214,790684,111117745,XM_022456969.1,uncharacterized LOC111117745,52470
NC_035789.1,738214,790684,781886,790684,111117745,XM_022456970.1,uncharacterized LOC111117745,8798
NC_035789.1,1712419,1715173,1712419,1715173,111117747,XM_022456972.1,uncharacterized LOC111117747,2754
NC_035789.1,1509577,1523481,1509577,1523481,111117748,XM_022456973.1,uncharacterized LOC111117748,13904
NC_035789.1,652802,661480,653402,661480,111117749,XM_022456977.1,uncharacterized LOC111117749,8078
NC_035789.1,652802,661480,652802,661480,111117749,XM_022456976.1,uncharacterized LOC111117749,8678
NC_035789.1,1136014,1175392,1136014,1149405,111117750,XM_022456980.1,uncharacterized LOC111117750,13391
NC_035789.1,1136014,1175392,1136014,1175392,111117750,XM_022456981.1,uncharacterized LOC111117750,39378
NC_035789.1,618001,630655,618001,630655,111117751,XM_022456983.1,uncharacterized LOC111117751,12654
NC_035781.1,16205846,16207920,16205846,16207920,111117752,XM_022456987.1,uncharacterized LOC111117752,2074
NC_035789.1,1272560,1276518,1272560,1276518,111117756,XM_022456994.1,uncharacterized LOC111117756,3958
NC_035789.1,1789987,1793053,1789987,1793053,111117757,XM_022456997.1,uncharacterized LOC111117757,3066
NC_035789.1,665165,668470,665165,668470,111117759,XM_022456998.1,uncharacterized LOC111117759,3305
NC_035789.1,2013819,2024657,2013821,2024657,111117762,XM_022457005.1,uncharacterized LOC111117762,10836
NC_035789.1,683208,686590,683208,686590,111117765,XM_022457009.1,uncharacterized LOC111117765,3382
NC_035789.1,1920515,1922269,1920515,1922266,111117767,XM_022457010.1,uncharacterized LOC111117767,1751
NC_035789.1,1920515,1922269,1920515,1922269,111117767,XM_022457011.1,uncharacterized LOC111117767,1754
NC_035789.1,996839,1007049,996839,1007049,111117768,XM_022457013.1,uncharacterized LOC111117768,10210
NC_035789.1,996839,1007049,996839,1006177,111117768,XM_022457012.1,uncharacterized LOC111117768,9338
NC_035789.1,12130779,12134880,12130779,12134880,111117781,XM_022457017.1,uncharacterized LOC111117781,4101
NC_035789.1,30056838,30059754,30056838,30059754,111117782,XM_022457018.1,uncharacterized LOC111117782,2916
NC_035789.1,4800027,4803531,4800027,4803531,111117789,XM_022457022.1,uncharacterized LOC111117789,3504
NC_035789.1,10585457,10588105,10585457,10588105,111117792,XM_022457024.1,uncharacterized LOC111117792,2648
NC_035789.1,9299582,9321207,9299582,9321207,111117795,XM_022457025.1,uncharacterized LOC111117795,21625
NC_035789.1,30918355,30919724,30918355,30919724,111117797,XM_022457027.1,uncharacterized LOC111117797,1369
NC_035789.1,6761376,6771683,6761376,6771683,111117800,XM_022457029.1,uncharacterized LOC111117800,10307
NC_035789.1,22731371,22764352,22731371,22764352,111117804,XM_022457037.1,uncharacterized LOC111117804,32981
NC_035789.1,22690193,22707426,22690193,22707426,111117805,XM_022457038.1,uncharacterized LOC111117805,17233
NC_035781.1,47622397,47626206,47622397,47626206,111117808,XM_022457043.1,uncharacterized LOC111117808,3809
NC_035789.1,23105980,23108288,23105980,23108288,111117809,XM_022457040.1,uncharacterized LOC111117809,2308
NC_035789.1,23068095,23070893,23068095,23070893,111117810,XM_022457041.1,uncharacterized LOC111117810,2798
NC_035789.1,23142391,23144822,23142391,23144822,111117811,XM_022457042.1,uncharacterized LOC111117811,2431
NC_035789.1,22853684,22856056,22853684,22856056,111117816,XM_022457050.1,uncharacterized LOC111117816,2372
NC_035789.1,23203330,23206489,23203330,23206489,111117821,XM_022457055.1,uncharacterized LOC111117821,3159
NC_035789.1,22782256,22784802,22782256,22784802,111117822,XM_022457056.1,uncharacterized LOC111117822,2546
NC_035789.1,23210634,23213071,23210634,23213071,111117823,XM_022457057.1,uncharacterized LOC111117823,2437
NC_035789.1,23206409,23207476,23206409,23207476,111117826,XM_022457060.1,uncharacterized LOC111117826,1067
NC_035789.1,22775623,22778412,22775623,22778412,111117830,XM_022457062.1,uncharacterized LOC111117830,2789
NC_035789.1,22809998,22820071,22809998,22820071,111117835,XM_022457070.1,uncharacterized LOC111117835,10073
NC_035789.1,18033914,18043669,18033914,18043669,111117841,XM_022457071.1,uncharacterized LOC111117841,9755
NC_035789.1,31250221,31252987,31250221,31252987,111117844,XM_022457074.1,uncharacterized LOC111117844,2766
NC_035789.1,11970016,11970992,11970016,11970992,111117845,XM_022457075.1,uncharacterized LOC111117845,976
NC_035789.1,19589981,19591691,19589981,19591691,111117849,XM_022457079.1,uncharacterized LOC111117849,1710
NC_035789.1,3508193,3510938,3508193,3510938,111117853,XM_022457080.1,uncharacterized LOC111117853,2745
NC_035789.1,32427213,32429123,32427213,32429123,111117854,XM_022457081.1,uncharacterized LOC111117854,1910
NC_035789.1,14853418,14855342,14853418,14855342,111117857,XM_022457084.1,uncharacterized LOC111117857,1924
NC_035789.1,17352189,17357208,17352189,17357208,111117859,XM_022457086.1,uncharacterized LOC111117859,5019
NC_035789.1,18937780,18957449,18942972,18957449,111117861,XM_022457098.1,uncharacterized LOC111117861,14477
NC_035789.1,18937780,18957449,18941780,18957449,111117861,XM_022457095.1,uncharacterized LOC111117861,15669
NC_035789.1,18937780,18957449,18941354,18957449,111117861,XM_022457093.1,uncharacterized LOC111117861,16095
NC_035781.1,20810453,20818703,20810453,20818703,111117862,XM_022457097.1,uncharacterized LOC111117862,8250
NC_035789.1,15676537,15679596,15676537,15679596,111117864,XM_022457100.1,uncharacterized LOC111117864,3059
NC_035789.1,29915904,29917351,29915904,29917351,111117865,XM_022457101.1,uncharacterized LOC111117865,1447
NC_035789.1,12087873,12090627,12088044,12090627,111117868,XM_022457103.1,uncharacterized LOC111117868,2583
NC_035789.1,12087873,12090627,12087873,12090627,111117868,XM_022457102.1,uncharacterized LOC111117868,2754
NC_035789.1,12090626,12093180,12090626,12093180,111117869,XM_022457105.1,uncharacterized LOC111117869,2554
NC_035789.1,24534347,24564240,24534347,24564240,111117870,XM_022457106.1,uncharacterized LOC111117870,29893
NC_035781.1,859272,863557,859272,863557,111117874,XM_022457115.1,uncharacterized LOC111117874,4285
NC_035789.1,7833814,7836305,7833814,7836305,111117876,XM_022457112.1,uncharacterized LOC111117876,2491
NC_035789.1,8440920,8445130,8440920,8445130,111117878,XM_022457116.1,uncharacterized LOC111117878,4210
NC_035789.1,388221,405059,388221,405059,111117879,XM_022457118.1,uncharacterized LOC111117879,16838
NC_035789.1,19403973,19407967,19403984,19407967,111117880,XM_022457120.1,uncharacterized LOC111117880,3983
NC_035789.1,19403973,19407967,19403973,19407967,111117880,XM_022457119.1,uncharacterized LOC111117880,3994
NC_035789.1,10740304,10744452,10741968,10744452,111117886,XM_022457126.1,uncharacterized LOC111117886,2484
NC_035789.1,10740304,10744452,10740304,10744452,111117886,XM_022457125.1,uncharacterized LOC111117886,4148
NC_035789.1,29721318,29723788,29721318,29723788,111117888,XM_022457127.1,uncharacterized LOC111117888,2470
NC_035789.1,19518605,19525024,19518605,19525024,111117892,XM_022457129.1,uncharacterized LOC111117892,6419
NC_035789.1,15073327,15074217,15073327,15074217,111117893,XM_022457130.1,uncharacterized LOC111117893,890
NC_035789.1,8390788,8401978,8390788,8401978,111117894,XM_022457131.1,uncharacterized LOC111117894,11190
NC_035789.1,7858401,7862523,7858401,7862523,111117895,XM_022457132.1,uncharacterized LOC111117895,4122
NC_035789.1,18133270,18134510,18133270,18134510,111117896,XM_022457133.1,uncharacterized LOC111117896,1240
NC_035789.1,2315739,2318920,2315739,2318920,111117898,XM_022457134.1,uncharacterized LOC111117898,3181
NC_035789.1,8455268,8467878,8455268,8467878,111117901,XM_022457136.1,uncharacterized LOC111117901,12610
NC_035789.1,20898444,20904480,20898444,20901461,111117902,XM_022457137.1,uncharacterized LOC111117902,3017
NC_035789.1,20898444,20904480,20898444,20901767,111117902,XM_022457138.1,uncharacterized LOC111117902,3323
NC_035789.1,14991342,14992415,14991342,14992415,111117905,XM_022457141.1,uncharacterized LOC111117905,1073
NC_035780.1,59349027,59353104,59349027,59353104,111117915,XM_022457152.1,uncharacterized LOC111117915,4077
NC_035781.1,49534321,49555143,49534321,49555143,111117918,XM_022457151.1,uncharacterized LOC111117918,20822
NC_035781.1,49538515,49541656,49538515,49541656,111117919,XM_022457153.1,uncharacterized LOC111117919,3141
NC_035781.1,45151236,45161779,45151236,45161779,111117927,XM_022457163.1,uncharacterized LOC111117927,10543
NC_035781.1,8941496,8949965,8944311,8949965,111117929,XM_022457171.1,uncharacterized LOC111117929,5654
NC_035781.1,8972856,8974687,8972856,8974687,111117930,XM_022457173.1,uncharacterized LOC111117930,1831
NC_035780.1,18995649,19012673,18999519,19012673,111117931,XM_022457177.1,uncharacterized LOC111117931,13154
NC_035780.1,18995649,19012673,18995649,19012673,111117931,XM_022457183.1,uncharacterized LOC111117931,17024
NC_035781.1,8959496,8961214,8959496,8961214,111117932,XM_022457174.1,uncharacterized LOC111117932,1718
NC_035781.1,8965885,8967857,8965885,8967857,111117933,XM_022457175.1,uncharacterized LOC111117933,1972
NC_035781.1,8930886,8932881,8930886,8932881,111117934,XM_022457176.1,uncharacterized LOC111117934,1995
NC_035780.1,26986116,27000711,26986116,27000710,111117935,XM_022457215.1,uncharacterized LOC111117935,14594
NC_035780.1,26986116,27000711,26986116,27000711,111117935,XM_022457287.1,uncharacterized LOC111117935,14595
NC_035781.1,56390959,56414017,56390959,56414017,111117937,XM_022457178.1,uncharacterized LOC111117937,23058
NC_035781.1,56404391,56406486,56404391,56406486,111117938,XM_022457179.1,uncharacterized LOC111117938,2095
NC_035781.1,41323767,41326242,41323767,41326242,111117940,XM_022457180.1,uncharacterized LOC111117940,2475
NC_035781.1,44713111,44728964,44713111,44728964,111117941,XM_022457181.1,uncharacterized LOC111117941,15853
NC_035781.1,44735000,44749339,44735000,44749339,111117942,XM_022457182.1,uncharacterized LOC111117942,14339
NC_035781.1,54858770,54861715,54858770,54861715,111117943,XM_022457184.1,uncharacterized LOC111117943,2945
NC_035780.1,4312895,4317345,4312895,4317345,111117949,XM_022457194.1,uncharacterized LOC111117949,4450
NC_035781.1,49583438,49590015,49583943,49590015,111117950,XM_022457191.1,uncharacterized LOC111117950,6072
NC_035781.1,49583438,49590015,49583438,49590015,111117950,XM_022457190.1,uncharacterized LOC111117950,6577
NC_035781.1,28468624,28479727,28468624,28479727,111117961,XM_022457210.1,uncharacterized LOC111117961,11103
NC_035781.1,46684205,46691561,46684205,46691561,111117974,XM_022457229.1,uncharacterized LOC111117974,7356
NC_035781.1,46705685,46743944,46705685,46743944,111117975,XM_022457230.1,uncharacterized LOC111117975,38259
NC_035781.1,38990774,38992195,38990774,38992195,111117977,XM_022457232.1,uncharacterized LOC111117977,1421
NC_035780.1,13215655,13224135,13215655,13224109,111117980,XM_022457245.1,uncharacterized LOC111117980,8454
NC_035780.1,13215655,13224135,13215655,13224135,111117980,XM_022457236.1,uncharacterized LOC111117980,8480
NC_035781.1,49627170,49630966,49627170,49630966,111117981,XM_022457235.1,uncharacterized LOC111117981,3796
NC_035781.1,54268152,54271917,54268152,54271917,111117986,XM_022457243.1,uncharacterized LOC111117986,3765
NC_035781.1,31080414,31082897,31080422,31082897,111118030,XM_022457313.1,uncharacterized LOC111118030,2475
NC_035781.1,31080414,31082897,31080414,31082897,111118030,XM_022457312.1,uncharacterized LOC111118030,2483
NC_035781.1,45760738,45766812,45760738,45766812,111118037,XM_022457323.1,uncharacterized LOC111118037,6074
NC_035780.1,53577513,53582648,53577513,53582648,111118041,XM_022457332.1,uncharacterized LOC111118041,5135
NC_035781.1,45496633,45508735,45496633,45508735,111118043,XM_022457333.1,uncharacterized LOC111118043,12102
NC_035781.1,45785754,45798298,45785754,45798298,111118044,XM_022457334.1,uncharacterized LOC111118044,12544
NC_035781.1,39229593,39246861,39229593,39246861,111118050,XM_022457337.1,uncharacterized LOC111118050,17268
NC_035781.1,39392293,39398336,39392293,39396458,111118052,XM_022457339.1,uncharacterized LOC111118052,4165
NC_035781.1,39392293,39398336,39392293,39398336,111118052,XM_022457338.1,uncharacterized LOC111118052,6043
NC_035781.1,9217469,9220348,9217469,9220348,111118053,XM_022457340.1,uncharacterized LOC111118053,2879
NC_035780.1,53077881,53094338,53079562,53094338,111118060,XM_022457354.1,uncharacterized LOC111118060,14776
NC_035780.1,53077881,53094338,53077881,53094338,111118060,XM_022457361.1,uncharacterized LOC111118060,16457
NC_035781.1,39787385,39800108,39787385,39799338,111118062,XM_022457355.1,uncharacterized LOC111118062,11953
NC_035781.1,39787385,39800108,39787389,39800108,111118062,XM_022457353.1,uncharacterized LOC111118062,12719
NC_035781.1,39787385,39800108,39787395,39793680,111118062,XM_022457352.1,uncharacterized LOC111118062,6285
NC_035781.1,39787385,39800108,39787385,39796559,111118062,XM_022457356.1,uncharacterized LOC111118062,9174
NC_035780.1,26837961,26857819,26846977,26857819,111118074,XM_022457564.1,uncharacterized LOC111118074,10842
NC_035780.1,26837961,26857819,26844610,26857819,111118074,XM_022457410.1,uncharacterized LOC111118074,13209
NC_035780.1,26837961,26857819,26837961,26857819,111118074,XM_022457489.1,uncharacterized LOC111118074,19858
NC_035781.1,34753145,34798067,34753145,34793540,111118076,XM_022457370.1,uncharacterized LOC111118076,40395
NC_035781.1,34753145,34798067,34753145,34798067,111118076,XM_022457371.1,uncharacterized LOC111118076,44922
NC_035781.1,27983597,27985530,27983597,27985530,111118077,XM_022457372.1,uncharacterized LOC111118077,1933
NC_035781.1,15331129,15333673,15331129,15333673,111118080,XM_022457376.1,uncharacterized LOC111118080,2544
NC_035781.1,15333695,15335854,15333695,15335854,111118081,XM_022457377.1,uncharacterized LOC111118081,2159
NC_035781.1,48123949,48126033,48123949,48126033,111118084,XM_022457380.1,uncharacterized LOC111118084,2084
NC_035781.1,33436814,33454762,33436837,33454752,111118094,XM_022457399.1,uncharacterized LOC111118094,17915
NC_035781.1,33436814,33454762,33436837,33454756,111118094,XM_022457398.1,uncharacterized LOC111118094,17919
NC_035781.1,33436814,33454762,33436833,33454756,111118094,XM_022457395.1,uncharacterized LOC111118094,17923
NC_035781.1,33436814,33454762,33436831,33454758,111118094,XM_022457396.1,uncharacterized LOC111118094,17927
NC_035781.1,33436814,33454762,33436823,33454760,111118094,XM_022457394.1,uncharacterized LOC111118094,17937
NC_035781.1,33436814,33454762,33436814,33454762,111118094,XM_022457393.1,uncharacterized LOC111118094,17948
NC_035781.1,33436814,33454762,33446029,33454760,111118094,XM_022457400.1,uncharacterized LOC111118094,8731
NC_035781.1,30611656,30628408,30611656,30628408,111118095,XM_022457401.1,uncharacterized LOC111118095,16752
NC_035781.1,18407211,18416214,18407211,18416214,111118103,XM_022457414.1,uncharacterized LOC111118103,9003
NC_035781.1,33460579,33464194,33460579,33464194,111118108,XM_022457421.1,uncharacterized LOC111118108,3615
NC_035781.1,27007825,27010925,27007825,27010925,111118109,XM_022457422.1,uncharacterized LOC111118109,3100
NC_035780.1,16241022,16242955,16241022,16242955,111118113,XM_022457431.1,uncharacterized LOC111118113,1933
NC_035781.1,10002477,10005083,10002477,10005083,111118115,XM_022457428.1,uncharacterized LOC111118115,2606
NC_035781.1,16746369,16756009,16746369,16756009,111118116,XM_022457429.1,uncharacterized LOC111118116,9640
NC_035781.1,16737290,16746497,16737290,16746497,111118117,XM_022457432.1,uncharacterized LOC111118117,9207
NC_035781.1,48302506,48308985,48302506,48308458,111118120,XM_022457435.1,uncharacterized LOC111118120,5952
NC_035781.1,48302506,48308985,48302506,48308985,111118120,XM_022457434.1,uncharacterized LOC111118120,6479
NC_035781.1,14057631,14061933,14057631,14061933,111118124,XM_022457439.1,uncharacterized LOC111118124,4302
NC_035781.1,20792217,20806556,20792217,20806556,111118128,XM_022457444.1,uncharacterized LOC111118128,14339
NC_035781.1,57672465,57674591,57672465,57674591,111118146,XM_022457467.1,uncharacterized LOC111118146,2126
NC_035781.1,25533221,25537523,25533221,25537523,111118149,XM_022457469.1,uncharacterized LOC111118149,4302
NC_035781.1,51791927,51798171,51791927,51798171,111118157,XM_022457481.1,uncharacterized LOC111118157,6244
NC_035781.1,9965151,9966441,9965151,9966441,111118159,XM_022457482.1,uncharacterized LOC111118159,1290
NC_035781.1,58471304,58476289,58471304,58476289,111118169,XM_022457495.1,uncharacterized LOC111118169,4985
NC_035781.1,24813404,24821855,24813404,24821855,111118170,XM_022457496.1,uncharacterized LOC111118170,8451
NC_035781.1,24849205,24869232,24851479,24869232,111118171,XM_022457499.1,uncharacterized LOC111118171,17753
NC_035781.1,24849205,24869232,24849205,24869232,111118171,XM_022457498.1,uncharacterized LOC111118171,20027
NC_035781.1,24801578,24804141,24801578,24804141,111118177,XM_022457510.1,uncharacterized LOC111118177,2563
NC_035781.1,24785255,24787117,24785696,24787117,111118178,XM_022457511.1,uncharacterized LOC111118178,1421
NC_035781.1,24785255,24787117,24785255,24787117,111118178,XM_022457512.1,uncharacterized LOC111118178,1862
NC_035780.1,55284845,55289553,55284845,55289553,111118180,XM_022457517.1,uncharacterized LOC111118180,4708
NC_035781.1,48261530,48265629,48261530,48265629,111118181,XM_022457514.1,uncharacterized LOC111118181,4099
NC_035781.1,52971556,52977895,52971556,52977895,111118186,XM_022457520.1,uncharacterized LOC111118186,6339
NC_035781.1,52968896,52971513,52968896,52971513,111118187,XM_022457521.1,uncharacterized LOC111118187,2617
NC_035781.1,51883194,51886724,51883194,51886724,111118193,XM_022457526.1,uncharacterized LOC111118193,3530
NC_035781.1,41272960,41277118,41272960,41277118,111118202,XM_022457536.1,uncharacterized LOC111118202,4158
NC_035781.1,27522694,27524986,27522694,27524986,111118207,XM_022457544.1,uncharacterized LOC111118207,2292
NC_035781.1,51145856,51147035,51145856,51147035,111118212,XM_022457550.1,uncharacterized LOC111118212,1179
NC_035781.1,57411526,57427762,57411526,57427762,111118213,XM_022457551.1,uncharacterized LOC111118213,16236
NC_035781.1,20274682,20281843,20274682,20281843,111118215,XM_022457553.1,uncharacterized LOC111118215,7161
NC_035781.1,8404894,8414271,8404894,8414271,111118218,XM_022457558.1,uncharacterized LOC111118218,9377
NC_035781.1,8396444,8402862,8396444,8402862,111118219,XM_022457559.1,uncharacterized LOC111118219,6418
NC_035780.1,47224479,47228432,47224479,47228432,111118221,XM_022457565.1,uncharacterized LOC111118221,3953
NC_035781.1,55291219,55296547,55291219,55296547,111118226,XM_022457568.1,uncharacterized LOC111118226,5328
NC_035781.1,45101018,45103562,45101018,45103562,111118227,XM_022457569.1,uncharacterized LOC111118227,2544
NC_035781.1,9652772,9659439,9655903,9659439,111118229,XM_022457573.1,uncharacterized LOC111118229,3536
NC_035781.1,9652772,9659439,9652772,9659439,111118229,XM_022457571.1,uncharacterized LOC111118229,6667
NC_035781.1,54833810,54837132,54833810,54837132,111118243,XM_022457590.1,uncharacterized LOC111118243,3322
NC_035781.1,49065908,49068819,49065908,49068819,111118246,XM_022457599.1,uncharacterized LOC111118246,2911
NC_035781.1,21277175,21283638,21277175,21283638,111118251,XM_022457610.1,uncharacterized LOC111118251,6463
NC_035781.1,15837979,15838772,15838051,15838772,111118252,XM_022457612.1,uncharacterized LOC111118252,721
NC_035781.1,15837979,15838772,15837979,15838772,111118252,XM_022457611.1,uncharacterized LOC111118252,793
NC_035781.1,3080859,3088709,3080859,3088709,111118254,XM_022457614.1,uncharacterized LOC111118254,7850
NC_035781.1,37916531,37932941,37916531,37932941,111118256,XM_022457618.1,uncharacterized LOC111118256,16410
NC_035781.1,43426872,43429751,43426872,43429751,111118261,XM_022457631.1,uncharacterized LOC111118261,2879
NC_035781.1,1433204,1441532,1433207,1441531,111118269,XM_022457641.1,uncharacterized LOC111118269,8324
NC_035781.1,1433204,1441532,1433204,1441532,111118269,XM_022457640.1,uncharacterized LOC111118269,8328
NC_035781.1,57670213,57672165,57670213,57672165,111118275,XM_022457649.1,uncharacterized LOC111118275,1952
NC_035781.1,8581852,8586596,8581891,8586596,111118282,XM_022457662.1,uncharacterized LOC111118282,4705
NC_035781.1,8581852,8586596,8581852,8586596,111118282,XM_022457661.1,uncharacterized LOC111118282,4744
NC_035781.1,5502059,5504310,5502059,5504310,111118283,XM_022457663.1,uncharacterized LOC111118283,2251
NC_035781.1,44512722,44517462,44512722,44517462,111118287,XM_022457669.1,uncharacterized LOC111118287,4740
NC_035781.1,6525155,6529881,6525155,6529881,111118292,XM_022457677.1,uncharacterized LOC111118292,4726
NC_035781.1,24118887,24179244,24118887,24179244,111118302,XM_022457685.1,uncharacterized LOC111118302,60357
NC_035781.1,24180957,24182693,24180957,24182693,111118306,XM_022457698.1,uncharacterized LOC111118306,1736
NC_035781.1,31381529,31387217,31381529,31387217,111118310,XM_022457702.1,uncharacterized LOC111118310,5688
NC_035781.1,55063034,55068072,55063034,55068072,111118319,XM_022457725.1,uncharacterized LOC111118319,5038
NC_035781.1,47698212,47702505,47698212,47702505,111118334,XM_022457739.1,uncharacterized LOC111118334,4293
NC_035781.1,13047542,13064384,13051111,13064384,111118363,XM_022457769.1,uncharacterized LOC111118363,13273
NC_035781.1,49769129,49771234,49769129,49771233,111118365,XM_022457771.1,uncharacterized LOC111118365,2104
NC_035781.1,49769129,49771234,49769129,49771234,111118365,XM_022457770.1,uncharacterized LOC111118365,2105
NC_035780.1,49783131,49787314,49783131,49787314,111118368,XM_022457779.1,uncharacterized LOC111118368,4183
NC_035781.1,16245098,16246937,16245098,16246937,111118369,XM_022457786.1,uncharacterized LOC111118369,1839
NC_035780.1,8199563,8237332,8199563,8216263,111118371,XM_022457845.1,uncharacterized LOC111118371,16700
NC_035780.1,8199563,8237332,8199563,8216264,111118371,XM_022457837.1,uncharacterized LOC111118371,16701
NC_035780.1,8199563,8237332,8199563,8216265,111118371,XM_022457801.1,uncharacterized LOC111118371,16702
NC_035780.1,8199563,8237332,8199563,8216266,111118371,XM_022457793.1,uncharacterized LOC111118371,16703
NC_035780.1,8199563,8237332,8199563,8221411,111118371,XM_022457830.1,uncharacterized LOC111118371,21848
NC_035780.1,8199563,8237332,8199563,8227677,111118371,XM_022457821.1,uncharacterized LOC111118371,28114
NC_035780.1,8199563,8237332,8199563,8237332,111118371,XM_022457811.1,uncharacterized LOC111118371,37769
NC_035781.1,3265825,3289152,3278386,3289152,111118372,XM_022457791.1,uncharacterized LOC111118372,10766
NC_035781.1,3265825,3289152,3274962,3289152,111118372,XM_022457789.1,uncharacterized LOC111118372,14190
NC_035781.1,3265825,3289152,3265825,3289152,111118372,XM_022457790.1,uncharacterized LOC111118372,23327
NC_035781.1,3242182,3256365,3245191,3256365,111118373,XM_022457795.1,uncharacterized LOC111118373,11174
NC_035781.1,3242182,3256365,3242182,3256355,111118373,XM_022457794.1,uncharacterized LOC111118373,14173
NC_035781.1,3242182,3256365,3242182,3256365,111118373,XM_022457792.1,uncharacterized LOC111118373,14183
NC_035781.1,3259710,3274570,3259710,3274570,111118374,XM_022457797.1,uncharacterized LOC111118374,14860
NC_035781.1,3259710,3274570,3259710,3265616,111118374,XM_022457796.1,uncharacterized LOC111118374,5906
NC_035781.1,34707915,34712243,34707915,34712243,111118375,XM_022457798.1,uncharacterized LOC111118375,4328
NC_035781.1,32869134,32870470,32869134,32870470,111118378,XM_022457802.1,uncharacterized LOC111118378,1336
NC_035781.1,40683706,40685817,40683706,40685817,111118387,XM_022457834.1,uncharacterized LOC111118387,2111
NC_035781.1,48126685,48141689,48126685,48139912,111118391,XM_022457838.1,uncharacterized LOC111118391,13227
NC_035781.1,48126685,48141689,48126685,48141689,111118391,XM_022457839.1,uncharacterized LOC111118391,15004
NC_035781.1,48142766,48148874,48142766,48148874,111118392,XM_022457840.1,uncharacterized LOC111118392,6108
NC_035781.1,43871296,43875877,43871296,43875877,111118394,XM_022457842.1,uncharacterized LOC111118394,4581
NC_035781.1,24521263,24530901,24521263,24530901,111118395,XM_022457843.1,uncharacterized LOC111118395,9638
NC_035781.1,45050514,45054676,45050514,45054175,111118396,XM_022457844.1,uncharacterized LOC111118396,3661
NC_035781.1,45050514,45054676,45050514,45054676,111118396,XM_022457846.1,uncharacterized LOC111118396,4162
NC_035780.1,26927574,26929594,26927574,26929594,111118400,XM_022457892.1,uncharacterized LOC111118400,2020
NC_035781.1,30381208,30393324,30381208,30393324,111118401,XM_022457851.1,uncharacterized LOC111118401,12116
NC_035781.1,36415199,36419154,36415199,36419154,111118402,XM_022457852.1,uncharacterized LOC111118402,3955
NC_035780.1,927409,934670,927409,934670,111118408,XM_022457866.1,uncharacterized LOC111118408,7261
NC_035781.1,1652760,1655997,1652760,1655997,111118415,XM_022457886.1,uncharacterized LOC111118415,3237
NC_035781.1,43877454,43879043,43877455,43879043,111118430,XM_022457906.1,uncharacterized LOC111118430,1588
NC_035781.1,43877454,43879043,43877454,43879043,111118430,XM_022457907.1,uncharacterized LOC111118430,1589
NC_035781.1,32635765,32642921,32635765,32642921,111118436,XM_022457916.1,uncharacterized LOC111118436,7156
NC_035781.1,26621866,26626690,26622465,26626690,111118437,XM_022457918.1,uncharacterized LOC111118437,4225
NC_035781.1,26621866,26626690,26621866,26626690,111118437,XM_022457917.1,uncharacterized LOC111118437,4824
NC_035781.1,26735744,26746682,26736058,26746682,111118439,XM_022457925.1,uncharacterized LOC111118439,10624
NC_035781.1,26735744,26746682,26735749,26746682,111118439,XM_022457923.1,uncharacterized LOC111118439,10933
NC_035781.1,26735744,26746682,26735745,26746682,111118439,XM_022457921.1,uncharacterized LOC111118439,10937
NC_035781.1,26735744,26746682,26735744,26746682,111118439,XM_022457920.1,uncharacterized LOC111118439,10938
NC_035781.1,26735744,26746682,26737696,26746682,111118439,XM_022457924.1,uncharacterized LOC111118439,8986
NC_035781.1,26772869,26786137,26772869,26786137,111118441,XM_022457927.1,uncharacterized LOC111118441,13268
NC_035781.1,26772869,26786137,26772869,26777263,111118441,XM_022457926.1,uncharacterized LOC111118441,4394
NC_035781.1,26772869,26786137,26772869,26777266,111118441,XM_022457929.1,uncharacterized LOC111118441,4397
NC_035781.1,26772869,26786137,26772869,26779231,111118441,XM_022457930.1,uncharacterized LOC111118441,6362
NC_035781.1,9958206,9964464,9958206,9964464,111118443,XM_022457932.1,uncharacterized LOC111118443,6258
NC_035781.1,56186516,56196364,56186516,56189354,111118449,XM_022457937.1,uncharacterized LOC111118449,2838
NC_035781.1,56186516,56196364,56186516,56190137,111118449,XM_022457942.1,uncharacterized LOC111118449,3621
NC_035781.1,56186516,56196364,56186516,56191584,111118449,XM_022457939.1,uncharacterized LOC111118449,5068
NC_035781.1,56186516,56196364,56186516,56196364,111118449,XM_022457938.1,uncharacterized LOC111118449,9848
NC_035781.1,48067080,48069076,48067080,48069076,111118450,XM_022457943.1,uncharacterized LOC111118450,1996
NC_035781.1,46973462,46978292,46973462,46978292,111118457,XM_022457949.1,uncharacterized LOC111118457,4830
NC_035781.1,20284640,20286600,20284640,20286369,111118462,XM_022457955.1,uncharacterized LOC111118462,1729
NC_035781.1,19276968,19290904,19276969,19290904,111118463,XM_022457957.1,uncharacterized LOC111118463,13935
NC_035781.1,19276968,19290904,19276968,19290904,111118463,XM_022457956.1,uncharacterized LOC111118463,13936
NC_035781.1,19249117,19263572,19249117,19263572,111118464,XM_022457963.1,uncharacterized LOC111118464,14455
NC_035781.1,19266906,19272811,19267487,19272811,111118465,XM_022457965.1,uncharacterized LOC111118465,5324
NC_035781.1,19266906,19272811,19266906,19272811,111118465,XM_022457964.1,uncharacterized LOC111118465,5905
NC_035780.1,26967374,26968640,26967374,26968640,111118469,XM_022458010.1,uncharacterized LOC111118469,1266
NC_035781.1,14086614,14089793,14087121,14089793,111118470,XM_022457971.1,uncharacterized LOC111118470,2672
NC_035781.1,14086614,14089793,14086640,14089793,111118470,XM_022457970.1,uncharacterized LOC111118470,3153
NC_035781.1,14086614,14089793,14086614,14089793,111118470,XM_022457972.1,uncharacterized LOC111118470,3179
NC_035781.1,5838242,5870635,5838242,5870635,111118472,XM_022457974.1,uncharacterized LOC111118472,32393
NC_035781.1,3032415,3045587,3032415,3045587,111118480,XM_022457983.1,uncharacterized LOC111118480,13172
NC_035781.1,3032415,3045587,3041303,3045587,111118480,XM_022457982.1,uncharacterized LOC111118480,4284
NC_035780.1,64560615,64565008,64560615,64565008,111118487,XM_022457992.1,uncharacterized LOC111118487,4393
NC_035781.1,416973,419851,416973,419851,111118495,XM_022458000.1,uncharacterized LOC111118495,2878
NC_035781.1,33025513,33043758,33025513,33043758,111118499,XM_022458013.1,uncharacterized LOC111118499,18245
NC_035781.1,55071249,55076307,55071249,55076307,111118509,XM_022458025.1,uncharacterized LOC111118509,5058
NC_035781.1,21221007,21223716,21221007,21223716,111118512,XM_022458028.1,uncharacterized LOC111118512,2709
NC_035781.1,19862335,19866454,19862335,19866454,111118513,XM_022458030.1,uncharacterized LOC111118513,4119
NC_035781.1,40556810,40561144,40556810,40561144,111118515,XM_022458032.1,uncharacterized LOC111118515,4334
NC_035781.1,46601732,46605616,46602493,46605616,111118516,XM_022458033.1,uncharacterized LOC111118516,3123
NC_035781.1,46601732,46605616,46601732,46605616,111118516,XM_022458034.1,uncharacterized LOC111118516,3884
NC_035781.1,58787719,58792815,58787719,58792815,111118517,XM_022458035.1,uncharacterized LOC111118517,5096
NC_035781.1,26049188,26054476,26049188,26054476,111118521,XM_022458039.1,uncharacterized LOC111118521,5288
NC_035781.1,55974133,55979339,55974133,55979339,111118538,XM_022458052.1,uncharacterized LOC111118538,5206
NC_035781.1,15873119,15877086,15873119,15877086,111118545,XM_022458063.1,uncharacterized LOC111118545,3967
NC_035781.1,47550480,47555804,47550480,47555804,111118548,XM_022458067.1,uncharacterized LOC111118548,5324
NC_035781.1,23374049,23376373,23374049,23376373,111118551,XM_022458071.1,uncharacterized LOC111118551,2324
NC_035780.1,60847009,60855737,60847009,60855737,111118554,XM_022458077.1,uncharacterized LOC111118554,8728
NC_035781.1,58880501,58896436,58880501,58896436,111118555,XM_022458075.1,uncharacterized LOC111118555,15935
NC_035781.1,58846832,58855555,58846832,58855555,111118556,XM_022458076.1,uncharacterized LOC111118556,8723
NC_035781.1,44071271,44088534,44071271,44088534,111118557,XM_022458078.1,uncharacterized LOC111118557,17263
NC_035780.1,26885712,26886893,26885712,26886893,111118559,XM_022458120.1,uncharacterized LOC111118559,1181
NC_035780.1,16909121,16912511,16909121,16912511,111118560,XM_022458092.1,uncharacterized LOC111118560,3390
NC_035780.1,21566800,21596351,21566801,21596351,111118564,XM_022458104.1,uncharacterized LOC111118564,29550
NC_035780.1,21566800,21596351,21566800,21596351,111118564,XM_022458107.1,uncharacterized LOC111118564,29551
NC_035781.1,47781862,47784552,47782210,47784552,111118573,XM_022458108.1,uncharacterized LOC111118573,2342
NC_035781.1,47781862,47784552,47781862,47784552,111118573,XM_022458106.1,uncharacterized LOC111118573,2690
NC_035781.1,58748167,58751078,58748695,58751078,111118575,XM_022458111.1,uncharacterized LOC111118575,2383
NC_035781.1,58748167,58751078,58748167,58751078,111118575,XM_022458110.1,uncharacterized LOC111118575,2911
NC_035780.1,12896160,12897207,12896160,12897207,111118578,XM_022458121.1,uncharacterized LOC111118578,1047
NC_035781.1,37291464,37308892,37291464,37308892,111118583,XM_022458126.1,uncharacterized LOC111118583,17428
NC_035781.1,37189402,37215713,37189402,37215713,111118585,XM_022458130.1,uncharacterized LOC111118585,26311
NC_035781.1,37108853,37109993,37108853,37109993,111118594,XM_022458138.1,uncharacterized LOC111118594,1140
NC_035781.1,34548910,34550814,34548910,34550814,111118598,XM_022458142.1,uncharacterized LOC111118598,1904
NC_035780.1,13908842,13926947,13908842,13926947,111118599,XM_022458147.1,uncharacterized LOC111118599,18105
NC_035781.1,16353633,16358973,16353633,16358537,111118601,XM_022458150.1,uncharacterized LOC111118601,4904
NC_035781.1,16353633,16358973,16353633,16358973,111118601,XM_022458151.1,uncharacterized LOC111118601,5340
NC_035781.1,39407568,39413347,39407568,39413347,111118603,XM_022458154.1,uncharacterized LOC111118603,5779
NC_035780.1,19091472,19097615,19091472,19097615,111118605,XM_022458159.1,uncharacterized LOC111118605,6143
NC_035781.1,49891305,49899412,49891305,49899411,111118608,XM_022458158.1,uncharacterized LOC111118608,8106
NC_035781.1,4010900,4049664,4010900,4049664,111118619,XM_022458172.1,uncharacterized LOC111118619,38764
NC_035781.1,28388386,28406747,28388386,28406747,111118620,XM_022458175.1,uncharacterized LOC111118620,18361
NC_035781.1,50168839,50171173,50168839,50170800,111118622,XM_022458177.1,uncharacterized LOC111118622,1961
NC_035781.1,50168839,50171173,50168839,50171097,111118622,XM_022458179.1,uncharacterized LOC111118622,2258
NC_035781.1,50168839,50171173,50168839,50171173,111118622,XM_022458176.1,uncharacterized LOC111118622,2334
NC_035781.1,16673389,16689495,16673389,16680854,111118623,XM_022458180.1,uncharacterized LOC111118623,7465
NC_035781.1,17106647,17108342,17106647,17108342,111118624,XM_022458181.1,uncharacterized LOC111118624,1695
NC_035781.1,40673558,40674958,40673583,40674958,111118625,XM_022458183.1,uncharacterized LOC111118625,1375
NC_035781.1,40673558,40674958,40673558,40674958,111118625,XM_022458182.1,uncharacterized LOC111118625,1400
NC_035781.1,18036805,18040911,18036805,18040911,111118629,XM_022458188.1,uncharacterized LOC111118629,4106
NC_035781.1,58802330,58808362,58802330,58808362,111118632,XM_022458192.1,uncharacterized LOC111118632,6032
NC_035781.1,17222113,17223820,17222113,17223820,111118637,XM_022458196.1,uncharacterized LOC111118637,1707
NC_035780.1,26882931,26884829,26882931,26884829,111118638,XM_022458233.1,uncharacterized LOC111118638,1898
NC_035781.1,49752526,49768511,49752526,49768511,111118642,XM_022458199.1,uncharacterized LOC111118642,15985
NC_035781.1,49745787,49751428,49747719,49751428,111118644,XM_022458201.1,uncharacterized LOC111118644,3709
NC_035781.1,49745787,49751428,49745787,49751428,111118644,XM_022458200.1,uncharacterized LOC111118644,5641
NC_035781.1,4363140,4375051,4363140,4375051,111118655,XM_022458219.1,uncharacterized LOC111118655,11911
NC_035781.1,55989581,55995492,55989581,55995492,111118656,XM_022458220.1,uncharacterized LOC111118656,5911
NC_035781.1,56093659,56116178,56093659,56108072,111118657,XM_022458224.1,uncharacterized LOC111118657,14413
NC_035781.1,56093659,56116178,56093659,56110245,111118657,XM_022458225.1,uncharacterized LOC111118657,16586
NC_035781.1,56093659,56116178,56093659,56116178,111118657,XM_022458222.1,uncharacterized LOC111118657,22519
NC_035781.1,56093659,56116178,56093659,56100382,111118657,XM_022458221.1,uncharacterized LOC111118657,6723
NC_035781.1,920734,923885,920734,923885,111118661,XM_022458227.1,uncharacterized LOC111118661,3151
NC_035781.1,59924204,59934141,59924204,59934141,111118664,XM_022458230.1,uncharacterized LOC111118664,9937
NC_035781.1,25374536,25375875,25374536,25375875,111118668,XM_022458236.1,uncharacterized LOC111118668,1339
NC_035781.1,39813643,39822321,39813643,39822321,111118673,XM_022458244.1,uncharacterized LOC111118673,8678
NC_035780.1,52700758,52745416,52700758,52745416,111118675,XM_022458249.1,uncharacterized LOC111118675,44658
NC_035781.1,58243304,58262375,58243304,58262375,111118680,XM_022458250.1,uncharacterized LOC111118680,19071
NC_035781.1,9676379,9683312,9676379,9683312,111118688,XM_022458265.1,uncharacterized LOC111118688,6933
NC_035781.1,33171572,33175181,33171572,33175181,111118689,XM_022458266.1,uncharacterized LOC111118689,3609
NC_035781.1,55920207,55923341,55920221,55923340,111118695,XM_022458273.1,uncharacterized LOC111118695,3119
NC_035781.1,55920207,55923341,55920207,55923341,111118695,XM_022458274.1,uncharacterized LOC111118695,3134
NC_035780.1,56087509,56090005,56087509,56090005,111118700,XM_022458283.1,uncharacterized LOC111118700,2496
NC_035781.1,58069735,58095856,58075988,58095856,111118706,XM_022458291.1,uncharacterized LOC111118706,19868
NC_035781.1,58069735,58095856,58069735,58095856,111118706,XM_022458290.1,uncharacterized LOC111118706,26121
NC_035781.1,33179264,33182426,33179264,33182414,111118711,XM_022458297.1,uncharacterized LOC111118711,3150
NC_035781.1,33179264,33182426,33179264,33182426,111118711,XM_022458295.1,uncharacterized LOC111118711,3162
NC_035780.1,6882152,6890382,6883779,6890382,111118716,XM_022458315.1,uncharacterized LOC111118716,6603
NC_035780.1,6882152,6890382,6882152,6890242,111118716,XM_022458305.1,uncharacterized LOC111118716,8090
NC_035781.1,32832487,32834961,32833306,32834961,111118719,XM_022458304.1,uncharacterized LOC111118719,1655
NC_035781.1,14092539,14099975,14092539,14099975,111118730,XM_022458327.1,uncharacterized LOC111118730,7436
NC_035781.1,10959742,10963871,10959742,10963871,111118734,XM_022458335.1,uncharacterized LOC111118734,4129
NC_035781.1,47180325,47187184,47182358,47187156,111118737,XM_022458337.1,uncharacterized LOC111118737,4798
NC_035781.1,47180325,47187184,47182358,47187184,111118737,XM_022458339.1,uncharacterized LOC111118737,4826
NC_035781.1,47180325,47187184,47181637,47187156,111118737,XM_022458338.1,uncharacterized LOC111118737,5519
NC_035781.1,47180325,47187184,47181637,47187184,111118737,XM_022458341.1,uncharacterized LOC111118737,5547
NC_035781.1,47180325,47187184,47180325,47187181,111118737,XM_022458342.1,uncharacterized LOC111118737,6856
NC_035781.1,47180325,47187184,47180325,47187182,111118737,XM_022458343.1,uncharacterized LOC111118737,6857
NC_035781.1,47180325,47187184,47180325,47187184,111118737,XM_022458340.1,uncharacterized LOC111118737,6859
NC_035781.1,16153024,16157499,16153024,16157499,111118740,XM_022458348.1,uncharacterized LOC111118740,4475
NC_035781.1,56696389,56705774,56696389,56705774,111118743,XM_022458352.1,uncharacterized LOC111118743,9385
NC_035781.1,33152361,33155296,33152361,33155296,111118744,XM_022458353.1,uncharacterized LOC111118744,2935
NC_035781.1,29596025,29601524,29596025,29601524,111118746,XM_022458356.1,uncharacterized LOC111118746,5499
NC_035781.1,451837,453785,451837,453785,111118749,XM_022458359.1,uncharacterized LOC111118749,1948
NC_035781.1,453615,471395,453615,471395,111118750,XM_022458360.1,uncharacterized LOC111118750,17780
NC_035781.1,19080077,19084861,19080077,19084861,111118751,XM_022458361.1,uncharacterized LOC111118751,4784
NC_035781.1,45077506,45083283,45077506,45083283,111118752,XM_022458363.1,uncharacterized LOC111118752,5777
NC_035780.1,44577637,44582143,44577637,44582143,111118757,XM_022458373.1,uncharacterized LOC111118757,4506
NC_035780.1,31522184,31526122,31522184,31526122,111118768,XM_022458384.1,uncharacterized LOC111118768,3938
NC_035781.1,11376335,11379382,11376335,11379382,111118774,XM_022458387.1,uncharacterized LOC111118774,3047
NC_035781.1,11953838,11955010,11953838,11955010,111118775,XM_022458388.1,uncharacterized LOC111118775,1172
NC_035781.1,37538,37995,37538,37995,111118777,XM_022458390.1,uncharacterized LOC111118777,457
NC_035781.1,5729126,5738375,5729126,5738375,111118778,XM_022458391.1,uncharacterized LOC111118778,9249
NC_035780.1,43952647,43955662,43952647,43955662,111118779,XM_022458397.1,uncharacterized LOC111118779,3015
NC_035781.1,61057339,61062266,61057339,61062266,111118781,XM_022458398.1,uncharacterized LOC111118781,4927
NC_035781.1,96883,99999,96883,99999,111118784,XM_022458404.1,uncharacterized LOC111118784,3116
NC_035780.1,24755576,24757543,24755576,24757543,111118786,XM_022458409.1,uncharacterized LOC111118786,1967
NC_035781.1,140274,146790,140274,146790,111118788,XM_022458407.1,uncharacterized LOC111118788,6516
NC_035781.1,146940,161455,146940,161455,111118789,XM_022458408.1,uncharacterized LOC111118789,14515
NC_035781.1,23987954,24036006,23987954,24036006,111118790,XM_022458411.1,uncharacterized LOC111118790,48052
NC_035780.1,24754498,24755533,24754498,24755533,111118792,XM_022458423.1,uncharacterized LOC111118792,1035
NC_035781.1,2949665,2956579,2949665,2956579,111118798,XM_022458428.1,uncharacterized LOC111118798,6914
NC_035781.1,3876045,3891772,3876045,3891769,111118802,XM_022458431.1,uncharacterized LOC111118802,15724
NC_035781.1,3876045,3891772,3876045,3891770,111118802,XM_022458434.1,uncharacterized LOC111118802,15725
NC_035781.1,3876045,3891772,3876045,3891772,111118802,XM_022458432.1,uncharacterized LOC111118802,15727
NC_035781.1,3876045,3891772,3876045,3880589,111118802,XM_022458433.1,uncharacterized LOC111118802,4544
NC_035780.1,26888839,26889940,26888839,26889940,111118803,XM_022458473.1,uncharacterized LOC111118803,1101
NC_035781.1,816738,820776,816738,820776,111118804,XM_022458436.1,uncharacterized LOC111118804,4038
NC_035781.1,952290,955018,952290,955018,111118805,XM_022458437.1,uncharacterized LOC111118805,2728
NC_035781.1,53527569,53543845,53527569,53543176,111118810,XM_022458442.1,uncharacterized LOC111118810,15607
NC_035781.1,53527569,53543845,53527572,53543613,111118810,XM_022458444.1,uncharacterized LOC111118810,16041
NC_035781.1,53527569,53543845,53527578,53543845,111118810,XM_022458443.1,uncharacterized LOC111118810,16267
NC_035781.1,1834690,1835850,1834690,1835850,111118822,XM_022458459.1,uncharacterized LOC111118822,1160
NC_035780.1,61535965,61538239,61535965,61538239,111118824,XM_022458465.1,uncharacterized LOC111118824,2274
NC_035780.1,43157614,43162343,43157614,43162343,111118829,XM_022458478.1,uncharacterized LOC111118829,4729
NC_035781.1,47166401,47179559,47166651,47179559,111118831,XM_022458476.1,uncharacterized LOC111118831,12908
NC_035781.1,47166401,47179559,47166401,47179559,111118831,XM_022458477.1,uncharacterized LOC111118831,13158
NC_035781.1,2556427,2566059,2556427,2566059,111118836,XM_022458485.1,uncharacterized LOC111118836,9632
NC_035781.1,32747205,32752140,32747205,32752140,111118837,XM_022458486.1,uncharacterized LOC111118837,4935
NC_035780.1,957967,963094,957969,963092,111118838,XM_022458490.1,uncharacterized LOC111118838,5123
NC_035780.1,957967,963094,957967,963094,111118838,XM_022458500.1,uncharacterized LOC111118838,5127
NC_035781.1,9620360,9624723,9620360,9624723,111118839,XM_022458487.1,uncharacterized LOC111118839,4363
NC_035781.1,59948831,59960895,59948831,59960895,111118847,XM_022458530.1,uncharacterized LOC111118847,12064
NC_035780.1,47850331,47852728,47850331,47852728,111118853,XM_022458540.1,uncharacterized LOC111118853,2397
NC_035781.1,3153749,3156747,3153749,3156747,111118860,XM_022458544.1,uncharacterized LOC111118860,2998
NC_035781.1,58331149,58333128,58331149,58333128,111118861,XM_022458545.1,uncharacterized LOC111118861,1979
NC_035781.1,27669167,27704362,27669167,27704362,111118862,XM_022458546.1,uncharacterized LOC111118862,35195
NC_035781.1,27743439,27744982,27743439,27744982,111118863,XM_022458547.1,uncharacterized LOC111118863,1543
NC_035781.1,12511553,12515270,12511553,12515270,111118876,XM_022458564.1,uncharacterized LOC111118876,3717
NC_035781.1,12568849,12571745,12568849,12571745,111118878,XM_022458566.1,uncharacterized LOC111118878,2896
NC_035781.1,12566098,12568310,12566271,12568310,111118879,XM_022458569.1,uncharacterized LOC111118879,2039
NC_035781.1,12566098,12568310,12566098,12568310,111118879,XM_022458568.1,uncharacterized LOC111118879,2212
NC_035781.1,12626523,12629639,12626523,12629639,111118884,XM_022458578.1,uncharacterized LOC111118884,3116
NC_035781.1,12631809,12634362,12631809,12634362,111118886,XM_022458580.1,uncharacterized LOC111118886,2553
NC_035781.1,3911910,3937182,3911910,3937182,111118891,XM_022458582.1,uncharacterized LOC111118891,25272
NC_035781.1,50273883,50275683,50273883,50275683,111118895,XM_022458588.1,uncharacterized LOC111118895,1800
NC_035781.1,50267176,50271479,50267176,50271479,111118896,XM_022458589.1,uncharacterized LOC111118896,4303
NC_035781.1,28423849,28426906,28423849,28426906,111118899,XM_022458597.1,uncharacterized LOC111118899,3057
NC_035781.1,27402497,27405505,27402497,27405469,111118900,XM_022458600.1,uncharacterized LOC111118900,2972
NC_035781.1,27402497,27405505,27402497,27405505,111118900,XM_022458598.1,uncharacterized LOC111118900,3008
NC_035781.1,4286926,4288566,4286926,4288566,111118901,XM_022458601.1,uncharacterized LOC111118901,1640
NC_035781.1,4327805,4329789,4327805,4329789,111118902,XM_022458602.1,uncharacterized LOC111118902,1984
NC_035781.1,5018960,5038201,5018960,5038201,111118904,XM_022458605.1,uncharacterized LOC111118904,19241
NC_035781.1,5486136,5486813,5486136,5486813,111118919,XM_022458634.1,uncharacterized LOC111118919,677
NC_035781.1,29400524,29408487,29400524,29408487,111118921,XM_022458637.1,uncharacterized LOC111118921,7963
NC_035780.1,55754815,55759792,55754815,55759792,111118922,XM_022458642.1,uncharacterized LOC111118922,4977
NC_035781.1,9256190,9275036,9256190,9275036,111118926,XM_022458645.1,uncharacterized LOC111118926,18846
NC_035781.1,9300562,9312560,9300562,9312560,111118927,XM_022458646.1,uncharacterized LOC111118927,11998
NC_035781.1,9278906,9295403,9278906,9295403,111118928,XM_022458647.1,uncharacterized LOC111118928,16497
NC_035781.1,31520382,31560168,31520382,31560168,111118929,XM_022458648.1,uncharacterized LOC111118929,39786
NC_035781.1,5749759,5750211,5749759,5750211,111118930,XM_022458649.1,uncharacterized LOC111118930,452
NC_035780.1,51666041,51670501,51666041,51670501,111118931,XM_022458653.1,uncharacterized LOC111118931,4460
NC_035781.1,5886123,5961792,5886123,5961792,111118933,XM_022458651.1,uncharacterized LOC111118933,75669
NC_035781.1,31716172,31718976,31716172,31718976,111118937,XM_022458658.1,uncharacterized LOC111118937,2804
NC_035781.1,31708150,31715445,31708181,31715143,111118938,XM_022458663.1,uncharacterized LOC111118938,6962
NC_035781.1,31708150,31715445,31708181,31715160,111118938,XM_022458662.1,uncharacterized LOC111118938,6979
NC_035781.1,31708150,31715445,31708180,31715160,111118938,XM_022458661.1,uncharacterized LOC111118938,6980
NC_035781.1,31708150,31715445,31708179,31715160,111118938,XM_022458659.1,uncharacterized LOC111118938,6981
NC_035781.1,31708150,31715445,31708150,31715146,111118938,XM_022458660.1,uncharacterized LOC111118938,6996
NC_035780.1,26382214,26395536,26382214,26395536,111118939,XM_022458665.1,uncharacterized LOC111118939,13322
NC_035780.1,26382214,26395536,26387050,26395536,111118939,XM_022458674.1,uncharacterized LOC111118939,8486
NC_035780.1,26382214,26395536,26387036,26395536,111118939,XM_022458689.1,uncharacterized LOC111118939,8500
NC_035780.1,26382214,26395536,26386843,26395536,111118939,XM_022458681.1,uncharacterized LOC111118939,8693
NC_035781.1,6221700,6233096,6221700,6233096,111118943,XM_022458667.1,uncharacterized LOC111118943,11396
NC_035781.1,9069030,9093422,9069030,9090091,111118944,XM_022458673.1,uncharacterized LOC111118944,21061
NC_035781.1,9069030,9093422,9069030,9090555,111118944,XM_022458675.1,uncharacterized LOC111118944,21525
NC_035781.1,9069030,9093422,9069030,9092921,111118944,XM_022458671.1,uncharacterized LOC111118944,23891
NC_035781.1,9069030,9093422,9069030,9092951,111118944,XM_022458668.1,uncharacterized LOC111118944,23921
NC_035781.1,9069030,9093422,9069030,9092956,111118944,XM_022458669.1,uncharacterized LOC111118944,23926
NC_035781.1,9069030,9093422,9069030,9093422,111118944,XM_022458670.1,uncharacterized LOC111118944,24392
NC_035781.1,6641643,6665969,6641643,6665969,111118948,XM_022458679.1,uncharacterized LOC111118948,24326
NC_035781.1,6699959,6702726,6699959,6702726,111118949,XM_022458680.1,uncharacterized LOC111118949,2767
NC_035781.1,9744953,9753200,9744953,9747793,111118952,XM_022458684.1,uncharacterized LOC111118952,2840
NC_035781.1,9744953,9753200,9744953,9753200,111118952,XM_022458683.1,uncharacterized LOC111118952,8247
NC_035781.1,7475098,7477785,7475098,7477785,111118967,XM_022458700.1,uncharacterized LOC111118967,2687
NC_035780.1,26369417,26370490,26369417,26370490,111118972,XM_022458708.1,uncharacterized LOC111118972,1073
NC_035781.1,47694103,47695894,47694103,47695894,111118980,XM_022458713.1,uncharacterized LOC111118980,1791
NC_035780.1,24803109,24806091,24803109,24806091,111118982,XM_022458719.1,uncharacterized LOC111118982,2982
NC_035781.1,9724798,9732425,9724798,9732425,111118989,XM_022458725.1,uncharacterized LOC111118989,7627
NC_035780.1,52373575,52376921,52373575,52376921,111118993,XM_022458742.1,uncharacterized LOC111118993,3346
NC_035780.1,32932202,32934434,32932202,32934434,111118997,XM_022458754.1,uncharacterized LOC111118997,2232
NC_035781.1,11438794,11460864,11438794,11460864,111118998,XM_022458750.1,uncharacterized LOC111118998,22070
NC_035781.1,11504346,11518312,11504346,11518312,111118999,XM_022458751.1,uncharacterized LOC111118999,13966
NC_035781.1,11859829,11861105,11859829,11861105,111119002,XM_022458757.1,uncharacterized LOC111119002,1276
NC_035781.1,11867169,11868026,11867169,11868026,111119003,XM_022458758.1,uncharacterized LOC111119003,857
NC_035781.1,12010697,12012011,12010697,12012011,111119004,XM_022458759.1,uncharacterized LOC111119004,1314
NC_035781.1,12499006,12505691,12499006,12505691,111119006,XM_022458761.1,uncharacterized LOC111119006,6685
NC_035781.1,12524092,12528057,12524092,12528057,111119010,XM_022458785.1,uncharacterized LOC111119010,3965
NC_035781.1,23547365,23984687,23547365,23984687,111119012,XM_022458787.1,uncharacterized LOC111119012,437322
NC_035781.1,23579208,23628408,23579208,23628408,111119021,XM_022458812.1,uncharacterized LOC111119021,49200
NC_035781.1,23568601,23570823,23568601,23570823,111119025,XM_022458821.1,uncharacterized LOC111119025,2222
NC_035780.1,53211645,53215273,53211645,53215273,111119028,XM_022458827.1,uncharacterized LOC111119028,3628
NC_035781.1,23566401,23568442,23566401,23568442,111119029,XM_022458825.1,uncharacterized LOC111119029,2041
NC_035780.1,34219932,34223814,34219932,34223814,111119037,XM_022458849.1,uncharacterized LOC111119037,3882
NC_035781.1,23787430,23789541,23787430,23789541,111119042,XM_022458853.1,uncharacterized LOC111119042,2111
NC_035781.1,23959288,23960024,23959288,23960024,111119046,XM_022458857.1,uncharacterized LOC111119046,736
NC_035780.1,34235914,34236829,34235914,34236829,111119047,XM_022458860.1,uncharacterized LOC111119047,915
NC_035781.1,12539055,12539648,12539055,12539648,111119049,XM_022458858.1,uncharacterized LOC111119049,593
NC_035781.1,14144553,14146070,14144553,14146070,111119073,XM_022458887.1,uncharacterized LOC111119073,1517
NC_035781.1,14721070,14722301,14721070,14722301,111119075,XM_022458889.1,uncharacterized LOC111119075,1231
NC_035781.1,14762679,14763278,14762679,14763278,111119076,XM_022458891.1,uncharacterized LOC111119076,599
NC_035781.1,14779904,14787487,14779904,14787487,111119080,XM_022458898.1,uncharacterized LOC111119080,7583
NC_035780.1,8122845,8129093,8122845,8129093,111119081,XM_022458902.1,uncharacterized LOC111119081,6248
NC_035781.1,15530673,15549755,15530673,15549755,111119087,XM_022458908.1,uncharacterized LOC111119087,19082
NC_035780.1,27204855,27206424,27204855,27206424,111119089,XM_022458913.1,uncharacterized LOC111119089,1569
NC_035781.1,52493396,52508999,52493396,52508999,111119099,XM_022458928.1,uncharacterized LOC111119099,15603
NC_035781.1,52579448,52597992,52579448,52597992,111119100,XM_022458932.1,uncharacterized LOC111119100,18544
NC_035780.1,53849585,53862891,53849585,53854651,111119103,XM_022458959.1,uncharacterized LOC111119103,5066
NC_035780.1,53849585,53862891,53855802,53862891,111119103,XM_022458950.1,uncharacterized LOC111119103,7089
NC_035781.1,52397005,52406389,52397006,52405889,111119104,XM_022458951.1,uncharacterized LOC111119104,8883
NC_035781.1,52397005,52406389,52397006,52406389,111119104,XM_022458949.1,uncharacterized LOC111119104,9383
NC_035781.1,52397005,52406389,52397005,52406389,111119104,XM_022458952.1,uncharacterized LOC111119104,9384
NC_035781.1,52361236,52367713,52361236,52367713,111119112,XM_022458967.1,uncharacterized LOC111119112,6477
NC_035780.1,30028444,30038668,30028444,30038668,111119119,XM_022458979.1,uncharacterized LOC111119119,10224
NC_035781.1,52637903,52639167,52637903,52639167,111119121,XM_022458977.1,uncharacterized LOC111119121,1264
NC_035781.1,52554835,52556490,52554835,52556490,111119122,XM_022458978.1,uncharacterized LOC111119122,1655
NC_035781.1,52752934,52758959,52752934,52758959,111119124,XM_022458981.1,uncharacterized LOC111119124,6025
NC_035781.1,52599229,52637485,52599229,52637485,111119126,XM_022458983.1,uncharacterized LOC111119126,38256
NC_035781.1,57709677,57730965,57709677,57730965,111119132,XM_022458988.1,uncharacterized LOC111119132,21288
NC_035781.1,16634303,16668448,16634303,16668448,111119134,XM_022458989.1,uncharacterized LOC111119134,34145
NC_035781.1,17410430,17425521,17410430,17425521,111119136,XM_022458992.1,uncharacterized LOC111119136,15091
NC_035781.1,17435761,17452520,17435761,17452520,111119137,XM_022458993.1,uncharacterized LOC111119137,16759
NC_035781.1,57943206,57960947,57943206,57960947,111119143,XM_022458998.1,uncharacterized LOC111119143,17741
NC_035781.1,57943206,57960947,57943206,57946989,111119143,XM_022459000.1,uncharacterized LOC111119143,3783
NC_035781.1,57961853,57967674,57961864,57967674,111119144,XM_022459001.1,uncharacterized LOC111119144,5810
NC_035781.1,57961853,57967674,57961853,57967674,111119144,XM_022459003.1,uncharacterized LOC111119144,5821
NC_035781.1,2474342,2495518,2474342,2495518,111119145,XM_022459004.1,uncharacterized LOC111119145,21176
NC_035781.1,2822192,2839157,2822192,2839157,111119156,XM_022459031.1,uncharacterized LOC111119156,16965
NC_035781.1,2969811,2984191,2969811,2984191,111119157,XM_022459032.1,uncharacterized LOC111119157,14380
NC_035781.1,15440232,15441808,15440232,15441808,111119164,XM_022459044.1,uncharacterized LOC111119164,1576
NC_035781.1,29151204,29172604,29151204,29172604,111119177,XM_022459056.1,uncharacterized LOC111119177,21400
NC_035781.1,40487457,40490895,40487457,40490895,111119180,XM_022459059.1,uncharacterized LOC111119180,3438
NC_035780.1,49709015,49726163,49715864,49726163,111119181,XM_022459084.1,uncharacterized LOC111119181,10299
NC_035780.1,49709015,49726163,49710166,49726163,111119181,XM_022459074.1,uncharacterized LOC111119181,15997
NC_035780.1,49709015,49726163,49709015,49726163,111119181,XM_022459064.1,uncharacterized LOC111119181,17148
NC_035781.1,39330759,39345632,39330759,39345632,111119183,XM_022459065.1,uncharacterized LOC111119183,14873
NC_035781.1,39292142,39327831,39293154,39327826,111119184,XM_022459073.1,uncharacterized LOC111119184,34672
NC_035781.1,39292142,39327831,39292145,39327826,111119184,XM_022459067.1,uncharacterized LOC111119184,35681
NC_035781.1,39292142,39327831,39292143,39327826,111119184,XM_022459068.1,uncharacterized LOC111119184,35683
NC_035781.1,39292142,39327831,39292142,39327826,111119184,XM_022459077.1,uncharacterized LOC111119184,35684
NC_035781.1,39292142,39327831,39292143,39327831,111119184,XM_022459066.1,uncharacterized LOC111119184,35688
NC_035781.1,1132797,1138684,1132797,1138684,111119189,XM_022459090.1,uncharacterized LOC111119189,5887
NC_035781.1,9175801,9183240,9175801,9183240,111119200,XM_022459125.1,uncharacterized LOC111119200,7439
NC_035781.1,38478848,38542061,38515890,38542061,111119209,XM_022459153.1,uncharacterized LOC111119209,26171
NC_035781.1,38478848,38542061,38513533,38542061,111119209,XM_022459152.1,uncharacterized LOC111119209,28528
NC_035781.1,38478848,38542061,38512903,38542061,111119209,XM_022459151.1,uncharacterized LOC111119209,29158
NC_035781.1,38478848,38542061,38483776,38542061,111119209,XM_022459147.1,uncharacterized LOC111119209,58285
NC_035781.1,38478848,38542061,38478872,38542061,111119209,XM_022459149.1,uncharacterized LOC111119209,63189
NC_035781.1,38478848,38542061,38478850,38542061,111119209,XM_022459155.1,uncharacterized LOC111119209,63211
NC_035781.1,38478848,38542061,38478849,38542061,111119209,XM_022459154.1,uncharacterized LOC111119209,63212
NC_035781.1,38478848,38542061,38478848,38542061,111119209,XM_022459148.1,uncharacterized LOC111119209,63213
NC_035781.1,4809549,4819938,4809549,4819938,111119217,XM_022459171.1,uncharacterized LOC111119217,10389
NC_035781.1,39530243,39544036,39530243,39544036,111119225,XM_022459182.1,uncharacterized LOC111119225,13793
NC_035781.1,39546923,39580797,39546926,39580793,111119226,XM_022459187.1,uncharacterized LOC111119226,33867
NC_035781.1,39546923,39580797,39546926,39580794,111119226,XM_022459190.1,uncharacterized LOC111119226,33868
NC_035781.1,39546923,39580797,39546925,39580795,111119226,XM_022459188.1,uncharacterized LOC111119226,33870
NC_035781.1,39546923,39580797,39546924,39580795,111119226,XM_022459189.1,uncharacterized LOC111119226,33871
NC_035781.1,39546923,39580797,39546924,39580796,111119226,XM_022459186.1,uncharacterized LOC111119226,33872
NC_035781.1,39546923,39580797,39546923,39580797,111119226,XM_022459193.1,uncharacterized LOC111119226,33874
NC_035780.1,49353707,49370115,49356809,49370115,111119227,XM_022459207.1,uncharacterized LOC111119227,13306
NC_035780.1,49353707,49370115,49353707,49370115,111119227,XM_022459197.1,uncharacterized LOC111119227,16408
NC_035781.1,39501114,39507586,39501114,39507586,111119229,XM_022459199.1,uncharacterized LOC111119229,6472
NC_035780.1,58726592,58730146,58726592,58730146,111119237,XM_022459262.1,uncharacterized LOC111119237,3554
NC_035781.1,51902142,52013338,51906412,52013338,111119241,XM_022459232.1,uncharacterized LOC111119241,106926
NC_035781.1,51902142,52013338,51906411,52013338,111119241,XM_022459231.1,uncharacterized LOC111119241,106927
NC_035781.1,52064473,52127690,52064473,52127690,111119242,XM_022459233.1,uncharacterized LOC111119242,63217
NC_035781.1,52159750,52218322,52159750,52218322,111119243,XM_022459234.1,uncharacterized LOC111119243,58572
NC_035781.1,52030071,52034098,52030071,52034098,111119244,XM_022459235.1,uncharacterized LOC111119244,4027
NC_035781.1,8714056,8716270,8714056,8716270,111119249,XM_022459239.1,uncharacterized LOC111119249,2214
NC_035780.1,49495708,49500124,49495708,49500124,111119257,XM_022459265.1,uncharacterized LOC111119257,4416
NC_035781.1,39445923,39448647,39445923,39448647,111119260,XM_022459266.1,uncharacterized LOC111119260,2724
NC_035781.1,59255310,59265097,59255310,59265097,111119265,XM_022459272.1,uncharacterized LOC111119265,9787
NC_035780.1,49478484,49484306,49478484,49484306,111119266,XM_022459277.1,uncharacterized LOC111119266,5822
NC_035781.1,59382246,59392052,59382274,59390349,111119267,XM_022459278.1,uncharacterized LOC111119267,8075
NC_035781.1,59382246,59392052,59382246,59390349,111119267,XM_022459274.1,uncharacterized LOC111119267,8103
NC_035781.1,59382246,59392052,59382246,59392052,111119267,XM_022459275.1,uncharacterized LOC111119267,9806
NC_035781.1,59391993,59399870,59391993,59399870,111119268,XM_022459279.1,uncharacterized LOC111119268,7877
NC_035781.1,59372836,59380307,59375143,59380307,111119273,XM_022459285.1,uncharacterized LOC111119273,5164
NC_035781.1,59372836,59380307,59372836,59380307,111119273,XM_022459284.1,uncharacterized LOC111119273,7471
NC_035781.1,59248489,59249656,59248489,59249656,111119276,XM_022459287.1,uncharacterized LOC111119276,1167
NC_035781.1,7021330,7057110,7021330,7042648,111119286,XM_022459299.1,uncharacterized LOC111119286,21318
NC_035781.1,7021330,7057110,7021330,7057110,111119286,XM_022459301.1,uncharacterized LOC111119286,35780
NC_035781.1,7107356,7114709,7107356,7114709,111119290,XM_022459315.1,uncharacterized LOC111119290,7353
NC_035781.1,7055148,7120824,7091373,7120824,111119292,XM_022459317.1,uncharacterized LOC111119292,29451
NC_035781.1,7055148,7120824,7055149,7098295,111119292,XM_022459318.1,uncharacterized LOC111119292,43146
NC_035781.1,7055148,7120824,7055148,7098297,111119292,XM_022459319.1,uncharacterized LOC111119292,43149
NC_035781.1,7055148,7120824,7091373,7098301,111119292,XM_022459316.1,uncharacterized LOC111119292,6928
NC_035781.1,7055148,7120824,7055155,7062652,111119292,XM_022459320.1,uncharacterized LOC111119292,7497
NC_035780.1,49348119,49349628,49348119,49349628,111119295,XM_022459338.1,uncharacterized LOC111119295,1509
NC_035780.1,49348119,49349628,49348119,49349082,111119295,XM_022459327.1,uncharacterized LOC111119295,963
NC_035781.1,11872038,11907853,11872038,11885777,111119297,XM_022459341.1,uncharacterized LOC111119297,13739
NC_035781.1,11872038,11907853,11872038,11885779,111119297,XM_022459339.1,uncharacterized LOC111119297,13741
NC_035781.1,11872038,11907853,11872038,11885780,111119297,XM_022459340.1,uncharacterized LOC111119297,13742
NC_035781.1,11872038,11907853,11872038,11898246,111119297,XM_022459344.1,uncharacterized LOC111119297,26208
NC_035781.1,11872038,11907853,11872038,11898248,111119297,XM_022459343.1,uncharacterized LOC111119297,26210
NC_035781.1,11872038,11907853,11872038,11898249,111119297,XM_022459342.1,uncharacterized LOC111119297,26211
NC_035781.1,11872038,11907853,11872038,11907850,111119297,XM_022459325.1,uncharacterized LOC111119297,35812
NC_035781.1,11872038,11907853,11872038,11907851,111119297,XM_022459334.1,uncharacterized LOC111119297,35813
NC_035781.1,11872038,11907853,11872038,11907852,111119297,XM_022459332.1,uncharacterized LOC111119297,35814
NC_035781.1,11872038,11907853,11872038,11907853,111119297,XM_022459330.1,uncharacterized LOC111119297,35815
NC_035780.1,49325329,49326615,49325329,49326615,111119300,XM_022459352.1,uncharacterized LOC111119300,1286
NC_035781.1,16623768,16626517,16623768,16626517,111119305,XM_022459359.1,uncharacterized LOC111119305,2749
NC_035781.1,18769444,18799127,18789997,18799126,111119315,XM_022459369.1,uncharacterized LOC111119315,9129
NC_035780.1,49468296,49469261,49468296,49469261,111119317,XM_022459375.1,uncharacterized LOC111119317,965
NC_035781.1,25023384,25025804,25023384,25025804,111119321,XM_022459383.1,uncharacterized LOC111119321,2420
NC_035780.1,49583402,49600653,49583402,49600653,111119322,XM_022459387.1,uncharacterized LOC111119322,17251
NC_035781.1,24979450,25035882,24979450,25035882,111119323,XM_022459385.1,uncharacterized LOC111119323,56432
NC_035781.1,31014282,31028323,31014295,31028323,111119330,XM_022459397.1,uncharacterized LOC111119330,14028
NC_035781.1,31014282,31028323,31014282,31028323,111119330,XM_022459398.1,uncharacterized LOC111119330,14041
NC_035781.1,30035160,30044266,30035192,30044266,111119336,XM_022459408.1,uncharacterized LOC111119336,9074
NC_035781.1,30035160,30044266,30035160,30044266,111119336,XM_022459407.1,uncharacterized LOC111119336,9106
NC_035781.1,18206639,18220458,18206639,18220458,111119352,XM_022459418.1,uncharacterized LOC111119352,13819
NC_035781.1,18224007,18229910,18224588,18229910,111119353,XM_022459421.1,uncharacterized LOC111119353,5322
NC_035781.1,18224007,18229910,18224007,18229910,111119353,XM_022459420.1,uncharacterized LOC111119353,5903
NC_035781.1,18234072,18239822,18234074,18239822,111119356,XM_022459427.1,uncharacterized LOC111119356,5748
NC_035781.1,18234072,18239822,18234072,18239822,111119356,XM_022459426.1,uncharacterized LOC111119356,5750
NC_035780.1,24871946,24875442,24871947,24875442,111119367,XM_022459469.1,uncharacterized LOC111119367,3495
NC_035780.1,24871946,24875442,24871946,24875442,111119367,XM_022459459.1,uncharacterized LOC111119367,3496
NC_035781.1,50424113,50430204,50424113,50430204,111119368,XM_022459456.1,uncharacterized LOC111119368,6091
NC_035781.1,42058219,42091125,42064978,42091125,111119376,XM_022459485.1,uncharacterized LOC111119376,26147
NC_035781.1,42058219,42091125,42058219,42091125,111119376,XM_022459480.1,uncharacterized LOC111119376,32906
NC_035781.1,28710360,28798777,28756240,28798777,111119378,XM_022459489.1,uncharacterized LOC111119378,42537
NC_035781.1,28710360,28798777,28710360,28798777,111119378,XM_022459486.1,uncharacterized LOC111119378,88417
NC_035781.1,14701946,14704965,14701946,14704965,111119385,XM_022459497.1,uncharacterized LOC111119385,3019
NC_035780.1,1874661,1878188,1874661,1878188,111119406,XM_022459546.1,uncharacterized LOC111119406,3527
NC_035781.1,20325219,20454743,20325219,20454743,111119411,XM_022459551.1,uncharacterized LOC111119411,129524
NC_035781.1,20343019,20344398,20343019,20344398,111119413,XM_022459553.1,uncharacterized LOC111119413,1379
NC_035780.1,3793738,3799748,3793738,3798288,111119414,XM_022459566.1,uncharacterized LOC111119414,4550
NC_035780.1,3793738,3799748,3793739,3799748,111119414,XM_022459557.1,uncharacterized LOC111119414,6009
NC_035781.1,33940725,33955327,33940725,33953829,111119416,XM_022459556.1,uncharacterized LOC111119416,13104
NC_035781.1,33940725,33955327,33940725,33955327,111119416,XM_022459555.1,uncharacterized LOC111119416,14602
NC_035781.1,34055462,34071823,34055462,34071823,111119425,XM_022459599.1,uncharacterized LOC111119425,16361
NC_035781.1,33929520,33931428,33929520,33931428,111119438,XM_022459625.1,uncharacterized LOC111119438,1908
NC_035781.1,34158122,34160849,34158122,34160849,111119441,XM_022459629.1,uncharacterized LOC111119441,2727
NC_035780.1,39215248,39218023,39215315,39218023,111119447,XM_022459647.1,uncharacterized LOC111119447,2708
NC_035780.1,39215248,39218023,39215248,39218022,111119447,XM_022459639.1,uncharacterized LOC111119447,2774
NC_035781.1,16016307,16020686,16016307,16020686,111119456,XM_022459645.1,uncharacterized LOC111119456,4379
NC_035781.1,5795795,5804957,5795795,5804957,111119462,XM_022459653.1,uncharacterized LOC111119462,9162
NC_035781.1,5787588,5790014,5787588,5790014,111119463,XM_022459654.1,uncharacterized LOC111119463,2426
NC_035781.1,5779588,5787679,5779588,5787679,111119465,XM_022459655.1,uncharacterized LOC111119465,8091
NC_035781.1,31998911,32034589,31999112,32034589,111119466,XM_022459657.1,uncharacterized LOC111119466,35477
NC_035781.1,31998911,32034589,31998911,32034589,111119466,XM_022459656.1,uncharacterized LOC111119466,35678
NC_035781.1,32171370,32194344,32175315,32194344,111119467,XM_022459660.1,uncharacterized LOC111119467,19029
NC_035781.1,32171370,32194344,32171370,32194344,111119467,XM_022459661.1,uncharacterized LOC111119467,22974
NC_035781.1,32040952,32070611,32040952,32065210,111119468,XM_022459666.1,uncharacterized LOC111119468,24258
NC_035781.1,32040952,32070611,32040952,32070611,111119468,XM_022459665.1,uncharacterized LOC111119468,29659
NC_035781.1,32127204,32162055,32127227,32162055,111119469,XM_022459669.1,uncharacterized LOC111119469,34828
NC_035781.1,32127204,32162055,32127207,32162055,111119469,XM_022459667.1,uncharacterized LOC111119469,34848
NC_035781.1,32127204,32162055,32127204,32162055,111119469,XM_022459668.1,uncharacterized LOC111119469,34851
NC_035781.1,10178722,10206406,10178722,10206406,111119477,XM_022459673.1,uncharacterized LOC111119477,27684
NC_035780.1,35812470,35822298,35812470,35822298,111119480,XM_022459681.1,uncharacterized LOC111119480,9828
NC_035781.1,27774867,27815879,27774867,27815879,111119482,XM_022459679.1,uncharacterized LOC111119482,41012
NC_035781.1,59567239,59573311,59567239,59569886,111119486,XM_022459687.1,uncharacterized LOC111119486,2647
NC_035781.1,59567239,59573311,59567239,59573311,111119486,XM_022459688.1,uncharacterized LOC111119486,6072
NC_035781.1,59573508,59579594,59573508,59579594,111119488,XM_022459690.1,uncharacterized LOC111119488,6086
NC_035781.1,7718775,7738453,7718775,7738453,111119491,XM_022459696.1,uncharacterized LOC111119491,19678
NC_035781.1,7751333,7800381,7779156,7800381,111119492,XM_022459697.1,uncharacterized LOC111119492,21225
NC_035781.1,7751333,7800381,7751333,7800381,111119492,XM_022459698.1,uncharacterized LOC111119492,49048
NC_035781.1,1011018,1014301,1011018,1014301,111119494,XM_022459700.1,uncharacterized LOC111119494,3283
NC_035781.1,941124,945148,941124,945148,111119495,XM_022459701.1,uncharacterized LOC111119495,4024
NC_035781.1,984914,987998,984914,987998,111119496,XM_022459702.1,uncharacterized LOC111119496,3084
NC_035780.1,30398941,30400416,30398941,30400416,111119497,XM_022459706.1,uncharacterized LOC111119497,1475
NC_035781.1,1022300,1025672,1022300,1025672,111119498,XM_022459703.1,uncharacterized LOC111119498,3372
NC_035781.1,995608,998797,995608,998797,111119499,XM_022459704.1,uncharacterized LOC111119499,3189
NC_035781.1,1053002,1056105,1053002,1056105,111119500,XM_022459705.1,uncharacterized LOC111119500,3103
NC_035781.1,969074,973025,969074,973025,111119501,XM_022459707.1,uncharacterized LOC111119501,3951
NC_035781.1,932133,935185,932139,935185,111119502,XM_022459709.1,uncharacterized LOC111119502,3046
NC_035781.1,932133,935185,932133,935185,111119502,XM_022459708.1,uncharacterized LOC111119502,3052
NC_035781.1,1045152,1049448,1045266,1049448,111119506,XM_022459713.1,uncharacterized LOC111119506,4182
NC_035781.1,1045152,1049448,1045152,1049448,111119506,XM_022459712.1,uncharacterized LOC111119506,4296
NC_035781.1,957297,959971,957297,959971,111119508,XM_022459714.1,uncharacterized LOC111119508,2674
NC_035781.1,50736624,50748821,50736624,50748821,111119516,XM_022459725.1,uncharacterized LOC111119516,12197
NC_035781.1,26903931,26913101,26903931,26912902,111119518,XM_022459729.1,uncharacterized LOC111119518,8971
NC_035781.1,26903931,26913101,26903931,26913101,111119518,XM_022459727.1,uncharacterized LOC111119518,9170
NC_035780.1,60507224,60517336,60507224,60517336,111119524,XM_022459740.1,uncharacterized LOC111119524,10112
NC_035781.1,46122071,46124221,46122071,46124221,111119528,XM_022459741.1,uncharacterized LOC111119528,2150
NC_035781.1,46135054,46143698,46135054,46143698,111119529,XM_022459742.1,uncharacterized LOC111119529,8644
NC_035781.1,59185125,59220551,59185125,59214748,111119530,XM_022459746.1,uncharacterized LOC111119530,29623
NC_035781.1,59185125,59220551,59190824,59220551,111119530,XM_022459754.1,uncharacterized LOC111119530,29727
NC_035781.1,59185125,59220551,59185125,59217925,111119530,XM_022459747.1,uncharacterized LOC111119530,32800
NC_035781.1,59185125,59220551,59185125,59218628,111119530,XM_022459745.1,uncharacterized LOC111119530,33503
NC_035781.1,59185125,59220551,59186825,59220551,111119530,XM_022459751.1,uncharacterized LOC111119530,33726
NC_035781.1,59185125,59220551,59185125,59219113,111119530,XM_022459744.1,uncharacterized LOC111119530,33988
NC_035781.1,59185125,59220551,59185125,59219352,111119530,XM_022459748.1,uncharacterized LOC111119530,34227
NC_035781.1,59185125,59220551,59185125,59220551,111119530,XM_022459752.1,uncharacterized LOC111119530,35426
NC_035780.1,8492273,8502116,8492273,8502116,111119534,XM_022459779.1,uncharacterized LOC111119534,9843
NC_035781.1,32990174,33001167,32990174,33001167,111119542,XM_022459787.1,uncharacterized LOC111119542,10993
NC_035781.1,46483701,46489842,46483703,46489842,111119551,XM_022459800.1,uncharacterized LOC111119551,6139
NC_035781.1,46483701,46489842,46483702,46489842,111119551,XM_022459799.1,uncharacterized LOC111119551,6140
NC_035781.1,46483701,46489842,46483701,46489842,111119551,XM_022459801.1,uncharacterized LOC111119551,6141
NC_035781.1,30908545,30910495,30908545,30910495,111119556,XM_022459814.1,uncharacterized LOC111119556,1950
NC_035781.1,54489534,54500275,54489534,54500275,111119559,XM_022459820.1,uncharacterized LOC111119559,10741
NC_035781.1,10092365,10104808,10092365,10104808,111119561,XM_022459824.1,uncharacterized LOC111119561,12443
NC_035781.1,10092365,10104808,10092365,10095102,111119561,XM_022459823.1,uncharacterized LOC111119561,2737
NC_035781.1,10092365,10104808,10092365,10097473,111119561,XM_022459826.1,uncharacterized LOC111119561,5108
NC_035781.1,10092365,10104808,10092365,10098008,111119561,XM_022459825.1,uncharacterized LOC111119561,5643
NC_035780.1,52983322,53028662,52983322,53028662,111119572,XM_022459855.1,uncharacterized LOC111119572,45340
NC_035780.1,13935566,13945819,13935580,13945819,111119580,XM_022459876.1,uncharacterized LOC111119580,10239
NC_035780.1,13935566,13945819,13935566,13945819,111119580,XM_022459885.1,uncharacterized LOC111119580,10253
NC_035781.1,42739698,42741041,42739698,42741041,111119583,XM_022459883.1,uncharacterized LOC111119583,1343
NC_035781.1,58012032,58014497,58012032,58014497,111119589,XM_022459903.1,uncharacterized LOC111119589,2465
NC_035780.1,57776178,57776968,57776178,57776968,111119605,XM_022459949.1,uncharacterized LOC111119605,790
NC_035781.1,45044887,45050060,45044887,45050060,111119606,XM_022459945.1,uncharacterized LOC111119606,5173
NC_035781.1,35877833,35929421,35877833,35896382,111119611,XM_022459957.1,uncharacterized LOC111119611,18549
NC_035781.1,35877833,35929421,35877833,35929421,111119611,XM_022459958.1,uncharacterized LOC111119611,51588
NC_035781.1,35997100,36003672,35997100,36003672,111119613,XM_022459960.1,uncharacterized LOC111119613,6572
NC_035781.1,35799045,35860003,35799045,35860003,111119614,XM_022459964.1,uncharacterized LOC111119614,60958
NC_035781.1,35832098,35847015,35838525,35843532,111119616,XM_022459967.1,uncharacterized LOC111119616,5007
NC_035781.1,35832098,35847015,35838525,35847015,111119616,XM_022459966.1,uncharacterized LOC111119616,8490
NC_035781.1,2909644,2928928,2917651,2928928,111119620,XM_022459971.1,uncharacterized LOC111119620,11277
NC_035781.1,2909644,2928928,2916950,2928928,111119620,XM_022459972.1,uncharacterized LOC111119620,11978
NC_035781.1,2909644,2928928,2916329,2928928,111119620,XM_022459973.1,uncharacterized LOC111119620,12599
NC_035781.1,2909644,2928928,2915502,2928928,111119620,XM_022459970.1,uncharacterized LOC111119620,13426
NC_035781.1,2909644,2928928,2909652,2928924,111119620,XM_022459974.1,uncharacterized LOC111119620,19272
NC_035781.1,2909644,2928928,2909644,2928928,111119620,XM_022459969.1,uncharacterized LOC111119620,19284
NC_035781.1,2909644,2928928,2920742,2928926,111119620,XM_022459975.1,uncharacterized LOC111119620,8184
NC_035781.1,15308402,15326590,15315837,15326590,111119621,XM_022459980.1,uncharacterized LOC111119621,10753
NC_035781.1,15308402,15326590,15308403,15326586,111119621,XM_022459984.1,uncharacterized LOC111119621,18183
NC_035781.1,15308402,15326590,15308402,15326586,111119621,XM_022459978.1,uncharacterized LOC111119621,18184
NC_035781.1,15308402,15326590,15308402,15326587,111119621,XM_022459976.1,uncharacterized LOC111119621,18185
NC_035780.1,17655151,17660390,17655151,17660390,111119622,XM_022459982.1,uncharacterized LOC111119622,5239
NC_035780.1,34629184,34630881,34629184,34630881,111119631,XM_022460009.1,uncharacterized LOC111119631,1697
NC_035781.1,56594021,56595770,56594021,56595770,111119651,XM_022460054.1,uncharacterized LOC111119651,1749
NC_035780.1,7638094,7641132,7638094,7641132,111119653,XM_022460060.1,uncharacterized LOC111119653,3038
NC_035781.1,15976750,15978863,15976750,15978863,111119658,XM_022460065.1,uncharacterized LOC111119658,2113
NC_035781.1,38341047,38371907,38341047,38371907,111119659,XM_022460066.1,uncharacterized LOC111119659,30860
NC_035781.1,34951353,34972108,34951353,34971549,111119663,XM_022460070.1,uncharacterized LOC111119663,20196
NC_035781.1,34951353,34972108,34951353,34972108,111119663,XM_022460069.1,uncharacterized LOC111119663,20755
NC_035781.1,55283884,55288714,55283884,55288714,111119665,XM_022460074.1,uncharacterized LOC111119665,4830
NC_035781.1,30824874,30840658,30824874,30840658,111119688,XM_022460109.1,uncharacterized LOC111119688,15784
NC_035781.1,30840565,30850230,30840836,30850230,111119690,XM_022460111.1,uncharacterized LOC111119690,9394
NC_035781.1,30840565,30850230,30840770,30850230,111119690,XM_022460113.1,uncharacterized LOC111119690,9460
NC_035781.1,30840565,30850230,30840565,30850230,111119690,XM_022460112.1,uncharacterized LOC111119690,9665
NC_035780.1,54753621,54757596,54753621,54757596,111119701,XM_022460132.1,uncharacterized LOC111119701,3975
NC_035781.1,36971630,36978840,36971630,36978840,111119702,XM_022460130.1,uncharacterized LOC111119702,7210
NC_035781.1,36965978,36970935,36965978,36970935,111119703,XM_022460131.1,uncharacterized LOC111119703,4957
NC_035781.1,36979356,36987572,36979356,36987572,111119704,XM_022460133.1,uncharacterized LOC111119704,8216
NC_035780.1,4019514,4023265,4019514,4023265,111119716,XM_022460156.1,uncharacterized LOC111119716,3751
NC_035781.1,29941029,29942740,29941029,29942740,111119717,XM_022460153.1,uncharacterized LOC111119717,1711
NC_035781.1,8216465,8261240,8216472,8261240,111119718,XM_022460154.1,uncharacterized LOC111119718,44768
NC_035781.1,8301790,8336297,8301790,8336297,111119719,XM_022460155.1,uncharacterized LOC111119719,34507
NC_035781.1,8179176,8181839,8179176,8181839,111119723,XM_022460163.1,uncharacterized LOC111119723,2663
NC_035781.1,31150663,31153670,31150663,31153657,111119728,XM_022460170.1,uncharacterized LOC111119728,2994
NC_035781.1,61104861,61115189,61104861,61115189,111119737,XM_022460194.1,uncharacterized LOC111119737,10328
NC_035781.1,40906450,40911285,40906450,40911284,111119740,XM_022460196.1,uncharacterized LOC111119740,4834
NC_035781.1,40906450,40911285,40906450,40911285,111119740,XM_022460197.1,uncharacterized LOC111119740,4835
NC_035780.1,3545295,3550207,3545295,3547664,111119741,XM_022460199.1,uncharacterized LOC111119741,2369
NC_035780.1,3545295,3550207,3545295,3550207,111119741,XM_022460207.1,uncharacterized LOC111119741,4912
NC_035781.1,13477102,13479513,13477102,13479513,111119747,XM_022460203.1,uncharacterized LOC111119747,2411
NC_035781.1,11642758,11658504,11642789,11658504,111119748,XM_022460206.1,uncharacterized LOC111119748,15715
NC_035781.1,11642758,11658504,11642758,11658504,111119748,XM_022460204.1,uncharacterized LOC111119748,15746
NC_035781.1,2869761,2872604,2869761,2872604,111119751,XM_022460209.1,uncharacterized LOC111119751,2843
NC_035781.1,55707745,55710935,55708379,55710935,111119755,XM_022460215.1,uncharacterized LOC111119755,2556
NC_035781.1,55707745,55710935,55707745,55710935,111119755,XM_022460216.1,uncharacterized LOC111119755,3190
NC_035781.1,55662171,55666408,55662171,55666408,111119757,XM_022460221.1,uncharacterized LOC111119757,4237
NC_035781.1,55775108,55777241,55775108,55776161,111119764,XM_022460231.1,uncharacterized LOC111119764,1053
NC_035781.1,55775108,55777241,55775108,55777241,111119764,XM_022460230.1,uncharacterized LOC111119764,2133
NC_035781.1,23062726,23077980,23062726,23076332,111119768,XM_022460236.1,uncharacterized LOC111119768,13606
NC_035781.1,23062726,23077980,23062726,23076841,111119768,XM_022460237.1,uncharacterized LOC111119768,14115
NC_035781.1,23062726,23077980,23062726,23077980,111119768,XM_022460238.1,uncharacterized LOC111119768,15254
NC_035781.1,23062726,23077980,23062726,23069082,111119768,XM_022460235.1,uncharacterized LOC111119768,6356
NC_035780.1,46158529,46161297,46158529,46161297,111119772,XM_022460254.1,uncharacterized LOC111119772,2768
NC_035781.1,17453787,17458420,17453787,17458420,111119777,XM_022460257.1,uncharacterized LOC111119777,4633
NC_035780.1,32016429,32035434,32016429,32035434,111119780,XM_022460267.1,uncharacterized LOC111119780,19005
NC_035781.1,58533674,58537107,58533674,58537107,111119782,XM_022460266.1,uncharacterized LOC111119782,3433
NC_035781.1,58516791,58519523,58516791,58519523,111119784,XM_022460270.1,uncharacterized LOC111119784,2732
NC_035781.1,7223084,7249095,7223084,7249095,111119802,XM_022460302.1,uncharacterized LOC111119802,26011
NC_035781.1,28953767,28974229,28953767,28974229,111119807,XM_022460306.1,uncharacterized LOC111119807,20462
NC_035781.1,15455600,15463573,15455600,15463573,111119821,XM_022460332.1,uncharacterized LOC111119821,7973
NC_035781.1,15465969,15468438,15465969,15468438,111119822,XM_022460333.1,uncharacterized LOC111119822,2469
NC_035781.1,27850550,27868341,27850550,27868341,111119831,XM_022460348.1,uncharacterized LOC111119831,17791
NC_035780.1,3424450,3436311,3424857,3436311,111119833,XM_022460354.1,uncharacterized LOC111119833,11454
NC_035780.1,3424450,3436311,3424450,3436287,111119833,XM_022460362.1,uncharacterized LOC111119833,11837
NC_035781.1,43134596,43153958,43134596,43153958,111119837,XM_022460356.1,uncharacterized LOC111119837,19362
NC_035780.1,20828818,20833039,20828818,20833039,111119839,XM_022461532.1,uncharacterized LOC111119839,4221
NC_035781.1,58341737,58389491,58341737,58389491,111119843,XM_022460360.1,uncharacterized LOC111119843,47754
NC_035781.1,38307807,38327098,38307810,38327098,111119848,XM_022460375.1,uncharacterized LOC111119848,19288
NC_035781.1,38307807,38327098,38307807,38327098,111119848,XM_022460373.1,uncharacterized LOC111119848,19291
NC_035781.1,38307807,38327098,38323568,38327098,111119848,XM_022460372.1,uncharacterized LOC111119848,3530
NC_035781.1,38307807,38327098,38319786,38327098,111119848,XM_022460374.1,uncharacterized LOC111119848,7312
NC_035781.1,60134672,60137391,60135103,60137391,111119857,XM_022460390.1,uncharacterized LOC111119857,2288
NC_035781.1,60134672,60137391,60134679,60137391,111119857,XM_022460391.1,uncharacterized LOC111119857,2712
NC_035781.1,60134672,60137391,60134672,60137391,111119857,XM_022460393.1,uncharacterized LOC111119857,2719
NC_035781.1,60137475,60138329,60137475,60138329,111119858,XM_022460394.1,uncharacterized LOC111119858,854
NC_035781.1,10715544,10728181,10715544,10728181,111119861,XM_022460405.1,uncharacterized LOC111119861,12637
NC_035781.1,10638203,10648115,10638204,10648114,111119863,XM_022460408.1,uncharacterized LOC111119863,9910
NC_035781.1,10638203,10648115,10638203,10648115,111119863,XM_022460407.1,uncharacterized LOC111119863,9912
NC_035780.1,64268780,64274835,64268780,64274835,111119878,XM_022460446.1,uncharacterized LOC111119878,6055
NC_035781.1,10734113,10736439,10734113,10736439,111119884,XM_022460452.1,uncharacterized LOC111119884,2326
NC_035781.1,10738174,10740717,10738174,10740717,111119885,XM_022460453.1,uncharacterized LOC111119885,2543
NC_035781.1,10658673,10660800,10658673,10660800,111119888,XM_022460455.1,uncharacterized LOC111119888,2127
NC_035781.1,10652254,10654199,10652254,10654199,111119889,XM_022460456.1,uncharacterized LOC111119889,1945
NC_035781.1,10743537,10745928,10743537,10745779,111119890,XM_022460457.1,uncharacterized LOC111119890,2242
NC_035781.1,10743537,10745928,10743537,10745928,111119890,XM_022460458.1,uncharacterized LOC111119890,2391
NC_035781.1,10336849,10341377,10336849,10341377,111119891,XM_022460459.1,uncharacterized LOC111119891,4528
NC_035781.1,10353884,10357391,10353884,10357391,111119899,XM_022460475.1,uncharacterized LOC111119899,3507
NC_035781.1,10558875,10560000,10558875,10560000,111119901,XM_022460477.1,uncharacterized LOC111119901,1125
NC_035780.1,63911379,63916986,63911379,63916986,111119908,XM_022460519.1,uncharacterized LOC111119908,5607
NC_035781.1,1288254,1321901,1288254,1321901,111119919,XM_022460497.1,uncharacterized LOC111119919,33647
NC_035781.1,9126090,9147147,9126090,9147147,111119923,XM_022460500.1,uncharacterized LOC111119923,21057
NC_035781.1,1537925,1544429,1537929,1543063,111119925,XM_022460505.1,uncharacterized LOC111119925,5134
NC_035781.1,1537925,1544429,1537926,1543066,111119925,XM_022460504.1,uncharacterized LOC111119925,5140
NC_035781.1,1537925,1544429,1537929,1544340,111119925,XM_022460506.1,uncharacterized LOC111119925,6411
NC_035781.1,1537925,1544429,1537925,1544429,111119925,XM_022460502.1,uncharacterized LOC111119925,6504
NC_035781.1,42789514,42792756,42789514,42792756,111119929,XM_022460509.1,uncharacterized LOC111119929,3242
NC_035781.1,8873368,8874669,8873368,8874669,111119934,XM_022460515.1,uncharacterized LOC111119934,1301
NC_035781.1,8876179,8877404,8876179,8877404,111119935,XM_022460516.1,uncharacterized LOC111119935,1225
NC_035781.1,8877713,8878945,8877713,8878945,111119936,XM_022460517.1,uncharacterized LOC111119936,1232
NC_035781.1,8879798,8880662,8879798,8880662,111119937,XM_022460518.1,uncharacterized LOC111119937,864
NC_035781.1,8889605,8890581,8889605,8890581,111119939,XM_022460520.1,uncharacterized LOC111119939,976
NC_035781.1,56991800,57012499,56991800,57012499,111119945,XM_022460527.1,uncharacterized LOC111119945,20699
NC_035781.1,57124855,57134117,57124855,57130268,111119957,XM_022460549.1,uncharacterized LOC111119957,5413
NC_035781.1,57124855,57134117,57124855,57134117,111119957,XM_022460550.1,uncharacterized LOC111119957,9262
NC_035780.1,27236601,27239815,27236601,27237902,111119964,XM_022460568.1,uncharacterized LOC111119964,1301
NC_035780.1,27236601,27239815,27236601,27238333,111119964,XM_022460560.1,uncharacterized LOC111119964,1732
NC_035780.1,27236601,27239815,27236601,27239815,111119964,XM_022460575.1,uncharacterized LOC111119964,3214
NC_035781.1,56973669,56981641,56973669,56981641,111119965,XM_022460557.1,uncharacterized LOC111119965,7972
NC_035781.1,57359093,57369166,57359093,57369166,111119966,XM_022460558.1,uncharacterized LOC111119966,10073
NC_035781.1,57347979,57355060,57347979,57355060,111119967,XM_022460559.1,uncharacterized LOC111119967,7081
NC_035781.1,56962197,56969164,56962197,56969164,111119968,XM_022460561.1,uncharacterized LOC111119968,6967
NC_035781.1,57112591,57115987,57112850,57115987,111119971,XM_022460566.1,uncharacterized LOC111119971,3137
NC_035781.1,57112591,57115987,57112591,57115987,111119971,XM_022460565.1,uncharacterized LOC111119971,3396
NC_035781.1,57118594,57122671,57118594,57122671,111119972,XM_022460567.1,uncharacterized LOC111119972,4077
NC_035781.1,57103080,57108183,57103080,57108183,111119973,XM_022460569.1,uncharacterized LOC111119973,5103
NC_035781.1,57287604,57289354,57287604,57289354,111119976,XM_022460572.1,uncharacterized LOC111119976,1750
NC_035781.1,57039139,57041838,57039139,57041838,111119977,XM_022460573.1,uncharacterized LOC111119977,2699
NC_035781.1,18483236,18487877,18483236,18487877,111119981,XM_022460579.1,uncharacterized LOC111119981,4641
NC_035780.1,21957031,21959200,21957031,21959200,111119989,XM_022460593.1,uncharacterized LOC111119989,2169
NC_035781.1,59450494,59467911,59455605,59467911,111119992,XM_022460594.1,uncharacterized LOC111119992,12306
NC_035781.1,59450494,59467911,59450494,59467911,111119992,XM_022460595.1,uncharacterized LOC111119992,17417
NC_035781.1,39676720,39678830,39676720,39678830,111119996,XM_022460599.1,uncharacterized LOC111119996,2110
NC_035781.1,39654569,39667394,39654569,39666512,111119997,XM_022460600.1,uncharacterized LOC111119997,11943
NC_035781.1,39654569,39667394,39654569,39667394,111119997,XM_022460601.1,uncharacterized LOC111119997,12825
NC_035781.1,39654569,39667394,39654569,39664568,111119997,XM_022460602.1,uncharacterized LOC111119997,9999
NC_035781.1,39701750,39706705,39701750,39706705,111119999,XM_022460603.1,uncharacterized LOC111119999,4955
NC_035781.1,47490232,47498986,47490232,47498986,111120004,XM_022460610.1,uncharacterized LOC111120004,8754
NC_035781.1,48286683,48291497,48287987,48291497,111120011,XM_022460625.1,uncharacterized LOC111120011,3510
NC_035781.1,48286683,48291497,48287452,48291497,111120011,XM_022460623.1,uncharacterized LOC111120011,4045
NC_035781.1,48286683,48291497,48286683,48291497,111120011,XM_022460624.1,uncharacterized LOC111120011,4814
NC_035780.1,37748345,37751117,37748345,37751117,111120017,XM_022460641.1,uncharacterized LOC111120017,2772
NC_035781.1,9378621,9426188,9378621,9426188,111120020,XM_022460649.1,uncharacterized LOC111120020,47567
NC_035780.1,26171267,26173329,26171267,26173329,111120021,XM_022460654.1,uncharacterized LOC111120021,2062
NC_035781.1,37806088,37814454,37807444,37814454,111120023,XM_022460651.1,uncharacterized LOC111120023,7010
NC_035781.1,37806088,37814454,37806088,37814454,111120023,XM_022460652.1,uncharacterized LOC111120023,8366
NC_035780.1,26165279,26173045,26165279,26172654,111120028,XM_022460667.1,uncharacterized LOC111120028,7375
NC_035780.1,26165279,26173045,26165279,26173045,111120028,XM_022460676.1,uncharacterized LOC111120028,7766
NC_035781.1,15213008,15218016,15213008,15218016,111120035,XM_022460677.1,uncharacterized LOC111120035,5008
NC_035781.1,56557132,56581013,56557133,56581013,111120045,XM_022460689.1,uncharacterized LOC111120045,23880
NC_035781.1,56557132,56581013,56557132,56581013,111120045,XM_022460686.1,uncharacterized LOC111120045,23881
NC_035781.1,24734668,24750557,24734668,24750557,111120053,XM_022460699.1,uncharacterized LOC111120053,15889
NC_035781.1,54797560,54799825,54797560,54799825,111120055,XM_022460701.1,uncharacterized LOC111120055,2265
NC_035781.1,4301789,4303873,4301789,4303873,111120057,XM_022460704.1,uncharacterized LOC111120057,2084
NC_035780.1,22590479,22595318,22590479,22595318,111120060,XM_022460710.1,uncharacterized LOC111120060,4839
NC_035781.1,4292739,4323075,4292739,4323075,111120061,XM_022460708.1,uncharacterized LOC111120061,30336
NC_035781.1,17840424,17847020,17840424,17847020,111120076,XM_022460735.1,uncharacterized LOC111120076,6596
NC_035780.1,60800085,60806103,60800085,60806103,111120094,XM_022460770.1,uncharacterized LOC111120094,6018
NC_035781.1,58808932,58846192,58808932,58846192,111120095,XM_022460767.1,uncharacterized LOC111120095,37260
NC_035781.1,58815197,58821122,58815197,58821122,111120096,XM_022460768.1,uncharacterized LOC111120096,5925
NC_035781.1,55487809,55556063,55487809,55556063,111120097,XM_022460769.1,uncharacterized LOC111120097,68254
NC_035781.1,55490482,55502256,55490482,55502256,111120098,XM_022460771.1,uncharacterized LOC111120098,11774
NC_035780.1,60806190,60809490,60806190,60809490,111120102,XM_022460783.1,uncharacterized LOC111120102,3300
NC_035781.1,13548617,13553781,13548617,13553781,111120104,XM_022460782.1,uncharacterized LOC111120104,5164
NC_035781.1,5306637,5315180,5306637,5315180,111120115,XM_022460803.1,uncharacterized LOC111120115,8543
NC_035780.1,54141656,54148315,54141656,54144787,111120117,XM_022460820.1,uncharacterized LOC111120117,3131
NC_035780.1,54141656,54148315,54141656,54148315,111120117,XM_022460810.1,uncharacterized LOC111120117,6659
NC_035781.1,31306338,31369279,31306338,31369279,111120118,XM_022460814.1,uncharacterized LOC111120118,62941
NC_035780.1,35413974,35417804,35413974,35417804,111120119,XM_022460857.1,uncharacterized LOC111120119,3830
NC_035781.1,56520113,56548890,56520113,56548890,111120120,XM_022460817.1,uncharacterized LOC111120120,28777
NC_035781.1,55304705,55310310,55304705,55310310,111120124,XM_022460825.1,uncharacterized LOC111120124,5605
NC_035780.1,33631112,33653080,33631112,33648985,111120143,XM_022460872.1,uncharacterized LOC111120143,17873
NC_035780.1,33631112,33653080,33631112,33653080,111120143,XM_022460880.1,uncharacterized LOC111120143,21968
NC_035781.1,17536369,17570556,17536369,17570556,111120145,XM_022460870.1,uncharacterized LOC111120145,34187
NC_035781.1,18240866,18251321,18240866,18251321,111120146,XM_022460871.1,uncharacterized LOC111120146,10455
NC_035781.1,18269749,18273089,18269749,18273089,111120147,XM_022460873.1,uncharacterized LOC111120147,3340
NC_035781.1,18460779,18480374,18460779,18480374,111120148,XM_022460874.1,uncharacterized LOC111120148,19595
NC_035781.1,18517607,18519073,18517607,18519073,111120149,XM_022460875.1,uncharacterized LOC111120149,1466
NC_035781.1,18523862,18524392,18523862,18524392,111120150,XM_022460876.1,uncharacterized LOC111120150,530
NC_035780.1,33649471,33667084,33649471,33667084,111120161,XM_022460899.1,uncharacterized LOC111120161,17613
NC_035780.1,33649471,33667084,33657456,33667081,111120161,XM_022460891.1,uncharacterized LOC111120161,9625
NC_035781.1,21075229,21109494,21075229,21109494,111120167,XM_022460894.1,uncharacterized LOC111120167,34265
NC_035781.1,21182590,21185254,21182590,21185254,111120168,XM_022460895.1,uncharacterized LOC111120168,2664
NC_035781.1,21216112,21218678,21216112,21218678,111120170,XM_022460897.1,uncharacterized LOC111120170,2566
NC_035781.1,21240532,21241257,21240532,21241257,111120172,XM_022460900.1,uncharacterized LOC111120172,725
NC_035781.1,21471681,21472879,21471681,21472879,111120174,XM_022460902.1,uncharacterized LOC111120174,1198
NC_035781.1,21653260,21655534,21653260,21655534,111120175,XM_022460903.1,uncharacterized LOC111120175,2274
NC_035781.1,21656473,21658920,21656473,21658920,111120176,XM_022460904.1,uncharacterized LOC111120176,2447
NC_035781.1,21847189,21847815,21847189,21847815,111120177,XM_022460905.1,uncharacterized LOC111120177,626
NC_035781.1,21852470,21853015,21852470,21853015,111120178,XM_022460906.1,uncharacterized LOC111120178,545
NC_035781.1,23249081,23250073,23249081,23250073,111120185,XM_022460914.1,uncharacterized LOC111120185,992
NC_035781.1,24407790,24434426,24407790,24434426,111120188,XM_022460917.1,uncharacterized LOC111120188,26636
NC_035781.1,24755805,24758292,24755805,24758292,111120190,XM_022460919.1,uncharacterized LOC111120190,2487
NC_035781.1,26064275,26076657,26064275,26076657,111120200,XM_022460930.1,uncharacterized LOC111120200,12382
NC_035781.1,26455805,26460616,26455805,26460616,111120202,XM_022460932.1,uncharacterized LOC111120202,4811
NC_035781.1,27980673,27983607,27980673,27983607,111120213,XM_022460943.1,uncharacterized LOC111120213,2934
NC_035781.1,28408684,28413940,28408684,28413940,111120217,XM_022460946.1,uncharacterized LOC111120217,5256
NC_035781.1,28867040,28872772,28867040,28872772,111120220,XM_022460950.1,uncharacterized LOC111120220,5732
NC_035781.1,28888408,28915938,28888408,28915938,111120221,XM_022460951.1,uncharacterized LOC111120221,27530
NC_035781.1,29082250,29087003,29082250,29087003,111120222,XM_022460952.1,uncharacterized LOC111120222,4753
NC_035781.1,30149304,30155205,30149304,30155205,111120228,XM_022460956.1,uncharacterized LOC111120228,5901
NC_035781.1,30499025,30500904,30499025,30500904,111120231,XM_022460958.1,uncharacterized LOC111120231,1879
NC_035780.1,46718197,46720430,46718197,46720430,111120234,XM_022460964.1,uncharacterized LOC111120234,2233
NC_035781.1,30988071,31009414,30988071,31009414,111120236,XM_022460962.1,uncharacterized LOC111120236,21343
NC_035781.1,31910544,31911325,31910544,31911325,111120239,XM_022460966.1,uncharacterized LOC111120239,781
NC_035781.1,32093224,32117622,32093224,32117622,111120241,XM_022460968.1,uncharacterized LOC111120241,24398
NC_035781.1,32216802,32218247,32216802,32218247,111120242,XM_022460969.1,uncharacterized LOC111120242,1445
NC_035781.1,33725597,33738918,33725597,33738918,111120252,XM_022460977.1,uncharacterized LOC111120252,13321
NC_035781.1,34710625,34711761,34710625,34711761,111120255,XM_022460979.1,uncharacterized LOC111120255,1136
NC_035781.1,34711821,34713526,34711821,34713526,111120256,XM_022460981.1,uncharacterized LOC111120256,1705
NC_035781.1,34876911,34888532,34876911,34888532,111120257,XM_022460982.1,uncharacterized LOC111120257,11621
NC_035781.1,34929911,34951073,34929911,34951073,111120258,XM_022460983.1,uncharacterized LOC111120258,21162
NC_035781.1,35063705,35066364,35063705,35066364,111120259,XM_022460984.1,uncharacterized LOC111120259,2659
NC_035781.1,36174050,36177543,36174050,36177543,111120264,XM_022460988.1,uncharacterized LOC111120264,3493
NC_035781.1,36757559,36759643,36757559,36759643,111120266,XM_022460991.1,uncharacterized LOC111120266,2084
NC_035781.1,36761704,36763347,36761704,36763347,111120268,XM_022460992.1,uncharacterized LOC111120268,1643
NC_035781.1,37110016,37111160,37110016,37111160,111120270,XM_022460993.1,uncharacterized LOC111120270,1144
NC_035781.1,37180778,37184426,37180778,37184426,111120271,XM_022460994.1,uncharacterized LOC111120271,3648
NC_035781.1,37487989,37496329,37487989,37496329,111120274,XM_022460998.1,uncharacterized LOC111120274,8340
NC_035781.1,37575972,37581618,37575972,37581618,111120275,XM_022460999.1,uncharacterized LOC111120275,5646
NC_035781.1,37606145,37614163,37606145,37614163,111120276,XM_022461000.1,uncharacterized LOC111120276,8018
NC_035781.1,37905280,37938126,37905280,37938126,111120278,XM_022461002.1,uncharacterized LOC111120278,32846
NC_035781.1,38122048,38125409,38122048,38125409,111120279,XM_022461003.1,uncharacterized LOC111120279,3361
NC_035781.1,38269993,38273166,38269993,38273166,111120280,XM_022461004.1,uncharacterized LOC111120280,3173
NC_035781.1,38711363,38712034,38711363,38712034,111120281,XM_022461006.1,uncharacterized LOC111120281,671
NC_035781.1,38902623,38905586,38902623,38905586,111120282,XM_022461007.1,uncharacterized LOC111120282,2963
NC_035781.1,39041447,39043736,39041447,39043736,111120285,XM_022461010.1,uncharacterized LOC111120285,2289
NC_035781.1,39043837,39045552,39043837,39045552,111120286,XM_022461012.1,uncharacterized LOC111120286,1715
NC_035781.1,39416156,39419940,39416156,39419940,111120287,XM_022461013.1,uncharacterized LOC111120287,3784
NC_035781.1,39850517,39850981,39850517,39850981,111120289,XM_022461015.1,uncharacterized LOC111120289,464
NC_035781.1,40487070,40487717,40487070,40487717,111120295,XM_022461022.1,uncharacterized LOC111120295,647
NC_035781.1,40536119,40537413,40536119,40537413,111120296,XM_022461023.1,uncharacterized LOC111120296,1294
NC_035781.1,40666887,40668639,40666887,40668639,111120298,XM_022461025.1,uncharacterized LOC111120298,1752
NC_035781.1,41056292,41057447,41056292,41057447,111120300,XM_022461029.1,uncharacterized LOC111120300,1155
NC_035781.1,42325273,42334922,42325273,42334922,111120303,XM_022461032.1,uncharacterized LOC111120303,9649
NC_035781.1,42480919,42483701,42480919,42483701,111120308,XM_022461036.1,uncharacterized LOC111120308,2782
NC_035780.1,51098155,51104117,51098155,51104117,111120313,XM_022461042.1,uncharacterized LOC111120313,5962
NC_035781.1,43394745,43402088,43394745,43402088,111120325,XM_022461047.1,uncharacterized LOC111120325,7343
NC_035781.1,43649563,43650688,43649563,43650688,111120327,XM_022461049.1,uncharacterized LOC111120327,1125
NC_035781.1,43677300,43684528,43677300,43684528,111120328,XM_022461051.1,uncharacterized LOC111120328,7228
NC_035781.1,43858183,43858663,43858183,43858663,111120329,XM_022461052.1,uncharacterized LOC111120329,480
NC_035781.1,43864544,43865514,43864544,43865514,111120330,XM_022461053.1,uncharacterized LOC111120330,970
NC_035781.1,44101651,44108347,44101651,44108347,111120331,XM_022461054.1,uncharacterized LOC111120331,6696
NC_035781.1,44503834,44504316,44503834,44504316,111120334,XM_022461057.1,uncharacterized LOC111120334,482
NC_035780.1,10838904,10840706,10838904,10840706,111120335,XM_022461061.1,uncharacterized LOC111120335,1802
NC_035781.1,44510150,44512042,44510150,44512042,111120336,XM_022461058.1,uncharacterized LOC111120336,1892
NC_035781.1,45061566,45062989,45061566,45062989,111120337,XM_022461059.1,uncharacterized LOC111120337,1423
NC_035781.1,45929710,45931364,45929710,45931364,111120343,XM_022461066.1,uncharacterized LOC111120343,1654
NC_035780.1,24857134,24863705,24857134,24863705,111120346,XM_022461070.1,uncharacterized LOC111120346,6571
NC_035781.1,46577686,46582272,46577686,46582272,111120348,XM_022461069.1,uncharacterized LOC111120348,4586
NC_035781.1,47280798,47281514,47280798,47281514,111120354,XM_022461075.1,uncharacterized LOC111120354,716
NC_035781.1,47803703,47804734,47803703,47804734,111120356,XM_022461078.1,uncharacterized LOC111120356,1031
NC_035781.1,48479225,48494268,48479225,48494268,111120359,XM_022461080.1,uncharacterized LOC111120359,15043
NC_035780.1,52488420,52492048,52488420,52492048,111120363,XM_022461092.1,uncharacterized LOC111120363,3628
NC_035781.1,49379407,49416827,49379407,49416827,111120366,XM_022461086.1,uncharacterized LOC111120366,37420
NC_035781.1,49980590,49985265,49980590,49985265,111120371,XM_022461091.1,uncharacterized LOC111120371,4675
NC_035781.1,51118796,51120681,51118796,51120681,111120378,XM_022461095.1,uncharacterized LOC111120378,1885
NC_035781.1,51147628,51150039,51147628,51150039,111120379,XM_022461096.1,uncharacterized LOC111120379,2411
NC_035780.1,63225811,63234255,63225811,63234255,111120381,XM_022461100.1,uncharacterized LOC111120381,8444
NC_035781.1,51216323,51223408,51216323,51223408,111120382,XM_022461098.1,uncharacterized LOC111120382,7085
NC_035781.1,51565280,51602155,51565280,51602155,111120384,XM_022461101.1,uncharacterized LOC111120384,36875
NC_035781.1,53827204,53831525,53827204,53831525,111120391,XM_022461107.1,uncharacterized LOC111120391,4321
NC_035781.1,53867320,53875374,53867320,53875374,111120392,XM_022461108.1,uncharacterized LOC111120392,8054
NC_035781.1,54027647,54033927,54027647,54033927,111120393,XM_022461109.1,uncharacterized LOC111120393,6280
NC_035781.1,54378656,54398104,54378656,54398104,111120394,XM_022461110.1,uncharacterized LOC111120394,19448
NC_035781.1,54733095,54734738,54733095,54734738,111120395,XM_022461111.1,uncharacterized LOC111120395,1643
NC_035781.1,54830767,54832913,54830767,54832913,111120396,XM_022461112.1,uncharacterized LOC111120396,2146
NC_035780.1,59710415,59713660,59710415,59713660,111120397,XM_022461115.1,uncharacterized LOC111120397,3245
NC_035781.1,55133063,55140150,55133063,55140150,111120399,XM_022461114.1,uncharacterized LOC111120399,7087
NC_035781.1,55385823,55395609,55385823,55395609,111120401,XM_022461116.1,uncharacterized LOC111120401,9786
NC_035781.1,55410480,55417114,55410480,55417114,111120402,XM_022461117.1,uncharacterized LOC111120402,6634
NC_035781.1,55435690,55487852,55435690,55487852,111120403,XM_022461118.1,uncharacterized LOC111120403,52162
NC_035781.1,55641314,55643086,55641314,55643086,111120405,XM_022461120.1,uncharacterized LOC111120405,1772
NC_035781.1,56136072,56143888,56136072,56143888,111120412,XM_022461127.1,uncharacterized LOC111120412,7816
NC_035781.1,56147494,56157337,56147494,56157337,111120413,XM_022461128.1,uncharacterized LOC111120413,9843
NC_035781.1,56414515,56436023,56414515,56436023,111120415,XM_022461130.1,uncharacterized LOC111120415,21508
NC_035781.1,56872927,56875130,56872927,56875130,111120419,XM_022461133.1,uncharacterized LOC111120419,2203
NC_035781.1,56887868,56888808,56887868,56888808,111120420,XM_022461134.1,uncharacterized LOC111120420,940
NC_035781.1,56924298,56926663,56924298,56926663,111120423,XM_022461136.1,uncharacterized LOC111120423,2365
NC_035781.1,57704342,57707575,57704342,57707575,111120425,XM_022461138.1,uncharacterized LOC111120425,3233
NC_035781.1,58256182,58263332,58256182,58263332,111120429,XM_022461143.1,uncharacterized LOC111120429,7150
NC_035781.1,58303196,58317872,58303196,58317872,111120430,XM_022461144.1,uncharacterized LOC111120430,14676
NC_035781.1,58337294,58339756,58337294,58339756,111120432,XM_022461146.1,uncharacterized LOC111120432,2462
NC_035781.1,58409857,58410426,58409857,58410426,111120434,XM_022461147.1,uncharacterized LOC111120434,569
NC_035781.1,58434890,58442044,58434890,58442044,111120435,XM_022461148.1,uncharacterized LOC111120435,7154
NC_035781.1,58438298,58463245,58438298,58463245,111120436,XM_022461149.1,uncharacterized LOC111120436,24947
NC_035780.1,27316140,27317790,27316140,27317790,111120440,XM_022461190.1,uncharacterized LOC111120440,1650
NC_035781.1,59319472,59323092,59319472,59323092,111120446,XM_022461158.1,uncharacterized LOC111120446,3620
NC_035781.1,59646723,59661739,59646723,59661739,111120447,XM_022461159.1,uncharacterized LOC111120447,15016
NC_035781.1,60040181,60041741,60040181,60041741,111120450,XM_022461162.1,uncharacterized LOC111120450,1560
NC_035781.1,60138811,60140021,60138811,60140021,111120453,XM_022461166.1,uncharacterized LOC111120453,1210
NC_035781.1,60146301,60149954,60146301,60149954,111120454,XM_022461167.1,uncharacterized LOC111120454,3653
NC_035781.1,60198077,60222234,60198077,60222234,111120456,XM_022461169.1,uncharacterized LOC111120456,24157
NC_035780.1,7748433,7759007,7748434,7759007,111120458,XM_022461182.1,uncharacterized LOC111120458,10573
NC_035780.1,7748433,7759007,7748433,7759007,111120458,XM_022461173.1,uncharacterized LOC111120458,10574
NC_035781.1,61452848,61454416,61452848,61454416,111120463,XM_022461175.1,uncharacterized LOC111120463,1568
NC_035781.1,61522516,61523202,61522516,61523202,111120464,XM_022461176.1,uncharacterized LOC111120464,686
NC_035781.1,61537735,61544990,61537735,61544990,111120465,XM_022461177.1,uncharacterized LOC111120465,7255
NC_035781.1,58156613,58209501,58177280,58209501,111120466,XM_022461181.1,uncharacterized LOC111120466,32221
NC_035781.1,58156613,58209501,58156613,58207047,111120466,XM_022461180.1,uncharacterized LOC111120466,50434
NC_035781.1,58156613,58209501,58156613,58209501,111120466,XM_022461178.1,uncharacterized LOC111120466,52888
NC_035781.1,24513891,24515425,24514031,24515404,111120470,XM_022461189.1,uncharacterized LOC111120470,1373
NC_035781.1,33007561,33024251,33010715,33024251,111120475,XM_022461199.1,uncharacterized LOC111120475,13536
NC_035781.1,33007561,33024251,33007561,33024251,111120475,XM_022461200.1,uncharacterized LOC111120475,16690
NC_035781.1,33008102,33013068,33008103,33009962,111120476,XM_022461201.1,uncharacterized LOC111120476,1859
NC_035781.1,33008102,33013068,33008104,33010138,111120476,XM_022461202.1,uncharacterized LOC111120476,2034
NC_035781.1,33008102,33013068,33008102,33013068,111120476,XM_022461203.1,uncharacterized LOC111120476,4966
NC_035781.1,4427906,4437581,4435574,4437581,111120497,XM_022461239.1,uncharacterized LOC111120497,2007
NC_035781.1,4427906,4437581,4431463,4437581,111120497,XM_022461242.1,uncharacterized LOC111120497,6118
NC_035781.1,4427906,4437581,4431236,4437581,111120497,XM_022461243.1,uncharacterized LOC111120497,6345
NC_035781.1,4427906,4437581,4430891,4437581,111120497,XM_022461240.1,uncharacterized LOC111120497,6690
NC_035781.1,4427906,4437581,4427906,4437581,111120497,XM_022461241.1,uncharacterized LOC111120497,9675
NC_035781.1,53451555,53456342,53451555,53456342,111120498,XM_022461244.1,uncharacterized LOC111120498,4787
NC_035781.1,23217301,23224634,23219045,23224634,111120510,XM_022461268.1,uncharacterized LOC111120510,5589
NC_035781.1,23217301,23224634,23218384,23224634,111120510,XM_022461269.1,uncharacterized LOC111120510,6250
NC_035781.1,23217301,23224634,23217301,23224634,111120510,XM_022461266.1,uncharacterized LOC111120510,7333
NC_035780.1,31922150,31927358,31922150,31927358,111120514,XM_022461324.1,uncharacterized LOC111120514,5208
NC_035780.1,31534611,31538096,31534611,31538096,111120516,XM_022461286.1,uncharacterized LOC111120516,3485
NC_035780.1,23127066,23129202,23127081,23129202,111120519,XM_022461310.1,uncharacterized LOC111120519,2121
NC_035780.1,23127066,23129202,23127066,23129202,111120519,XM_022461300.1,uncharacterized LOC111120519,2136
NC_035781.1,49958584,49979925,49958584,49979925,111120521,XM_022461299.1,uncharacterized LOC111120521,21341
NC_035781.1,27038639,27069474,27038639,27066232,111120524,XM_022461311.1,uncharacterized LOC111120524,27593
NC_035781.1,27038639,27069474,27038639,27066418,111120524,XM_022461306.1,uncharacterized LOC111120524,27779
NC_035781.1,27038639,27069474,27038639,27069255,111120524,XM_022461304.1,uncharacterized LOC111120524,30616
NC_035781.1,27038639,27069474,27038639,27069461,111120524,XM_022461308.1,uncharacterized LOC111120524,30822
NC_035781.1,27038639,27069474,27038639,27069470,111120524,XM_022461305.1,uncharacterized LOC111120524,30831
NC_035781.1,27038639,27069474,27038639,27069474,111120524,XM_022461307.1,uncharacterized LOC111120524,30835
NC_035781.1,14310319,14343604,14310319,14343604,111120526,XM_022461317.1,uncharacterized LOC111120526,33285
NC_035781.1,14467116,14472088,14467116,14472088,111120531,XM_022461325.1,uncharacterized LOC111120531,4972
NC_035781.1,14217050,14223134,14217051,14223134,111120532,XM_022461327.1,uncharacterized LOC111120532,6083
NC_035781.1,14217050,14223134,14217050,14223134,111120532,XM_022461326.1,uncharacterized LOC111120532,6084
NC_035780.1,35385492,35389226,35385492,35389226,111120560,XM_022461368.1,uncharacterized LOC111120560,3734
NC_035781.1,39188571,39210121,39188571,39210121,111120569,XM_022461374.1,uncharacterized LOC111120569,21550
NC_035781.1,39170522,39175940,39170522,39175940,111120571,XM_022461375.1,uncharacterized LOC111120571,5418
NC_035781.1,39177527,39180882,39177527,39180882,111120572,XM_022461376.1,uncharacterized LOC111120572,3355
NC_035781.1,53475347,53479334,53475347,53479334,111120576,XM_022461382.1,uncharacterized LOC111120576,3987
NC_035781.1,38662080,38667440,38662080,38667437,111120578,XM_022461385.1,uncharacterized LOC111120578,5357
NC_035781.1,38662080,38667440,38662080,38667440,111120578,XM_022461384.1,uncharacterized LOC111120578,5360
NC_035781.1,38659626,38660801,38659626,38660801,111120581,XM_022461389.1,uncharacterized LOC111120581,1175
NC_035781.1,40243433,40244958,40243433,40244958,111120586,XM_022461397.1,uncharacterized LOC111120586,1525
NC_035780.1,31918430,31951654,31929099,31951643,111120589,XM_022461621.1,uncharacterized LOC111120589,22544
NC_035780.1,31918430,31951654,31927601,31951643,111120589,XM_022461533.1,uncharacterized LOC111120589,24042
NC_035780.1,31918430,31951654,31927046,31951643,111120589,XM_022461449.1,uncharacterized LOC111120589,24597
NC_035780.1,31918430,31951654,31918430,31951654,111120589,XM_022461697.1,uncharacterized LOC111120589,33224
NC_035781.1,38083975,38094663,38083975,38094663,111120592,XM_022461405.1,uncharacterized LOC111120592,10688
NC_035781.1,38083975,38094663,38084974,38094663,111120592,XM_022461406.1,uncharacterized LOC111120592,9689
NC_035781.1,2616281,2621638,2616281,2621638,111120601,XM_022461445.1,uncharacterized LOC111120601,5357
NC_035781.1,40730165,40800174,40730165,40800174,111120604,XM_022461448.1,uncharacterized LOC111120604,70009
NC_035781.1,41236412,41248527,41236412,41248527,111120608,XM_022461452.1,uncharacterized LOC111120608,12115
NC_035781.1,29441137,29442921,29441137,29442921,111120611,XM_022461459.1,uncharacterized LOC111120611,1784
NC_035781.1,29445329,29448812,29445329,29448812,111120612,XM_022461460.1,uncharacterized LOC111120612,3483
NC_035781.1,29421920,29433172,29421920,29433172,111120613,XM_022461461.1,uncharacterized LOC111120613,11252
NC_035781.1,37855767,37894538,37855767,37894538,111120616,XM_022461464.1,uncharacterized LOC111120616,38771
NC_035781.1,650227,665578,650227,660656,111120617,XM_022461467.1,uncharacterized LOC111120617,10429
NC_035781.1,650227,665578,650227,661407,111120617,XM_022461468.1,uncharacterized LOC111120617,11180
NC_035781.1,650227,665578,650227,665578,111120617,XM_022461466.1,uncharacterized LOC111120617,15351
NC_035781.1,11026928,11028409,11026928,11028409,111120621,XM_022461473.1,uncharacterized LOC111120621,1481
NC_035780.1,48452481,48455421,48452481,48455106,111120622,XM_022461487.1,uncharacterized LOC111120622,2625
NC_035780.1,48452481,48455421,48452481,48455421,111120622,XM_022461477.1,uncharacterized LOC111120622,2940
NC_035781.1,25352130,25368695,25352130,25368695,111120623,XM_022461474.1,uncharacterized LOC111120623,16565
NC_035781.1,6570860,6577947,6570861,6577947,111120625,XM_022461479.1,uncharacterized LOC111120625,7086
NC_035781.1,6570860,6577947,6570860,6577947,111120625,XM_022461478.1,uncharacterized LOC111120625,7087
NC_035781.1,6599494,6634220,6599494,6634220,111120626,XM_022461481.1,uncharacterized LOC111120626,34726
NC_035781.1,6599494,6634220,6624928,6634220,111120626,XM_022461480.1,uncharacterized LOC111120626,9292
NC_035781.1,6599494,6634220,6599494,6609460,111120626,XM_022461484.1,uncharacterized LOC111120626,9966
NC_035781.1,22299502,22385483,22299528,22385483,111120629,XM_022461489.1,uncharacterized LOC111120629,85955
NC_035781.1,22299502,22385483,22299502,22385483,111120629,XM_022461488.1,uncharacterized LOC111120629,85981
NC_035781.1,61223113,61227918,61223113,61227918,111120631,XM_022461491.1,uncharacterized LOC111120631,4805
NC_035781.1,61205477,61207616,61205477,61207616,111120633,XM_022461493.1,uncharacterized LOC111120633,2139
NC_035780.1,9333963,9338256,9333963,9338256,111120635,XM_022461507.1,uncharacterized LOC111120635,4293
NC_035781.1,15476399,15482932,15476399,15482932,111120636,XM_022461497.1,uncharacterized LOC111120636,6533
NC_035781.1,15483074,15485660,15483074,15485660,111120638,XM_022461500.1,uncharacterized LOC111120638,2586
NC_035781.1,35295332,35305530,35295332,35305530,111120643,XM_022461510.1,uncharacterized LOC111120643,10198
NC_035781.1,1178921,1283552,1178921,1283552,111120650,XM_022461525.1,uncharacterized LOC111120650,104631
NC_035781.1,54238222,54252022,54238222,54252007,111120654,XM_022461528.1,uncharacterized LOC111120654,13785
NC_035781.1,54238222,54252022,54242587,54252022,111120654,XM_022461529.1,uncharacterized LOC111120654,9435
NC_035780.1,51634547,51646807,51634547,51646807,111120658,XM_022461549.1,uncharacterized LOC111120658,12260
NC_035780.1,48433892,48443793,48436296,48443793,111120669,XM_022461570.1,uncharacterized LOC111120669,7497
NC_035780.1,48433892,48443793,48433892,48443793,111120669,XM_022461578.1,uncharacterized LOC111120669,9901
NC_035781.1,2674762,2686141,2674762,2686141,111120670,XM_022461567.1,uncharacterized LOC111120670,11379
NC_035781.1,56672856,56675379,56672856,56675379,111120674,XM_022461573.1,uncharacterized LOC111120674,2523
NC_035781.1,55298001,55302850,55298799,55302850,111120689,XM_022461606.1,uncharacterized LOC111120689,4051
NC_035781.1,55298001,55302850,55298007,55302850,111120689,XM_022461607.1,uncharacterized LOC111120689,4843
NC_035781.1,55298001,55302850,55298001,55302850,111120689,XM_022461605.1,uncharacterized LOC111120689,4849
NC_035781.1,4754156,4773438,4754156,4773438,111120698,XM_022461618.1,uncharacterized LOC111120698,19282
NC_035781.1,9593264,9595634,9593264,9595634,111120702,XM_022461625.1,uncharacterized LOC111120702,2370
NC_035781.1,32916141,32918660,32916141,32918660,111120706,XM_022461631.1,uncharacterized LOC111120706,2519
NC_035781.1,32928643,32930449,32928643,32930449,111120707,XM_022461632.1,uncharacterized LOC111120707,1806
NC_035781.1,32898285,32899500,32898285,32899500,111120708,XM_022461633.1,uncharacterized LOC111120708,1215
NC_035781.1,32936522,32939066,32936522,32939066,111120709,XM_022461634.1,uncharacterized LOC111120709,2544
NC_035781.1,43768055,43772566,43768055,43772566,111120711,XM_022461636.1,uncharacterized LOC111120711,4511
NC_035781.1,31237516,31240160,31237516,31240160,111120715,XM_022461640.1,uncharacterized LOC111120715,2644
NC_035781.1,47949458,47953089,47949458,47953057,111120721,XM_022461648.1,uncharacterized LOC111120721,3599
NC_035781.1,47949458,47953089,47949458,47953089,111120721,XM_022461647.1,uncharacterized LOC111120721,3631
NC_035781.1,47953573,47973821,47953573,47973821,111120722,XM_022461649.1,uncharacterized LOC111120722,20248
NC_035781.1,50477917,50486405,50477917,50486405,111120735,XM_022461667.1,uncharacterized LOC111120735,8488
NC_035781.1,7256888,7269423,7256888,7269423,111120744,XM_022461681.1,uncharacterized LOC111120744,12535
NC_035781.1,41110523,41120458,41110532,41120458,111120749,XM_022461692.1,uncharacterized LOC111120749,9926
NC_035781.1,41110523,41120458,41110523,41120458,111120749,XM_022461686.1,uncharacterized LOC111120749,9935
NC_035781.1,41130220,41152152,41130220,41152152,111120750,XM_022461693.1,uncharacterized LOC111120750,21932
NC_035781.1,57657748,57668785,57657748,57668784,111120754,XM_022461696.1,uncharacterized LOC111120754,11036
NC_035781.1,57657748,57668785,57657748,57668785,111120754,XM_022461695.1,uncharacterized LOC111120754,11037
NC_035781.1,27753947,27765022,27753947,27765022,111120756,XM_022461699.1,uncharacterized LOC111120756,11075
NC_035781.1,20256279,20273418,20256279,20268031,111120759,XM_022461711.1,uncharacterized LOC111120759,11752
NC_035781.1,20256279,20273418,20256286,20268991,111120759,XM_022461714.1,uncharacterized LOC111120759,12705
NC_035781.1,20256279,20273418,20256279,20269012,111120759,XM_022461708.1,uncharacterized LOC111120759,12733
NC_035781.1,20256279,20273418,20256281,20271040,111120759,XM_022461707.1,uncharacterized LOC111120759,14759
NC_035781.1,20256279,20273418,20256290,20272198,111120759,XM_022461716.1,uncharacterized LOC111120759,15908
NC_035781.1,20256279,20273418,20256288,20272199,111120759,XM_022461713.1,uncharacterized LOC111120759,15911
NC_035781.1,20256279,20273418,20256283,20272201,111120759,XM_022461715.1,uncharacterized LOC111120759,15918
NC_035781.1,20256279,20273418,20256281,20272202,111120759,XM_022461702.1,uncharacterized LOC111120759,15921
NC_035781.1,20256279,20273418,20256279,20272203,111120759,XM_022461709.1,uncharacterized LOC111120759,15924
NC_035781.1,20256279,20273418,20256281,20272802,111120759,XM_022461705.1,uncharacterized LOC111120759,16521
NC_035781.1,20256279,20273418,20256281,20273418,111120759,XM_022461706.1,uncharacterized LOC111120759,17137
NC_035781.1,6674639,6683737,6674639,6683737,111120767,XM_022461727.1,uncharacterized LOC111120767,9098
NC_035781.1,45455813,45462125,45455813,45462125,111120779,XM_022461747.1,uncharacterized LOC111120779,6312
NC_035780.1,9917208,9922232,9917208,9922232,111120785,XM_022461756.1,uncharacterized LOC111120785,5024
NC_035781.1,37648740,37685392,37648740,37685392,111120792,XM_022461762.1,uncharacterized LOC111120792,36652
NC_035781.1,50174171,50178624,50174171,50178624,111120800,XM_022461774.1,uncharacterized LOC111120800,4453
NC_035780.1,13032745,13050419,13032745,13050419,111120802,XM_022461780.1,uncharacterized LOC111120802,17674
NC_035780.1,62427236,62442628,62427236,62437255,111120805,XM_022461902.1,uncharacterized LOC111120805,10019
NC_035780.1,62427236,62442628,62427236,62442627,111120805,XM_022462142.1,uncharacterized LOC111120805,15391
NC_035780.1,62427236,62442628,62427236,62442628,111120805,XM_022461820.1,uncharacterized LOC111120805,15392
NC_035780.1,62427236,62442628,62427236,62436075,111120805,XM_022462066.1,uncharacterized LOC111120805,8839
NC_035780.1,62427236,62442628,62427236,62436716,111120805,XM_022461986.1,uncharacterized LOC111120805,9480
NC_035781.1,50187501,50192583,50190833,50192583,111120806,XM_022461781.1,uncharacterized LOC111120806,1750
NC_035781.1,50187501,50192583,50187501,50192583,111120806,XM_022461782.1,uncharacterized LOC111120806,5082
NC_035781.1,54588932,54605921,54588932,54605921,111120814,XM_022461796.1,uncharacterized LOC111120814,16989
NC_035781.1,41787654,41802758,41791531,41802758,111120832,XM_022461822.1,uncharacterized LOC111120832,11227
NC_035781.1,41787654,41802758,41787654,41802758,111120832,XM_022461823.1,uncharacterized LOC111120832,15104
NC_035781.1,41787654,41802758,41793971,41802755,111120832,XM_022461824.1,uncharacterized LOC111120832,8784
NC_035781.1,23538119,23540337,23538119,23540337,111120837,XM_022461830.1,uncharacterized LOC111120837,2218
NC_035781.1,23535809,23538006,23535809,23538006,111120838,XM_022461831.1,uncharacterized LOC111120838,2197
NC_035781.1,47773993,47778885,47773993,47778885,111120841,XM_022461836.1,uncharacterized LOC111120841,4892
NC_035781.1,47759176,47765722,47759176,47760621,111120844,XM_022461840.1,uncharacterized LOC111120844,1445
NC_035781.1,47759176,47765722,47759176,47765722,111120844,XM_022461841.1,uncharacterized LOC111120844,6546
NC_035781.1,24536024,24540636,24536024,24540636,111120867,XM_022461875.1,uncharacterized LOC111120867,4612
NC_035780.1,43318827,43321132,43318827,43320343,111120870,XM_022461897.1,uncharacterized LOC111120870,1516
NC_035780.1,43318827,43321132,43318827,43320456,111120870,XM_022461890.1,uncharacterized LOC111120870,1629
NC_035780.1,43318827,43321132,43318827,43321132,111120870,XM_022461882.1,uncharacterized LOC111120870,2305
NC_035781.1,36410607,36412647,36410607,36412647,111120894,XM_022461915.1,uncharacterized LOC111120894,2040
NC_035781.1,39223910,39229008,39223910,39229008,111120895,XM_022461916.1,uncharacterized LOC111120895,5098
NC_035781.1,50727654,50733933,50727654,50733933,111120898,XM_022461921.1,uncharacterized LOC111120898,6279
NC_035781.1,24299131,24316479,24299131,24316479,111120916,XM_022461959.1,uncharacterized LOC111120916,17348
NC_035781.1,24299131,24316479,24311533,24316479,111120916,XM_022461961.1,uncharacterized LOC111120916,4946
NC_035781.1,24299131,24316479,24309291,24316479,111120916,XM_022461960.1,uncharacterized LOC111120916,7188
NC_035781.1,17176866,17178915,17176866,17178915,111120919,XM_022461963.1,uncharacterized LOC111120919,2049
NC_035780.1,18170592,18173431,18170592,18173431,111120923,XM_022461978.1,uncharacterized LOC111120923,2839
NC_035781.1,24269110,24280370,24277425,24280370,111120924,XM_022461977.1,uncharacterized LOC111120924,2945
NC_035781.1,24269110,24280370,24273094,24278221,111120924,XM_022461975.1,uncharacterized LOC111120924,5127
NC_035781.1,24269110,24280370,24269110,24278221,111120924,XM_022461976.1,uncharacterized LOC111120924,9111
NC_035781.1,49864661,49866650,49864661,49866650,111120928,XM_022461982.1,uncharacterized LOC111120928,1989
NC_035781.1,7666925,7669665,7666925,7669665,111120930,XM_022461984.1,uncharacterized LOC111120930,2740
NC_035781.1,7660368,7662370,7660368,7662370,111120931,XM_022461985.1,uncharacterized LOC111120931,2002
NC_035781.1,13381128,13384215,13381128,13384215,111120945,XM_022462004.1,uncharacterized LOC111120945,3087
NC_035781.1,8864900,8867471,8864900,8867471,111120948,XM_022462007.1,uncharacterized LOC111120948,2571
NC_035781.1,51160645,51173218,51160645,51173218,111120949,XM_022462008.1,uncharacterized LOC111120949,12573
NC_035781.1,35610716,35618270,35610716,35615418,111120950,XM_022462013.1,uncharacterized LOC111120950,4702
NC_035781.1,35610716,35618270,35610716,35615602,111120950,XM_022462012.1,uncharacterized LOC111120950,4886
NC_035781.1,35610716,35618270,35610716,35615804,111120950,XM_022462011.1,uncharacterized LOC111120950,5088
NC_035781.1,35610716,35618270,35610716,35615997,111120950,XM_022462015.1,uncharacterized LOC111120950,5281
NC_035781.1,35610716,35618270,35610716,35617188,111120950,XM_022462009.1,uncharacterized LOC111120950,6472
NC_035781.1,35610716,35618270,35610716,35618270,111120950,XM_022462010.1,uncharacterized LOC111120950,7554
NC_035781.1,33096213,33114537,33096213,33114537,111120953,XM_022462018.1,uncharacterized LOC111120953,18324
NC_035781.1,30536864,30538544,30536864,30538544,111120957,XM_022462022.1,uncharacterized LOC111120957,1680
NC_035780.1,35297034,35304382,35297034,35304382,111120958,XM_022462026.1,uncharacterized LOC111120958,7348
NC_035781.1,35206954,35209566,35206954,35209566,111120959,XM_022462023.1,uncharacterized LOC111120959,2612
NC_035781.1,9587818,9591105,9587818,9591105,111120968,XM_022462041.1,uncharacterized LOC111120968,3287
NC_035781.1,59640864,59642447,59640864,59642447,111120977,XM_022462053.1,uncharacterized LOC111120977,1583
NC_035781.1,13529501,13532628,13529501,13532628,111120980,XM_022462060.1,uncharacterized LOC111120980,3127
NC_035781.1,50345461,50348808,50345461,50348808,111120982,XM_022462062.1,uncharacterized LOC111120982,3347
NC_035781.1,35190264,35203420,35190264,35203420,111121000,XM_022462081.1,uncharacterized LOC111121000,13156
NC_035781.1,44518982,44520575,44518983,44520563,111121002,XM_022462083.1,uncharacterized LOC111121002,1580
NC_035781.1,44518982,44520575,44518982,44520575,111121002,XM_022462084.1,uncharacterized LOC111121002,1593
NC_035781.1,10160243,10164112,10160243,10164112,111121004,XM_022462086.1,uncharacterized LOC111121004,3869
NC_035781.1,11103941,11107497,11103941,11107438,111121014,XM_022462097.1,uncharacterized LOC111121014,3497
NC_035781.1,11103941,11107497,11103941,11107497,111121014,XM_022462098.1,uncharacterized LOC111121014,3556
NC_035781.1,51765304,51773684,51765304,51773684,111121018,XM_022462106.1,uncharacterized LOC111121018,8380
NC_035781.1,51612019,51625972,51612019,51625972,111121025,XM_022462116.1,uncharacterized LOC111121025,13953
NC_035781.1,51426050,51448778,51426050,51448778,111121026,XM_022462117.1,uncharacterized LOC111121026,22728
NC_035781.1,51492022,51496182,51492022,51495411,111121031,XM_022462131.1,uncharacterized LOC111121031,3389
NC_035781.1,51492022,51496182,51492022,51496182,111121031,XM_022462132.1,uncharacterized LOC111121031,4160
NC_035781.1,51679832,51683963,51679832,51683183,111121032,XM_022462133.1,uncharacterized LOC111121032,3351
NC_035781.1,51679832,51683963,51679832,51683963,111121032,XM_022462134.1,uncharacterized LOC111121032,4131
NC_035781.1,51669720,51676402,51669720,51676402,111121036,XM_022462138.1,uncharacterized LOC111121036,6682
NC_035781.1,51486212,51488424,51486212,51488424,111121037,XM_022462139.1,uncharacterized LOC111121037,2212
NC_035781.1,8790996,8792131,8790996,8792131,111121043,XM_022462144.1,uncharacterized LOC111121043,1135
NC_035781.1,39634327,39639462,39634327,39639462,111121046,XM_022462147.1,uncharacterized LOC111121046,5135
NC_035781.1,39619261,39633944,39619261,39633944,111121047,XM_022462148.1,uncharacterized LOC111121047,14683
NC_035780.1,663525,671754,663525,671754,111121058,XM_022462163.1,uncharacterized LOC111121058,8229
NC_035781.1,25455619,25464236,25455619,25464236,111121061,XM_022462164.1,uncharacterized LOC111121061,8617
NC_035781.1,25469944,25488389,25469944,25488389,111121062,XM_022462165.1,uncharacterized LOC111121062,18445
NC_035781.1,59769782,59776693,59769782,59775701,111121070,XM_022462183.1,uncharacterized LOC111121070,5919
NC_035781.1,59769782,59776693,59769782,59776693,111121070,XM_022462184.1,uncharacterized LOC111121070,6911
NC_035781.1,44432506,44436367,44432506,44436367,111121079,XM_022462204.1,uncharacterized LOC111121079,3861
NC_035781.1,41695463,41703311,41695463,41703311,111121081,XM_022462206.1,uncharacterized LOC111121081,7848
NC_035781.1,29918305,29924148,29918305,29924148,111121091,XM_022462217.1,uncharacterized LOC111121091,5843
NC_035781.1,11223804,11231482,11223804,11231482,111121093,XM_022462218.1,uncharacterized LOC111121093,7678
NC_035780.1,34388988,34396443,34388988,34396443,111121102,XM_022462232.1,uncharacterized LOC111121102,7455
NC_035780.1,34390439,34392288,34391269,34392288,111121112,XM_022462251.1,uncharacterized LOC111121112,1019
NC_035780.1,34390439,34392288,34390439,34392288,111121112,XM_022462243.1,uncharacterized LOC111121112,1849
NC_035781.1,5398927,5402718,5398927,5402718,111121121,XM_022462250.1,uncharacterized LOC111121121,3791
NC_035781.1,17037082,17042770,17037082,17042770,111121123,XM_022462255.1,uncharacterized LOC111121123,5688
NC_035781.1,7376527,7379105,7377982,7379105,111121124,XM_022462256.1,uncharacterized LOC111121124,1123
NC_035781.1,2811318,2815797,2811318,2815755,111121125,XM_022462258.1,uncharacterized LOC111121125,4437
NC_035781.1,2811318,2815797,2811318,2815797,111121125,XM_022462257.1,uncharacterized LOC111121125,4479
NC_035781.1,61710855,61716769,61710855,61716769,111121132,XM_022462269.1,uncharacterized LOC111121132,5914
NC_035781.1,17511572,17521280,17511572,17521280,111121142,XM_022462287.1,uncharacterized LOC111121142,9708
NC_035781.1,13365418,13370960,13365418,13370960,111121145,XM_022462290.1,uncharacterized LOC111121145,5542
NC_035781.1,56444267,56448422,56444267,56448422,111121149,XM_022462295.1,uncharacterized LOC111121149,4155
NC_035781.1,28815464,28827998,28815464,28827998,111121151,XM_022462296.1,uncharacterized LOC111121151,12534
NC_035781.1,11471967,11492274,11472262,11492274,111121152,XM_022462299.1,uncharacterized LOC111121152,20012
NC_035781.1,11471967,11492274,11471967,11492274,111121152,XM_022462297.1,uncharacterized LOC111121152,20307
NC_035781.1,15280764,15287060,15280764,15287060,111121156,XM_022462302.1,uncharacterized LOC111121156,6296
NC_035781.1,27628581,27645589,27628583,27645589,111121159,XM_022462308.1,uncharacterized LOC111121159,17006
NC_035781.1,27628581,27645589,27628581,27645589,111121159,XM_022462307.1,uncharacterized LOC111121159,17008
NC_035781.1,27621452,27628562,27621452,27628562,111121160,XM_022462309.1,uncharacterized LOC111121160,7110
NC_035781.1,48078607,48080460,48078607,48080460,111121163,XM_022462313.1,uncharacterized LOC111121163,1853
NC_035781.1,5123987,5130872,5123987,5130872,111121168,XM_022462319.1,uncharacterized LOC111121168,6885
NC_035780.1,45275937,45281440,45276008,45281440,111121176,XM_022462343.1,uncharacterized LOC111121176,5432
NC_035780.1,45275937,45281440,45275937,45281439,111121176,XM_022462336.1,uncharacterized LOC111121176,5502
NC_035781.1,8896799,8900041,8896799,8900041,111121179,XM_022462337.1,uncharacterized LOC111121179,3242
NC_035781.1,17058944,17060409,17058944,17060409,111121182,XM_022462340.1,uncharacterized LOC111121182,1465
NC_035780.1,19019451,19022153,19019451,19022153,111121183,XM_022462744.1,uncharacterized LOC111121183,2702
NC_035781.1,55324862,55333481,55324862,55333481,111121190,XM_022462346.1,uncharacterized LOC111121190,8619
NC_035781.1,20045583,20057924,20045583,20057924,111121191,XM_022462348.1,uncharacterized LOC111121191,12341
NC_035781.1,20045583,20057924,20045583,20053383,111121191,XM_022462347.1,uncharacterized LOC111121191,7800
NC_035780.1,49889529,49903204,49889529,49903204,111121193,XM_022462361.1,uncharacterized LOC111121193,13675
NC_035781.1,57936228,57938779,57936228,57938779,111121198,XM_022462356.1,uncharacterized LOC111121198,2551
NC_035781.1,6611488,6613818,6611488,6613818,111121202,XM_022462360.1,uncharacterized LOC111121202,2330
NC_035781.1,54862640,54865911,54862640,54865911,111121203,XM_022462362.1,uncharacterized LOC111121203,3271
NC_035781.1,58958046,58961950,58958046,58959623,111121204,XM_022462364.1,uncharacterized LOC111121204,1577
NC_035781.1,58958046,58961950,58958046,58961950,111121204,XM_022462363.1,uncharacterized LOC111121204,3904
NC_035781.1,42244348,42247596,42244348,42247596,111121208,XM_022462368.1,uncharacterized LOC111121208,3248
NC_035780.1,49871801,49886560,49871801,49886560,111121214,XM_022462390.1,uncharacterized LOC111121214,14759
NC_035781.1,48043760,48046199,48043760,48046199,111121219,XM_022462384.1,uncharacterized LOC111121219,2439
NC_035781.1,22290855,22295930,22290855,22295930,111121221,XM_022462388.1,uncharacterized LOC111121221,5075
NC_035781.1,50329927,50332963,50329927,50331922,111121223,XM_022462392.1,uncharacterized LOC111121223,1995
NC_035781.1,50329927,50332963,50329927,50332755,111121223,XM_022462391.1,uncharacterized LOC111121223,2828
NC_035781.1,50329927,50332963,50329927,50332963,111121223,XM_022462393.1,uncharacterized LOC111121223,3036
NC_035781.1,26378432,26379053,26378432,26379053,111121233,XM_022462404.1,uncharacterized LOC111121233,621
NC_035780.1,47333621,47336192,47333621,47336192,111121240,XM_022462417.1,uncharacterized LOC111121240,2571
NC_035781.1,24283659,24290421,24283659,24290421,111121241,XM_022462414.1,uncharacterized LOC111121241,6762
NC_035781.1,17187988,17189722,17187988,17189722,111121243,XM_022462415.1,uncharacterized LOC111121243,1734
NC_035781.1,46593257,46597944,46593257,46597944,111121245,XM_022462419.1,uncharacterized LOC111121245,4687
NC_035781.1,46181072,46186424,46181072,46186424,111121246,XM_022462420.1,uncharacterized LOC111121246,5352
NC_035781.1,46175910,46182396,46175910,46182388,111121247,XM_022462421.1,uncharacterized LOC111121247,6478
NC_035781.1,46175910,46182396,46175910,46182396,111121247,XM_022462422.1,uncharacterized LOC111121247,6486
NC_035781.1,9319365,9331943,9319365,9331943,111121255,XM_022462430.1,uncharacterized LOC111121255,12578
NC_035781.1,10172724,10175957,10172724,10175957,111121256,XM_022462431.1,uncharacterized LOC111121256,3233
NC_035781.1,20880298,20893762,20880298,20893751,111121257,XM_022462434.1,uncharacterized LOC111121257,13453
NC_035781.1,20880298,20893762,20880298,20893754,111121257,XM_022462436.1,uncharacterized LOC111121257,13456
NC_035781.1,20880298,20893762,20880298,20893762,111121257,XM_022462435.1,uncharacterized LOC111121257,13464
NC_035781.1,20880298,20893762,20880298,20883683,111121257,XM_022462438.1,uncharacterized LOC111121257,3385
NC_035781.1,20880298,20893762,20880298,20883813,111121257,XM_022462437.1,uncharacterized LOC111121257,3515
NC_035781.1,20880298,20893762,20880298,20885257,111121257,XM_022462432.1,uncharacterized LOC111121257,4959
NC_035780.1,42486546,42509612,42486546,42509612,111121258,XM_022462441.1,uncharacterized LOC111121258,23066
NC_035781.1,39473812,39482665,39478469,39482665,111121261,XM_022462444.1,uncharacterized LOC111121261,4196
NC_035781.1,39473812,39482665,39476544,39482665,111121261,XM_022462442.1,uncharacterized LOC111121261,6121
NC_035781.1,39473812,39482665,39473812,39482665,111121261,XM_022462443.1,uncharacterized LOC111121261,8853
NC_035781.1,34558103,34569593,34558103,34568136,111121265,XM_022462454.1,uncharacterized LOC111121265,10033
NC_035781.1,34558103,34569593,34558103,34568582,111121265,XM_022462452.1,uncharacterized LOC111121265,10479
NC_035781.1,34558103,34569593,34558103,34569593,111121265,XM_022462451.1,uncharacterized LOC111121265,11490
NC_035781.1,34558103,34569593,34558103,34568032,111121265,XM_022462453.1,uncharacterized LOC111121265,9929
NC_035781.1,39022519,39030300,39022519,39030298,111121269,XM_022462458.1,uncharacterized LOC111121269,7779
NC_035781.1,39022519,39030300,39022519,39030300,111121269,XM_022462460.1,uncharacterized LOC111121269,7781
NC_035780.1,6457204,6460225,6457204,6460225,111121270,XM_022462464.1,uncharacterized LOC111121270,3021
NC_035781.1,8869194,8871491,8869194,8871491,111121272,XM_022462462.1,uncharacterized LOC111121272,2297
NC_035781.1,7467536,7473552,7467536,7473552,111121274,XM_022462468.1,uncharacterized LOC111121274,6016
NC_035781.1,50513755,50514443,50513755,50514443,111121276,XM_022462470.1,uncharacterized LOC111121276,688
NC_035780.1,47941571,47967118,47951038,47967118,111121278,XM_022462501.1,uncharacterized LOC111121278,16080
NC_035780.1,47941571,47967118,47950134,47967118,111121278,XM_022462484.1,uncharacterized LOC111121278,16984
NC_035780.1,47941571,47967118,47949988,47967118,111121278,XM_022462493.1,uncharacterized LOC111121278,17130
NC_035780.1,47941571,47967118,47941571,47967118,111121278,XM_022462477.1,uncharacterized LOC111121278,25547
NC_035781.1,41719542,41721372,41719542,41721372,111121284,XM_022462481.1,uncharacterized LOC111121284,1830
NC_035781.1,60409107,60414474,60409107,60414474,111121286,XM_022462483.1,uncharacterized LOC111121286,5367
NC_035781.1,15501804,15527277,15501804,15527277,111121287,XM_022462485.1,uncharacterized LOC111121287,25473
NC_035781.1,52295422,52304355,52295423,52304354,111121292,XM_022462496.1,uncharacterized LOC111121292,8931
NC_035781.1,52295422,52304355,52295422,52304355,111121292,XM_022462495.1,uncharacterized LOC111121292,8933
NC_035781.1,11756621,11758217,11756621,11758217,111121294,XM_022462498.1,uncharacterized LOC111121294,1596
NC_035781.1,49887243,49889531,49887243,49889531,111121295,XM_022462499.1,uncharacterized LOC111121295,2288
NC_035781.1,7432410,7461553,7437816,7461553,111121296,XM_022462502.1,uncharacterized LOC111121296,23737
NC_035781.1,7432410,7461553,7433256,7461553,111121296,XM_022462504.1,uncharacterized LOC111121296,28297
NC_035781.1,7432410,7461553,7432693,7461553,111121296,XM_022462505.1,uncharacterized LOC111121296,28860
NC_035781.1,7432410,7461553,7432552,7461553,111121296,XM_022462503.1,uncharacterized LOC111121296,29001
NC_035781.1,7432410,7461553,7432410,7461553,111121296,XM_022462500.1,uncharacterized LOC111121296,29143
NC_035781.1,15859165,15861849,15859165,15861849,111121298,XM_022462511.1,uncharacterized LOC111121298,2684
NC_035780.1,38134758,38144734,38134758,38144734,111121299,XM_022462513.1,uncharacterized LOC111121299,9976
NC_035781.1,15381552,15414527,15381552,15414527,111121302,XM_022462514.1,uncharacterized LOC111121302,32975
NC_035781.1,20289604,20293175,20289604,20292436,111121305,XM_022462518.1,uncharacterized LOC111121305,2832
NC_035781.1,20289604,20293175,20289604,20293175,111121305,XM_022462519.1,uncharacterized LOC111121305,3571
NC_035781.1,21660958,21663038,21660958,21663038,111121314,XM_022462529.1,uncharacterized LOC111121314,2080
NC_035781.1,5364804,5382844,5364804,5382844,111121315,XM_022462530.1,uncharacterized LOC111121315,18040
NC_035781.1,17046004,17047967,17046004,17047967,111121316,XM_022462531.1,uncharacterized LOC111121316,1963
NC_035781.1,17476673,17484956,17476673,17484956,111121317,XM_022462533.1,uncharacterized LOC111121317,8283
NC_035781.1,59688080,59711516,59688080,59704420,111121323,XM_022462549.1,uncharacterized LOC111121323,16340
NC_035781.1,59688080,59711516,59688080,59705615,111121323,XM_022462548.1,uncharacterized LOC111121323,17535
NC_035781.1,59688080,59711516,59688080,59711508,111121323,XM_022462546.1,uncharacterized LOC111121323,23428
NC_035781.1,59688080,59711516,59688080,59711516,111121323,XM_022462544.1,uncharacterized LOC111121323,23436
NC_035781.1,9479158,9480649,9479158,9480649,111121328,XM_022462556.1,uncharacterized LOC111121328,1491
NC_035781.1,30050484,30053433,30050484,30053433,111121329,XM_022462557.1,uncharacterized LOC111121329,2949
NC_035781.1,48119608,48122813,48119608,48122813,111121330,XM_022462558.1,uncharacterized LOC111121330,3205
NC_035781.1,55142775,55146682,55142775,55146525,111121331,XM_022462560.1,uncharacterized LOC111121331,3750
NC_035781.1,55142775,55146682,55142775,55146682,111121331,XM_022462561.1,uncharacterized LOC111121331,3907
NC_035781.1,24346708,24350331,24346708,24350323,111121339,XM_022462571.1,uncharacterized LOC111121339,3615
NC_035781.1,24346708,24350331,24346708,24350328,111121339,XM_022462573.1,uncharacterized LOC111121339,3620
NC_035781.1,24346708,24350331,24346708,24350331,111121339,XM_022462572.1,uncharacterized LOC111121339,3623
NC_035781.1,56691085,56693748,56691085,56693748,111121344,XM_022462578.1,uncharacterized LOC111121344,2663
NC_035781.1,30979427,30982480,30979427,30982480,111121345,XM_022462579.1,uncharacterized LOC111121345,3053
NC_035781.1,17194251,17196201,17194251,17196201,111121350,XM_022462585.1,uncharacterized LOC111121350,1950
NC_035781.1,3944906,3967408,3944906,3967408,111121353,XM_022462588.1,uncharacterized LOC111121353,22502
NC_035781.1,3986468,4001650,3986475,4001650,111121354,XM_022462592.1,uncharacterized LOC111121354,15175
NC_035781.1,3986468,4001650,3986468,4001650,111121354,XM_022462591.1,uncharacterized LOC111121354,15182
NC_035781.1,47562210,47573695,47562627,47573695,111121356,XM_022462596.1,uncharacterized LOC111121356,11068
NC_035781.1,47562210,47573695,47562210,47573695,111121356,XM_022462594.1,uncharacterized LOC111121356,11485
NC_035781.1,47562210,47573695,47562211,47571038,111121356,XM_022462595.1,uncharacterized LOC111121356,8827
NC_035781.1,6889525,6893968,6889525,6893935,111121359,XM_022462611.1,uncharacterized LOC111121359,4410
NC_035781.1,6889525,6893968,6889525,6893968,111121359,XM_022462612.1,uncharacterized LOC111121359,4443
NC_035781.1,30967863,30979173,30967863,30979173,111121363,XM_022462616.1,uncharacterized LOC111121363,11310
NC_035781.1,30967863,30979173,30967863,30975409,111121363,XM_022462619.1,uncharacterized LOC111121363,7546
NC_035781.1,30967863,30979173,30967863,30976858,111121363,XM_022462617.1,uncharacterized LOC111121363,8995
NC_035781.1,20242016,20250757,20242016,20250757,111121367,XM_022462624.1,uncharacterized LOC111121367,8741
NC_035780.1,19327362,19332333,19328697,19332333,111121381,XM_022462659.1,uncharacterized LOC111121381,3636
NC_035780.1,19327362,19332333,19328612,19332333,111121381,XM_022462667.1,uncharacterized LOC111121381,3721
NC_035780.1,19327362,19332333,19327362,19332333,111121381,XM_022462651.1,uncharacterized LOC111121381,4971
NC_035781.1,59172411,59180891,59172411,59180887,111121383,XM_022462650.1,uncharacterized LOC111121383,8476
NC_035781.1,59172411,59180891,59172411,59180891,111121383,XM_022462649.1,uncharacterized LOC111121383,8480
NC_035781.1,45239434,45242981,45239434,45242981,111121385,XM_022462653.1,uncharacterized LOC111121385,3547
NC_035781.1,41932242,41941184,41932242,41941184,111121388,XM_022462655.1,uncharacterized LOC111121388,8942
NC_035781.1,55979902,55986303,55979902,55986303,111121389,XM_022462657.1,uncharacterized LOC111121389,6401
NC_035781.1,10997751,11005127,10997751,11005127,111121393,XM_022462662.1,uncharacterized LOC111121393,7376
NC_035781.1,57491320,57500557,57491320,57500557,111121394,XM_022462663.1,uncharacterized LOC111121394,9237
NC_035781.1,48964915,48979885,48965490,48979885,111121395,XM_022462665.1,uncharacterized LOC111121395,14395
NC_035781.1,48964915,48979885,48964915,48979844,111121395,XM_022462666.1,uncharacterized LOC111121395,14929
NC_035781.1,48964915,48979885,48964915,48979885,111121395,XM_022462664.1,uncharacterized LOC111121395,14970
NC_035781.1,7673799,7677371,7673799,7676396,111121396,XM_022462668.1,uncharacterized LOC111121396,2597
NC_035781.1,7673799,7677371,7673799,7677371,111121396,XM_022462669.1,uncharacterized LOC111121396,3572
NC_035781.1,17116588,17118314,17116588,17118314,111121399,XM_022462672.1,uncharacterized LOC111121399,1726
NC_035781.1,58793576,58799915,58793576,58799253,111121401,XM_022462675.1,uncharacterized LOC111121401,5677
NC_035781.1,58793576,58799915,58793576,58799915,111121401,XM_022462676.1,uncharacterized LOC111121401,6339
NC_035781.1,34290756,34291940,34290756,34291940,111121403,XM_022462677.1,uncharacterized LOC111121403,1184
NC_035781.1,4331240,4333386,4331240,4333386,111121407,XM_022462686.1,uncharacterized LOC111121407,2146
NC_035781.1,18505166,18512785,18505166,18512785,111121410,XM_022462689.1,uncharacterized LOC111121410,7619
NC_035781.1,54305775,54326934,54306055,54326934,111121411,XM_022462690.1,uncharacterized LOC111121411,20879
NC_035781.1,54305775,54326934,54305775,54326934,111121411,XM_022462691.1,uncharacterized LOC111121411,21159
NC_035781.1,11935416,11946986,11935416,11946984,111121412,XM_022462694.1,uncharacterized LOC111121412,11568
NC_035781.1,11935416,11946986,11935416,11946985,111121412,XM_022462693.1,uncharacterized LOC111121412,11569
NC_035781.1,11935416,11946986,11935416,11946986,111121412,XM_022462692.1,uncharacterized LOC111121412,11570
NC_035781.1,5267191,5272040,5267191,5272040,111121413,XM_022462695.1,uncharacterized LOC111121413,4849
NC_035781.1,11120871,11125460,11120871,11125460,111121424,XM_022462710.1,uncharacterized LOC111121424,4589
NC_035781.1,738539,742301,738539,742301,111121426,XM_022462712.1,uncharacterized LOC111121426,3762
NC_035781.1,42106861,42118253,42106875,42118253,111121430,XM_022462720.1,uncharacterized LOC111121430,11378
NC_035781.1,42106861,42118253,42106873,42118253,111121430,XM_022462718.1,uncharacterized LOC111121430,11380
NC_035781.1,42106861,42118253,42106861,42118253,111121430,XM_022462719.1,uncharacterized LOC111121430,11392
NC_035781.1,24610253,24620343,24610253,24620343,111121433,XM_022462722.1,uncharacterized LOC111121433,10090
NC_035781.1,56503644,56513427,56503644,56513427,111121434,XM_022462723.1,uncharacterized LOC111121434,9783
NC_035781.1,43886694,43893257,43886694,43893257,111121445,XM_022462737.1,uncharacterized LOC111121445,6563
NC_035780.1,34272828,34279085,34272828,34279085,111121446,XM_022462740.1,uncharacterized LOC111121446,6257
NC_035781.1,53740631,53748361,53740631,53748361,111121448,XM_022462742.1,uncharacterized LOC111121448,7730
NC_035781.1,55124115,55130434,55124115,55130434,111121451,XM_022462745.1,uncharacterized LOC111121451,6319
NC_035781.1,8727114,8732424,8727114,8732424,111121455,XM_022462750.1,uncharacterized LOC111121455,5310
NC_035781.1,9782694,9791995,9782694,9791959,111121458,XM_022462753.1,uncharacterized LOC111121458,9265
NC_035781.1,9782694,9791995,9782694,9791995,111121458,XM_022462752.1,uncharacterized LOC111121458,9301
NC_035781.1,18541167,18551756,18541167,18551756,111121459,XM_022462754.1,uncharacterized LOC111121459,10589
NC_035781.1,1394688,1411440,1394688,1411440,111121461,XM_022462757.1,uncharacterized LOC111121461,16752
NC_035781.1,58281636,58291247,58281636,58291247,111121463,XM_022462758.1,uncharacterized LOC111121463,9611
NC_035781.1,29450878,29453068,29450878,29453068,111121464,XM_022462759.1,uncharacterized LOC111121464,2190
NC_035781.1,53648751,53656010,53648766,53656010,111121465,XM_022462760.1,uncharacterized LOC111121465,7244
NC_035781.1,53648751,53656010,53648751,53656010,111121465,XM_022462761.1,uncharacterized LOC111121465,7259
NC_035781.1,17169136,17173729,17169136,17173729,111121466,XM_022462762.1,uncharacterized LOC111121466,4593
NC_035780.1,28120247,28131591,28120247,28131591,111121467,XM_022462766.1,uncharacterized LOC111121467,11344
NC_035781.1,823084,826493,823084,826334,111121471,XM_022462768.1,uncharacterized LOC111121471,3250
NC_035781.1,823084,826493,823084,826336,111121471,XM_022462770.1,uncharacterized LOC111121471,3252
NC_035781.1,823084,826493,823084,826493,111121471,XM_022462769.1,uncharacterized LOC111121471,3409
NC_035781.1,14948009,14977103,14948009,14977103,111121472,XM_022462771.1,uncharacterized LOC111121472,29094
NC_035781.1,443637,445568,443637,445568,111121474,XM_022462772.1,uncharacterized LOC111121474,1931
NC_035781.1,39368512,39375276,39368512,39375276,111121475,XM_022462773.1,uncharacterized LOC111121475,6764
NC_035780.1,4749521,4779422,4749521,4779422,111121476,XM_022462777.1,uncharacterized LOC111121476,29901
NC_035781.1,39040001,39053350,39040001,39053350,111121479,XM_022462779.1,uncharacterized LOC111121479,13349
NC_035781.1,39040001,39053350,39049620,39053350,111121479,XM_022462778.1,uncharacterized LOC111121479,3730
NC_035781.1,54345914,54364257,54346402,54364257,111121483,XM_022462785.1,uncharacterized LOC111121483,17855
NC_035781.1,54345914,54364257,54345914,54364256,111121483,XM_022462786.1,uncharacterized LOC111121483,18342
NC_035781.1,54345914,54364257,54345914,54364257,111121483,XM_022462784.1,uncharacterized LOC111121483,18343
NC_035781.1,30902212,30907224,30902212,30907224,111121485,XM_022462789.1,uncharacterized LOC111121485,5012
NC_035780.1,5170006,5210712,5170006,5210712,111121491,XM_022462798.1,uncharacterized LOC111121491,40706
NC_035781.1,17729482,17759547,17748367,17759547,111121498,XM_022462802.1,uncharacterized LOC111121498,11180
NC_035781.1,17729482,17759547,17729482,17759547,111121498,XM_022462803.1,uncharacterized LOC111121498,30065
NC_035780.1,4959372,4991977,4959372,4991977,111121500,XM_022462808.1,uncharacterized LOC111121500,32605
NC_035781.1,39722345,39725158,39722345,39725158,111121502,XM_022462806.1,uncharacterized LOC111121502,2813
NC_035781.1,51211930,51213906,51211930,51213906,111121503,XM_022462807.1,uncharacterized LOC111121503,1976
NC_035781.1,61015030,61017872,61015030,61017872,111121507,XM_022462812.1,uncharacterized LOC111121507,2842
NC_035781.1,15834333,15837717,15834333,15837717,111121510,XM_022462814.1,uncharacterized LOC111121510,3384
NC_035780.1,4917459,4942587,4917459,4941019,111121511,XM_022462826.1,uncharacterized LOC111121511,23560
NC_035780.1,4917459,4942587,4917459,4942587,111121511,XM_022462819.1,uncharacterized LOC111121511,25128
NC_035781.1,45092760,45098243,45092760,45098243,111121516,XM_022462821.1,uncharacterized LOC111121516,5483
NC_035781.1,60058935,60077295,60058935,60077295,111121518,XM_022462823.1,uncharacterized LOC111121518,18360
NC_035781.1,22705134,22712446,22705134,22712446,111121520,XM_022462825.1,uncharacterized LOC111121520,7312
NC_035781.1,31155533,31158683,31155533,31156622,111121521,XM_022462829.1,uncharacterized LOC111121521,1089
NC_035781.1,31155533,31158683,31155533,31158160,111121521,XM_022462827.1,uncharacterized LOC111121521,2627
NC_035781.1,31155533,31158683,31155533,31158683,111121521,XM_022462828.1,uncharacterized LOC111121521,3150
NC_035780.1,4895023,4904987,4895023,4904987,111121524,XM_022462848.1,uncharacterized LOC111121524,9964
NC_035781.1,52312032,52325490,52312032,52325490,111121527,XM_022462839.1,uncharacterized LOC111121527,13458
NC_035781.1,58935022,58949721,58935022,58949721,111121528,XM_022462841.1,uncharacterized LOC111121528,14699
NC_035781.1,40030296,40067192,40030296,40067192,111121536,XM_022462855.1,uncharacterized LOC111121536,36896
NC_035780.1,4801569,4815766,4801569,4815766,111121537,XM_022462860.1,uncharacterized LOC111121537,14197
NC_035780.1,4801569,4815766,4810252,4815766,111121537,XM_022462868.1,uncharacterized LOC111121537,5514
NC_035780.1,4801569,4815766,4810042,4815766,111121537,XM_022462876.1,uncharacterized LOC111121537,5724
NC_035781.1,42632892,42635351,42632892,42635351,111121540,XM_022462858.1,uncharacterized LOC111121540,2459
NC_035781.1,36239058,36242061,36239058,36242061,111121550,XM_022462873.1,uncharacterized LOC111121550,3003
NC_035781.1,36216066,36218411,36216066,36218411,111121555,XM_022462879.1,uncharacterized LOC111121555,2345
NC_035781.1,36375172,36378748,36375172,36378748,111121557,XM_022462882.1,uncharacterized LOC111121557,3576
NC_035781.1,36221209,36225143,36221209,36225141,111121558,XM_022462884.1,uncharacterized LOC111121558,3932
NC_035781.1,36221209,36225143,36221209,36225143,111121558,XM_022462883.1,uncharacterized LOC111121558,3934
NC_035780.1,4847455,4859825,4847455,4859825,111121565,XM_022462918.1,uncharacterized LOC111121565,12370
NC_035780.1,4847455,4859825,4854937,4859823,111121565,XM_022462934.1,uncharacterized LOC111121565,4886
NC_035780.1,4847455,4859825,4854927,4859823,111121565,XM_022462926.1,uncharacterized LOC111121565,4896
NC_035780.1,4847455,4859825,4847474,4853173,111121565,XM_022462900.1,uncharacterized LOC111121565,5699
NC_035780.1,4847455,4859825,4847455,4853172,111121565,XM_022462893.1,uncharacterized LOC111121565,5717
NC_035780.1,4847455,4859825,4847455,4853174,111121565,XM_022462908.1,uncharacterized LOC111121565,5719
NC_035781.1,36890661,36893329,36890661,36893329,111121567,XM_022462891.1,uncharacterized LOC111121567,2668
NC_035781.1,42825010,42834474,42825010,42834474,111121568,XM_022462892.1,uncharacterized LOC111121568,9464
NC_035781.1,17231411,17233153,17231411,17233153,111121569,XM_022462894.1,uncharacterized LOC111121569,1742
NC_035781.1,39400592,39407389,39400592,39407333,111121572,XM_022462898.1,uncharacterized LOC111121572,6741
NC_035781.1,23378028,23380194,23378028,23380194,111121576,XM_022462904.1,uncharacterized LOC111121576,2166
NC_035781.1,56682035,56687886,56682040,56687884,111121579,XM_022462909.1,uncharacterized LOC111121579,5844
NC_035781.1,56682035,56687886,56682035,56687886,111121579,XM_022462907.1,uncharacterized LOC111121579,5851
NC_035781.1,30472968,30478014,30472968,30478014,111121584,XM_022462923.1,uncharacterized LOC111121584,5046
NC_035781.1,54214248,54234845,54214640,54234845,111121586,XM_022462927.1,uncharacterized LOC111121586,20205
NC_035781.1,54214248,54234845,54214254,54234845,111121586,XM_022462928.1,uncharacterized LOC111121586,20591
NC_035781.1,54214248,54234845,54214248,54234845,111121586,XM_022462925.1,uncharacterized LOC111121586,20597
NC_035781.1,13208567,13211796,13208567,13211796,111121594,XM_022462940.1,uncharacterized LOC111121594,3229
NC_035781.1,35060726,35062887,35060726,35062887,111121598,XM_022462946.1,uncharacterized LOC111121598,2161
NC_035781.1,15490778,15494306,15490778,15494306,111121605,XM_022462958.1,uncharacterized LOC111121605,3528
NC_035781.1,15487637,15489843,15487637,15489843,111121606,XM_022462959.1,uncharacterized LOC111121606,2206
NC_035781.1,44257557,44261900,44257557,44261900,111121609,XM_022462962.1,uncharacterized LOC111121609,4343
NC_035780.1,4877869,4890053,4877869,4890052,111121611,XM_022462974.1,uncharacterized LOC111121611,12183
NC_035780.1,4877869,4890053,4877869,4890053,111121611,XM_022462967.1,uncharacterized LOC111121611,12184
NC_035781.1,59158830,59169857,59158830,59169857,111121612,XM_022462965.1,uncharacterized LOC111121612,11027
NC_035781.1,59158830,59169857,59160246,59169857,111121612,XM_022462964.1,uncharacterized LOC111121612,9611
NC_035781.1,6516865,6521138,6516865,6521138,111121621,XM_022462975.1,uncharacterized LOC111121621,4273
NC_035781.1,30117643,30124312,30117643,30124312,111121624,XM_022462979.1,uncharacterized LOC111121624,6669
NC_035781.1,29968432,29971717,29968687,29971717,111121626,XM_022462982.1,uncharacterized LOC111121626,3030
NC_035781.1,29968432,29971717,29968432,29971717,111121626,XM_022462981.1,uncharacterized LOC111121626,3285
NC_035781.1,29960222,29963192,29960222,29963192,111121628,XM_022462985.1,uncharacterized LOC111121628,2970
NC_035781.1,16381360,16386625,16381360,16386225,111121634,XM_022462990.1,uncharacterized LOC111121634,4865
NC_035781.1,16381360,16386625,16381360,16386625,111121634,XM_022462991.1,uncharacterized LOC111121634,5265
NC_035781.1,19335467,19337451,19335467,19337451,111121636,XM_022462994.1,uncharacterized LOC111121636,1984
NC_035781.1,33167780,33169873,33167780,33169873,111121637,XM_022462995.1,uncharacterized LOC111121637,2093
NC_035781.1,34895357,34902876,34895357,34902876,111121640,XM_022462998.1,uncharacterized LOC111121640,7519
NC_035781.1,34902784,34913968,34902784,34913968,111121641,XM_022462999.1,uncharacterized LOC111121641,11184
NC_035780.1,4873877,4876877,4873895,4876877,111121643,XM_022463011.1,uncharacterized LOC111121643,2982
NC_035780.1,4873877,4876877,4873877,4876877,111121643,XM_022463003.1,uncharacterized LOC111121643,3000
NC_035781.1,9712272,9715707,9712272,9715707,111121650,XM_022463006.1,uncharacterized LOC111121650,3435
NC_035781.1,21049215,21072046,21049221,21072046,111121655,XM_022463017.1,uncharacterized LOC111121655,22825
NC_035781.1,21049215,21072046,21049215,21072046,111121655,XM_022463018.1,uncharacterized LOC111121655,22831
NC_035781.1,28670834,28687574,28670834,28687574,111121662,XM_022463028.1,uncharacterized LOC111121662,16740
NC_035781.1,28663207,28670728,28663207,28670728,111121663,XM_022463029.1,uncharacterized LOC111121663,7521
NC_035781.1,60403042,60404244,60403042,60404244,111121664,XM_022463030.1,uncharacterized LOC111121664,1202
NC_035781.1,57785590,57789512,57785590,57789512,111121668,XM_022463033.1,uncharacterized LOC111121668,3922
NC_035781.1,37962867,37967011,37962868,37966859,111121669,XM_022463034.1,uncharacterized LOC111121669,3991
NC_035780.1,39696760,39707874,39696760,39707874,111121673,XM_022463042.1,uncharacterized LOC111121673,11114
NC_035781.1,25443788,25446295,25443788,25446295,111121676,XM_022463041.1,uncharacterized LOC111121676,2507
NC_035781.1,47639841,47642973,47640996,47642973,111121677,XM_022463045.1,uncharacterized LOC111121677,1977
NC_035781.1,47639841,47642973,47640309,47642973,111121677,XM_022463043.1,uncharacterized LOC111121677,2664
NC_035781.1,47639841,47642973,47639841,47642973,111121677,XM_022463044.1,uncharacterized LOC111121677,3132
NC_035780.1,46785998,46790706,46785998,46790706,111121682,XM_022463054.1,uncharacterized LOC111121682,4708
NC_035781.1,60312720,60398292,60338561,60398292,111121697,XM_022463065.1,uncharacterized LOC111121697,59731
NC_035781.1,60312720,60398292,60312720,60398292,111121697,XM_022463064.1,uncharacterized LOC111121697,85572
NC_035781.1,60354033,60356513,60354033,60356513,111121698,XM_022463066.1,uncharacterized LOC111121698,2480
NC_035781.1,60350627,60351814,60350627,60351814,111121699,XM_022463067.1,uncharacterized LOC111121699,1187
NC_035781.1,53831526,53835440,53832820,53835440,111121704,XM_022463073.1,uncharacterized LOC111121704,2620
NC_035781.1,53831526,53835440,53831526,53835440,111121704,XM_022463072.1,uncharacterized LOC111121704,3914
NC_035781.1,3025689,3029445,3025689,3027502,111121706,XM_022463075.1,uncharacterized LOC111121706,1813
NC_035781.1,3025689,3029445,3025689,3028764,111121706,XM_022463077.1,uncharacterized LOC111121706,3075
NC_035781.1,3025689,3029445,3025689,3029445,111121706,XM_022463076.1,uncharacterized LOC111121706,3756
NC_035781.1,2147427,2158270,2147427,2158270,111121736,XM_022463133.1,uncharacterized LOC111121736,10843
NC_035781.1,2147427,2158270,2147427,2156319,111121736,XM_022463132.1,uncharacterized LOC111121736,8892
NC_035781.1,56007994,56017253,56010647,56016513,111121742,XM_022463151.1,uncharacterized LOC111121742,5866
NC_035781.1,56007994,56017253,56010552,56016513,111121742,XM_022463150.1,uncharacterized LOC111121742,5961
NC_035781.1,56007994,56017253,56007994,56017253,111121742,XM_022463149.1,uncharacterized LOC111121742,9259
NC_035781.1,56041901,56061586,56041901,56055591,111121743,XM_022463160.1,uncharacterized LOC111121743,13690
NC_035781.1,56041901,56061586,56041901,56055592,111121743,XM_022463158.1,uncharacterized LOC111121743,13691
NC_035781.1,56041901,56061586,56041901,56061585,111121743,XM_022463154.1,uncharacterized LOC111121743,19684
NC_035781.1,56041901,56061586,56041901,56061586,111121743,XM_022463157.1,uncharacterized LOC111121743,19685
NC_035781.1,56064010,56088512,56068896,56088512,111121744,XM_022463163.1,uncharacterized LOC111121744,19616
NC_035781.1,56064010,56088512,56068788,56088512,111121744,XM_022463162.1,uncharacterized LOC111121744,19724
NC_035781.1,56064010,56088512,56064010,56088512,111121744,XM_022463161.1,uncharacterized LOC111121744,24502
NC_035781.1,2039512,2046711,2039512,2045318,111121749,XM_022463176.1,uncharacterized LOC111121749,5806
NC_035781.1,2039512,2046711,2039512,2045319,111121749,XM_022463174.1,uncharacterized LOC111121749,5807
NC_035781.1,2039512,2046711,2039512,2046711,111121749,XM_022463173.1,uncharacterized LOC111121749,7199
NC_035781.1,34341724,34350183,34341724,34350183,111121752,XM_022463179.1,uncharacterized LOC111121752,8459
NC_035780.1,2025787,2028053,2025787,2028053,111121766,XM_022463200.1,uncharacterized LOC111121766,2266
NC_035781.1,2269525,2270922,2269525,2270922,111121767,XM_022463197.1,uncharacterized LOC111121767,1397
NC_035781.1,1771582,1773040,1771582,1773040,111121769,XM_022463199.1,uncharacterized LOC111121769,1458
NC_035781.1,1801337,1833192,1801337,1833192,111121771,XM_022463202.1,uncharacterized LOC111121771,31855
NC_035781.1,61718574,61721277,61718574,61721277,111121776,XM_022463205.1,uncharacterized LOC111121776,2703
NC_035781.1,38597605,38602510,38597605,38602510,111121783,XM_022463213.1,uncharacterized LOC111121783,4905
NC_035781.1,9251278,9252371,9251278,9252371,111121784,XM_022463214.1,uncharacterized LOC111121784,1093
NC_035781.1,45084955,45090053,45084955,45090053,111121785,XM_022463215.1,uncharacterized LOC111121785,5098
NC_035781.1,26871768,26877633,26871768,26877633,111121790,XM_022463220.1,uncharacterized LOC111121790,5865
NC_035781.1,34663948,34680326,34664594,34680326,111121795,XM_022463224.1,uncharacterized LOC111121795,15732
NC_035781.1,34663948,34680326,34663948,34680326,111121795,XM_022463223.1,uncharacterized LOC111121795,16378
NC_035780.1,18833167,18836306,18833167,18836306,111121807,XM_022463240.1,uncharacterized LOC111121807,3139
NC_035781.1,36781852,36784622,36781852,36784622,111121814,XM_022463243.1,uncharacterized LOC111121814,2770
NC_035781.1,35357242,35359535,35357242,35359535,111121815,XM_022463244.1,uncharacterized LOC111121815,2293
NC_035781.1,40519320,40525463,40519320,40525463,111121817,XM_022463246.1,uncharacterized LOC111121817,6143
NC_035781.1,28921773,28948168,28921773,28948168,111121820,XM_022463251.1,uncharacterized LOC111121820,26395
NC_035781.1,60265769,60304160,60265769,60304160,111121821,XM_022463252.1,uncharacterized LOC111121821,38391
NC_035780.1,10596899,10602340,10597307,10602340,111121823,XM_022463266.1,uncharacterized LOC111121823,5033
NC_035780.1,10596899,10602340,10596899,10602340,111121823,XM_022463258.1,uncharacterized LOC111121823,5441
NC_035781.1,27340832,27353390,27340832,27353390,111121825,XM_022463257.1,uncharacterized LOC111121825,12558
NC_035781.1,27333779,27385434,27333779,27378280,111121826,XM_022463259.1,uncharacterized LOC111121826,44501
NC_035781.1,27333779,27385434,27333779,27378281,111121826,XM_022463261.1,uncharacterized LOC111121826,44502
NC_035781.1,27333779,27385434,27333779,27384846,111121826,XM_022463260.1,uncharacterized LOC111121826,51067
NC_035781.1,27333779,27385434,27379880,27385434,111121826,XM_022463262.1,uncharacterized LOC111121826,5554
NC_035780.1,65092946,65126616,65092946,65126616,111121840,XM_022463293.1,uncharacterized LOC111121840,33670
NC_035781.1,42622742,42625636,42622742,42625636,111121842,XM_022463295.1,uncharacterized LOC111121842,2894
NC_035781.1,32819286,32822090,32819451,32822090,111121866,XM_022463330.1,uncharacterized LOC111121866,2639
NC_035781.1,32819286,32822090,32819286,32822090,111121866,XM_022463329.1,uncharacterized LOC111121866,2804
NC_035781.1,38827615,38843224,38827616,38843223,111121867,XM_022463331.1,uncharacterized LOC111121867,15607
NC_035781.1,38827615,38843224,38827615,38843224,111121867,XM_022463332.1,uncharacterized LOC111121867,15609
NC_035781.1,45137599,45144510,45137599,45144504,111121868,XM_022463335.1,uncharacterized LOC111121868,6905
NC_035781.1,56161279,56179547,56161279,56179547,111121869,XM_022463336.1,uncharacterized LOC111121869,18268
NC_035781.1,53305562,53310975,53305562,53310975,111121870,XM_022463337.1,uncharacterized LOC111121870,5413
NC_035781.1,54550275,54560142,54550275,54559496,111121875,XM_022463344.1,uncharacterized LOC111121875,9221
NC_035781.1,54550275,54560142,54550275,54560142,111121875,XM_022463342.1,uncharacterized LOC111121875,9867
NC_035780.1,64951361,64962345,64951361,64962345,111121882,XM_022463368.1,uncharacterized LOC111121882,10984
NC_035781.1,2649030,2659867,2649030,2659867,111121888,XM_022463363.1,uncharacterized LOC111121888,10837
NC_035781.1,15839178,15840854,15839178,15840854,111121897,XM_022463376.1,uncharacterized LOC111121897,1676
NC_035781.1,61704855,61706021,61704855,61706021,111121900,XM_022463380.1,uncharacterized LOC111121900,1166
NC_035780.1,64962396,64978703,64966921,64978703,111121911,XM_022463420.1,uncharacterized LOC111121911,11782
NC_035780.1,64962396,64978703,64962396,64978703,111121911,XM_022463401.1,uncharacterized LOC111121911,16307
NC_035780.1,64962396,64978703,64968710,64978703,111121911,XM_022463409.1,uncharacterized LOC111121911,9993
NC_035781.1,26815711,26817777,26815711,26817777,111121915,XM_022463403.1,uncharacterized LOC111121915,2066
NC_035781.1,420702,423511,420702,423511,111121918,XM_022463406.1,uncharacterized LOC111121918,2809
NC_035780.1,64921956,64930580,64921956,64930580,111121931,XM_022463434.1,uncharacterized LOC111121931,8624
NC_035781.1,58901424,58912017,58901424,58912017,111121933,XM_022463432.1,uncharacterized LOC111121933,10593
NC_035781.1,26403693,26453680,26403693,26453680,111121934,XM_022463433.1,uncharacterized LOC111121934,49987
NC_035781.1,26461723,26472170,26461723,26472170,111121935,XM_022463435.1,uncharacterized LOC111121935,10447
NC_035781.1,33130455,33135666,33130455,33135666,111121938,XM_022463437.1,uncharacterized LOC111121938,5211
NC_035780.1,65076462,65082935,65076462,65082935,111121943,XM_022463443.1,uncharacterized LOC111121943,6473
NC_035781.1,42847691,42857476,42847691,42857476,111121944,XM_022463440.1,uncharacterized LOC111121944,9785
NC_035781.1,50396459,50417706,50396459,50417706,111121949,XM_022463447.1,uncharacterized LOC111121949,21247
NC_035781.1,22168004,22171470,22168004,22171470,111121950,XM_022463448.1,uncharacterized LOC111121950,3466
NC_035781.1,49772500,49775624,49772500,49775624,111121951,XM_022463449.1,uncharacterized LOC111121951,3124
NC_035781.1,60814652,60838065,60814652,60838065,111121952,XM_022463451.1,uncharacterized LOC111121952,23413
NC_035781.1,60814652,60838065,60829356,60838063,111121952,XM_022463450.1,uncharacterized LOC111121952,8707
NC_035780.1,64983918,64987123,64983918,64987123,111121953,XM_022463455.1,uncharacterized LOC111121953,3205
NC_035781.1,60592242,60602709,60592242,60602709,111121954,XM_022463452.1,uncharacterized LOC111121954,10467
NC_035781.1,60710860,60714280,60710860,60714280,111121963,XM_022463463.1,uncharacterized LOC111121963,3420
NC_035781.1,60512980,60517646,60512980,60517646,111121966,XM_022463466.1,uncharacterized LOC111121966,4666
NC_035781.1,60473475,60479458,60473475,60478873,111121967,XM_022463467.1,uncharacterized LOC111121967,5398
NC_035781.1,60473475,60479458,60473475,60479458,111121967,XM_022463468.1,uncharacterized LOC111121967,5983
NC_035781.1,60730807,60737683,60730807,60737087,111121968,XM_022463469.1,uncharacterized LOC111121968,6280
NC_035781.1,60730807,60737683,60730848,60737683,111121968,XM_022463470.1,uncharacterized LOC111121968,6835
NC_035781.1,60490808,60496360,60490808,60496360,111121970,XM_022463471.1,uncharacterized LOC111121970,5552
NC_035781.1,45148574,45150251,45148575,45150251,111121978,XM_022463479.1,uncharacterized LOC111121978,1676
NC_035781.1,45148574,45150251,45148574,45150251,111121978,XM_022463480.1,uncharacterized LOC111121978,1677
NC_035781.1,7272551,7284557,7272551,7284557,111121981,XM_022463483.1,uncharacterized LOC111121981,12006
NC_035781.1,29274136,29279097,29275431,29278492,111121986,XM_022463498.1,uncharacterized LOC111121986,3061
NC_035781.1,29274136,29279097,29274136,29278472,111121986,XM_022463495.1,uncharacterized LOC111121986,4336
NC_035781.1,29274136,29279097,29274136,29278486,111121986,XM_022463497.1,uncharacterized LOC111121986,4350
NC_035781.1,29274136,29279097,29274136,29279097,111121986,XM_022463496.1,uncharacterized LOC111121986,4961
NC_035781.1,31894851,31901395,31894851,31901354,111121995,XM_022463511.1,uncharacterized LOC111121995,6503
NC_035781.1,31894851,31901395,31894851,31901395,111121995,XM_022463512.1,uncharacterized LOC111121995,6544
NC_035781.1,60006405,60024958,60006405,60024958,111122013,XM_022463530.1,uncharacterized LOC111122013,18553
NC_035781.1,55114456,55115283,55114456,55115283,111122014,XM_022463531.1,uncharacterized LOC111122014,827
NC_035781.1,32769552,32772265,32769564,32772265,111122019,XM_022463544.1,uncharacterized LOC111122019,2701
NC_035781.1,32769552,32772265,32769552,32772261,111122019,XM_022463543.1,uncharacterized LOC111122019,2709
NC_035781.1,39129664,39131669,39129664,39131669,111122021,XM_022463546.1,uncharacterized LOC111122021,2005
NC_035781.1,5155414,5160349,5155414,5160349,111122023,XM_022463549.1,uncharacterized LOC111122023,4935
NC_035781.1,59679244,59681105,59679244,59681105,111122029,XM_022463556.1,uncharacterized LOC111122029,1861
NC_035781.1,34976395,34980228,34976395,34980228,111122032,XM_022463559.1,uncharacterized LOC111122032,3833
NC_035781.1,43418390,43421723,43418390,43421723,111122037,XM_022463562.1,uncharacterized LOC111122037,3333
NC_035781.1,41849663,41857198,41849663,41856355,111122047,XM_022463575.1,uncharacterized LOC111122047,6692
NC_035781.1,41849663,41857198,41850341,41857198,111122047,XM_022463577.1,uncharacterized LOC111122047,6857
NC_035781.1,41849663,41857198,41850128,41857198,111122047,XM_022463578.1,uncharacterized LOC111122047,7070
NC_035781.1,41849663,41857198,41849663,41857198,111122047,XM_022463576.1,uncharacterized LOC111122047,7535
NC_035780.1,13868083,13884744,13868083,13884743,111122050,XM_022463594.1,uncharacterized LOC111122050,16660
NC_035780.1,13868083,13884744,13868083,13884744,111122050,XM_022463585.1,uncharacterized LOC111122050,16661
NC_035781.1,17986402,17996163,17986402,17996163,111122063,XM_022463604.1,uncharacterized LOC111122063,9761
NC_035781.1,25129115,25139200,25129115,25139200,111122069,XM_022463621.1,uncharacterized LOC111122069,10085
NC_035781.1,42332808,42339115,42332808,42339115,111122080,XM_022463635.1,uncharacterized LOC111122080,6307
NC_035781.1,19028691,19043221,19028691,19043221,111122084,XM_022463640.1,uncharacterized LOC111122084,14530
NC_035781.1,19023709,19024740,19023709,19024740,111122085,XM_022463641.1,uncharacterized LOC111122085,1031
NC_035781.1,3052019,3052943,3052019,3052943,111122087,XM_022463642.1,uncharacterized LOC111122087,924
NC_035781.1,17205021,17206543,17205021,17206543,111122088,XM_022463643.1,uncharacterized LOC111122088,1522
NC_035781.1,36431750,36434782,36431750,36434782,111122096,XM_022463655.1,uncharacterized LOC111122096,3032
NC_035781.1,5551790,5555136,5551790,5555136,111122098,XM_022463656.1,uncharacterized LOC111122098,3346
NC_035781.1,19878619,19884592,19878619,19881834,111122103,XM_022463666.1,uncharacterized LOC111122103,3215
NC_035781.1,19878619,19884592,19878621,19884584,111122103,XM_022463665.1,uncharacterized LOC111122103,5963
NC_035781.1,19878619,19884592,19878619,19884592,111122103,XM_022463664.1,uncharacterized LOC111122103,5973
NC_035781.1,32488078,32500126,32488078,32500126,111122104,XM_022463667.1,uncharacterized LOC111122104,12048
NC_035781.1,16630966,16632581,16630966,16632581,111122123,XM_022463705.1,uncharacterized LOC111122123,1615
NC_035781.1,25678915,25683738,25678915,25683738,111122124,XM_022463706.1,uncharacterized LOC111122124,4823
NC_035781.1,17318381,17321309,17318381,17321309,111122126,XM_022463709.1,uncharacterized LOC111122126,2928
NC_035781.1,38226892,38246402,38226892,38246402,111122132,XM_022463717.1,uncharacterized LOC111122132,19510
NC_035781.1,20210445,20215781,20210445,20215781,111122135,XM_022463720.1,uncharacterized LOC111122135,5336
NC_035781.1,17109942,17111687,17109942,17111687,111122143,XM_022463728.1,uncharacterized LOC111122143,1745
NC_035781.1,44901109,44904613,44901109,44904613,111122147,XM_022463735.1,uncharacterized LOC111122147,3504
NC_035781.1,20726910,20739728,20726910,20739728,111122153,XM_022463740.1,uncharacterized LOC111122153,12818
NC_035781.1,38624561,38646468,38632500,38646468,111122154,XM_022463744.1,uncharacterized LOC111122154,13968
NC_035781.1,38624561,38646468,38624573,38646468,111122154,XM_022463742.1,uncharacterized LOC111122154,21895
NC_035781.1,38624561,38646468,38624561,38646468,111122154,XM_022463743.1,uncharacterized LOC111122154,21907
NC_035781.1,44751361,44757394,44751361,44757394,111122161,XM_022463764.1,uncharacterized LOC111122161,6033
NC_035781.1,31904722,31906093,31904722,31906093,111122165,XM_022463769.1,uncharacterized LOC111122165,1371
NC_035781.1,41087232,41098059,41087232,41098059,111122168,XM_022463776.1,uncharacterized LOC111122168,10827
NC_035781.1,9195261,9201215,9195261,9201215,111122170,XM_022463779.1,uncharacterized LOC111122170,5954
NC_035781.1,16786381,16788450,16786381,16788450,111122174,XM_022463790.1,uncharacterized LOC111122174,2069
NC_035781.1,19858411,19860515,19858411,19860515,111122182,XM_022463802.1,uncharacterized LOC111122182,2104
NC_035781.1,16851772,16854392,16851772,16854392,111122186,XM_022463807.1,uncharacterized LOC111122186,2620
NC_035781.1,6464815,6465981,6464815,6465981,111122188,XM_022463808.1,uncharacterized LOC111122188,1166
NC_035781.1,19292376,19293832,19292376,19293832,111122191,XM_022463813.1,uncharacterized LOC111122191,1456
NC_035781.1,17225625,17227223,17225625,17227223,111122192,XM_022463815.1,uncharacterized LOC111122192,1598
NC_035781.1,24923158,24927563,24923158,24927563,111122194,XM_022463819.1,uncharacterized LOC111122194,4405
NC_035780.1,3812208,3816668,3812208,3816668,111122198,XM_022463826.1,uncharacterized LOC111122198,4460
NC_035781.1,33796623,33798917,33796623,33798917,111122203,XM_022463828.1,uncharacterized LOC111122203,2294
NC_035781.1,25394359,25412424,25402140,25412424,111122205,XM_022463830.1,uncharacterized LOC111122205,10284
NC_035781.1,25394359,25412424,25395938,25398460,111122205,XM_022463831.1,uncharacterized LOC111122205,2522
NC_035781.1,25394359,25412424,25395938,25398462,111122205,XM_022463832.1,uncharacterized LOC111122205,2524
NC_035781.1,25394359,25412424,25403901,25406592,111122205,XM_022463834.1,uncharacterized LOC111122205,2691
NC_035781.1,25394359,25412424,25403901,25406700,111122205,XM_022463835.1,uncharacterized LOC111122205,2799
NC_035781.1,25394359,25412424,25394359,25398462,111122205,XM_022463833.1,uncharacterized LOC111122205,4103
NC_035780.1,22778102,22780113,22778102,22779736,111122206,XM_022463838.1,uncharacterized LOC111122206,1634
NC_035780.1,22778102,22780113,22778102,22780113,111122206,XM_022463845.1,uncharacterized LOC111122206,2011
NC_035781.1,34332340,34334128,34332340,34334128,111122207,XM_022463836.1,uncharacterized LOC111122207,1788
NC_035781.1,44111390,44117665,44111390,44117665,111122209,XM_022463839.1,uncharacterized LOC111122209,6275
NC_035781.1,12163688,12166169,12163688,12166169,111122212,XM_022463841.1,uncharacterized LOC111122212,2481
NC_035781.1,12166462,12169091,12166469,12169091,111122213,XM_022463843.1,uncharacterized LOC111122213,2622
NC_035781.1,12166462,12169091,12166462,12169091,111122213,XM_022463842.1,uncharacterized LOC111122213,2629
NC_035781.1,3808100,3839782,3808100,3839782,111122215,XM_022463847.1,uncharacterized LOC111122215,31682
NC_035781.1,15496588,15499215,15496588,15499215,111122217,XM_022463853.1,uncharacterized LOC111122217,2627
NC_035781.1,20094269,20099343,20094269,20099343,111122221,XM_022463861.1,uncharacterized LOC111122221,5074
NC_035781.1,20102019,20104221,20102019,20104221,111122223,XM_022463863.1,uncharacterized LOC111122223,2202
NC_035781.1,28557431,28560340,28557431,28560340,111122225,XM_022463865.1,uncharacterized LOC111122225,2909
NC_035781.1,46311614,46316143,46311614,46316143,111122237,XM_022463879.1,uncharacterized LOC111122237,4529
NC_035780.1,32141195,32144208,32141195,32144208,111122239,XM_022463885.1,uncharacterized LOC111122239,3013
NC_035781.1,46399440,46406532,46399440,46404805,111122240,XM_022463882.1,uncharacterized LOC111122240,5365
NC_035781.1,46399440,46406532,46399440,46406532,111122240,XM_022463881.1,uncharacterized LOC111122240,7092
NC_035781.1,46429844,46436056,46429844,46436056,111122241,XM_022463883.1,uncharacterized LOC111122241,6212
NC_035781.1,46321733,46325750,46322493,46325750,111122242,XM_022463887.1,uncharacterized LOC111122242,3257
NC_035781.1,46321733,46325750,46321733,46325750,111122242,XM_022463888.1,uncharacterized LOC111122242,4017
NC_035781.1,46406996,46410529,46406996,46410529,111122243,XM_022463889.1,uncharacterized LOC111122243,3533
NC_035780.1,43247661,43252575,43247661,43252575,111122247,XM_022463897.1,uncharacterized LOC111122247,4914
NC_035781.1,34338189,34339578,34338189,34339578,111122262,XM_022463912.1,uncharacterized LOC111122262,1389
NC_035780.1,12879066,12888705,12879066,12888705,111122263,XM_022463917.1,uncharacterized LOC111122263,9639
NC_035780.1,46110420,46113314,46110420,46113314,111122271,XM_022463927.1,uncharacterized LOC111122271,2894
NC_035781.1,52880787,52896121,52880787,52896121,111122274,XM_022463926.1,uncharacterized LOC111122274,15334
NC_035781.1,57479666,57486826,57479666,57486826,111122277,XM_022463929.1,uncharacterized LOC111122277,7160
NC_035781.1,4440319,4442627,4440319,4442627,111122280,XM_022463932.1,uncharacterized LOC111122280,2308
NC_035781.1,61617886,61650097,61617897,61650097,111122284,XM_022463936.1,uncharacterized LOC111122284,32200
NC_035781.1,61617886,61650097,61617886,61650097,111122284,XM_022463935.1,uncharacterized LOC111122284,32211
NC_035781.1,61650110,61685884,61650116,61685884,111122285,XM_022463937.1,uncharacterized LOC111122285,35768
NC_035781.1,61650110,61685884,61650110,61685884,111122285,XM_022463939.1,uncharacterized LOC111122285,35774
NC_035781.1,5483049,5488619,5483049,5488619,111122286,XM_022463940.1,uncharacterized LOC111122286,5570
NC_035781.1,29092830,29097538,29092830,29097538,111122290,XM_022463945.1,uncharacterized LOC111122290,4708
NC_035781.1,8622099,8638276,8626589,8638276,111122296,XM_022463957.1,uncharacterized LOC111122296,11687
NC_035781.1,8622099,8638276,8622102,8638276,111122296,XM_022463963.1,uncharacterized LOC111122296,16174
NC_035781.1,8622099,8638276,8622101,8638276,111122296,XM_022463961.1,uncharacterized LOC111122296,16175
NC_035781.1,8622099,8638276,8622099,8638276,111122296,XM_022463959.1,uncharacterized LOC111122296,16177
NC_035781.1,8622099,8638276,8631378,8637623,111122296,XM_022463964.1,uncharacterized LOC111122296,6245
NC_035781.1,8656824,8658340,8656824,8658340,111122298,XM_022463965.1,uncharacterized LOC111122298,1516
NC_035780.1,26159845,26164731,26159845,26162130,111122301,XM_022463989.1,uncharacterized LOC111122301,2285
NC_035780.1,26159845,26164731,26159845,26164404,111122301,XM_022463981.1,uncharacterized LOC111122301,4559
NC_035780.1,26159845,26164731,26159845,26164731,111122301,XM_022463972.1,uncharacterized LOC111122301,4886
NC_035781.1,8639482,8664335,8639488,8664335,111122302,XM_022463970.1,uncharacterized LOC111122302,24847
NC_035781.1,8639482,8664335,8639482,8664335,111122302,XM_022463971.1,uncharacterized LOC111122302,24853
NC_035781.1,8642901,8643806,8642901,8643806,111122303,XM_022463973.1,uncharacterized LOC111122303,905
NC_035781.1,56459837,56471059,56459837,56471059,111122304,XM_022463975.1,uncharacterized LOC111122304,11222
NC_035781.1,59638806,59640605,59638806,59640605,111122307,XM_022463980.1,uncharacterized LOC111122307,1799
NC_035781.1,7905529,7925169,7905529,7925169,111122308,XM_022463982.1,uncharacterized LOC111122308,19640
NC_035781.1,58917357,58929362,58917357,58929362,111122312,XM_022463990.1,uncharacterized LOC111122312,12005
NC_035781.1,43865013,43870407,43866299,43870407,111122315,XM_022463994.1,uncharacterized LOC111122315,4108
NC_035781.1,3446289,3448678,3446289,3448678,111122319,XM_022464031.1,uncharacterized LOC111122319,2389
NC_035781.1,18639054,18640240,18639054,18640240,111122322,XM_022464034.1,uncharacterized LOC111122322,1186
NC_035781.1,18637344,18638536,18637344,18638536,111122324,XM_022464035.1,uncharacterized LOC111122324,1192
NC_035781.1,18882526,18885613,18882526,18885613,111122338,XM_022464062.1,uncharacterized LOC111122338,3087
NC_035781.1,27894624,27896723,27894629,27896723,111122344,XM_022464075.1,uncharacterized LOC111122344,2094
NC_035781.1,27894624,27896723,27894624,27896723,111122344,XM_022464076.1,uncharacterized LOC111122344,2099
NC_035780.1,15782444,15788948,15782951,15788948,111122356,XM_022464162.1,uncharacterized LOC111122356,5997
NC_035780.1,15782444,15788948,15782704,15788948,111122356,XM_022464121.1,uncharacterized LOC111122356,6244
NC_035780.1,15782444,15788948,15782444,15788948,111122356,XM_022464104.1,uncharacterized LOC111122356,6504
NC_035781.1,17101198,17103929,17101198,17103601,111122357,XM_022464102.1,uncharacterized LOC111122357,2403
NC_035781.1,11158184,11174835,11159718,11174835,111122363,XM_022464109.1,uncharacterized LOC111122363,15117
NC_035781.1,11158184,11174835,11159394,11174835,111122363,XM_022464108.1,uncharacterized LOC111122363,15441
NC_035781.1,11158184,11174835,11158184,11174835,111122363,XM_022464107.1,uncharacterized LOC111122363,16651
NC_035781.1,30551420,30566011,30551791,30566011,111122368,XM_022464120.1,uncharacterized LOC111122368,14220
NC_035781.1,30551420,30566011,30551528,30566011,111122368,XM_022464116.1,uncharacterized LOC111122368,14483
NC_035781.1,30551420,30566011,30551525,30566011,111122368,XM_022464118.1,uncharacterized LOC111122368,14486
NC_035781.1,30551420,30566011,30551504,30566011,111122368,XM_022464117.1,uncharacterized LOC111122368,14507
NC_035781.1,30551420,30566011,30551420,30566011,111122368,XM_022464119.1,uncharacterized LOC111122368,14591
NC_035781.1,27441800,27453034,27441800,27453034,111122375,XM_022464132.1,uncharacterized LOC111122375,11234
NC_035781.1,743321,774572,743321,772705,111122377,XM_022464139.1,uncharacterized LOC111122377,29384
NC_035781.1,743321,774572,743321,774571,111122377,XM_022464138.1,uncharacterized LOC111122377,31250
NC_035781.1,743321,774572,743321,774572,111122377,XM_022464135.1,uncharacterized LOC111122377,31251
NC_035781.1,59682964,59684493,59682964,59684493,111122378,XM_022464140.1,uncharacterized LOC111122378,1529
NC_035781.1,20508058,20513991,20508059,20511416,111122382,XM_022464146.1,uncharacterized LOC111122382,3357
NC_035781.1,20508058,20513991,20508058,20512896,111122382,XM_022464147.1,uncharacterized LOC111122382,4838
NC_035781.1,20508058,20513991,20508058,20513991,111122382,XM_022464148.1,uncharacterized LOC111122382,5933
NC_035781.1,34402515,34404139,34402515,34404139,111122383,XM_022464149.1,uncharacterized LOC111122383,1624
NC_035781.1,55996191,56007362,55997272,56007362,111122384,XM_022464151.1,uncharacterized LOC111122384,10090
NC_035781.1,55996191,56007362,55997251,56007362,111122384,XM_022464150.1,uncharacterized LOC111122384,10111
NC_035781.1,55996191,56007362,55996191,56007362,111122384,XM_022464152.1,uncharacterized LOC111122384,11171
NC_035781.1,39853097,39854599,39853097,39854599,111122391,XM_022464161.1,uncharacterized LOC111122391,1502
NC_035781.1,17068242,17092878,17091287,17092878,111122393,XM_022464166.1,uncharacterized LOC111122393,1591
NC_035781.1,17068242,17092878,17068242,17092871,111122393,XM_022464165.1,uncharacterized LOC111122393,24629
NC_035781.1,17068242,17092878,17068242,17070841,111122393,XM_022464164.1,uncharacterized LOC111122393,2599
NC_035781.1,17064935,17066754,17064935,17066754,111122394,XM_022464168.1,uncharacterized LOC111122394,1819
NC_035781.1,17073647,17076363,17073647,17076363,111122395,XM_022464169.1,uncharacterized LOC111122395,2716
NC_035781.1,10870550,10877242,10870550,10877242,111122396,XM_022464170.1,uncharacterized LOC111122396,6692
NC_035781.1,4245739,4256487,4246299,4256487,111122400,XM_022464175.1,uncharacterized LOC111122400,10188
NC_035781.1,4245739,4256487,4245739,4256487,111122400,XM_022464173.1,uncharacterized LOC111122400,10748
NC_035781.1,4245739,4256487,4249632,4256487,111122400,XM_022464176.1,uncharacterized LOC111122400,6855
NC_035781.1,4245739,4256487,4249254,4256487,111122400,XM_022464177.1,uncharacterized LOC111122400,7233
NC_035781.1,4245739,4256487,4248912,4256487,111122400,XM_022464179.1,uncharacterized LOC111122400,7575
NC_035781.1,4245739,4256487,4247729,4256487,111122400,XM_022464178.1,uncharacterized LOC111122400,8758
NC_035780.1,53427929,53440349,53427929,53440349,111122402,XM_022464189.1,uncharacterized LOC111122402,12420
NC_035781.1,51299805,51303662,51299805,51303108,111122408,XM_022464194.1,uncharacterized LOC111122408,3303
NC_035781.1,31161591,31169902,31161591,31169889,111122418,XM_022464209.1,uncharacterized LOC111122418,8298
NC_035781.1,31161591,31169902,31161594,31169902,111122418,XM_022464208.1,uncharacterized LOC111122418,8308
NC_035780.1,5300793,5324822,5300793,5318251,111122419,XM_022464229.1,uncharacterized LOC111122419,17458
NC_035780.1,5300793,5324822,5300793,5319051,111122419,XM_022464220.1,uncharacterized LOC111122419,18258
NC_035780.1,5300793,5324822,5300793,5324822,111122419,XM_022464237.1,uncharacterized LOC111122419,24029
NC_035781.1,48328953,48350754,48328953,48350754,111122421,XM_022464212.1,uncharacterized LOC111122421,21801
NC_035781.1,48343082,48346150,48343082,48346150,111122422,XM_022464214.1,uncharacterized LOC111122422,3068
NC_035781.1,2637720,2643381,2637720,2643381,111122424,XM_022464216.1,uncharacterized LOC111122424,5661
NC_035781.1,289282,292450,289282,292450,111122451,XM_022464256.1,uncharacterized LOC111122451,3168
NC_035781.1,38551,39144,38551,39144,111122452,XM_022464257.1,uncharacterized LOC111122452,593
NC_035782.1,65811242,65812941,65811242,65812941,111122490,XM_022464263.1,uncharacterized LOC111122490,1699
NC_035782.1,33755766,33850358,33784941,33850358,111122494,XM_022464268.1,uncharacterized LOC111122494,65417
NC_035782.1,5972892,5973650,5972892,5973650,111122498,XM_022464270.1,uncharacterized LOC111122498,758
NC_035782.1,65059429,65065011,65059429,65064991,111122500,XM_022464273.1,uncharacterized LOC111122500,5562
NC_035782.1,65059429,65065011,65059429,65065011,111122500,XM_022464274.1,uncharacterized LOC111122500,5582
NC_035782.1,27986636,27994814,27986636,27994814,111122506,XM_022464282.1,uncharacterized LOC111122506,8178
NC_035782.1,16273255,16281603,16273255,16281603,111122512,XM_022464291.1,uncharacterized LOC111122512,8348
NC_035782.1,16288100,16292582,16288100,16292582,111122513,XM_022464292.1,uncharacterized LOC111122513,4482
NC_035780.1,3238126,3250761,3238126,3250761,111122515,XM_022464299.1,uncharacterized LOC111122515,12635
NC_035782.1,51571755,51577291,51571755,51577291,111122519,XM_022464301.1,uncharacterized LOC111122519,5536
NC_035782.1,64350492,64363282,64350492,64363282,111122521,XM_022464302.1,uncharacterized LOC111122521,12790
NC_035782.1,64350487,64355696,64350489,64355693,111122522,XM_022464305.1,uncharacterized LOC111122522,5204
NC_035782.1,64350487,64355696,64350487,64355695,111122522,XM_022464304.1,uncharacterized LOC111122522,5208
NC_035782.1,64350487,64355696,64350487,64355696,111122522,XM_022464307.1,uncharacterized LOC111122522,5209
NC_035780.1,3245892,3265788,3245892,3265788,111122523,XM_022464311.1,uncharacterized LOC111122523,19896
NC_035782.1,6393118,6394830,6393118,6394830,111122526,XM_022464313.1,uncharacterized LOC111122526,1712
NC_035780.1,60984221,60988807,60984227,60988807,111122528,XM_022465520.1,uncharacterized LOC111122528,4580
NC_035780.1,60984221,60988807,60984221,60988807,111122528,XM_022464707.1,uncharacterized LOC111122528,4586
NC_035782.1,6466672,6477450,6466672,6477450,111122531,XM_022464317.1,uncharacterized LOC111122531,10778
NC_035782.1,71793647,71798035,71793647,71798035,111122538,XM_022464323.1,uncharacterized LOC111122538,4388
NC_035780.1,21254605,21259402,21254605,21259402,111122541,XM_022464334.1,uncharacterized LOC111122541,4797
NC_035782.1,20299158,20301699,20299158,20301699,111122543,XM_022464325.1,uncharacterized LOC111122543,2541
NC_035782.1,18204595,18206067,18204595,18206067,111122545,XM_022464329.1,uncharacterized LOC111122545,1472
NC_035782.1,54754060,54759623,54755589,54759622,111122552,XM_022464340.1,uncharacterized LOC111122552,4033
NC_035782.1,54754060,54759623,54754060,54759620,111122552,XM_022464339.1,uncharacterized LOC111122552,5560
NC_035782.1,54754060,54759623,54754060,54759623,111122552,XM_022464341.1,uncharacterized LOC111122552,5563
NC_035782.1,54021803,54024230,54021803,54024230,111122562,XM_022464353.1,uncharacterized LOC111122562,2427
NC_035782.1,61781220,61782485,61781220,61782485,111122569,XM_022464359.1,uncharacterized LOC111122569,1265
NC_035782.1,61761926,61771134,61761926,61771134,111122570,XM_022464360.1,uncharacterized LOC111122570,9208
NC_035782.1,61744506,61747653,61744506,61747653,111122571,XM_022464361.1,uncharacterized LOC111122571,3147
NC_035782.1,61776430,61778490,61776430,61778490,111122572,XM_022464362.1,uncharacterized LOC111122572,2060
NC_035782.1,37509417,37510423,37509417,37510423,111122576,XM_022464364.1,uncharacterized LOC111122576,1006
NC_035782.1,10024146,10043276,10024146,10043276,111122577,XM_022464365.1,uncharacterized LOC111122577,19130
NC_035782.1,19138197,19143091,19138197,19143091,111122579,XM_022464370.1,uncharacterized LOC111122579,4894
NC_035782.1,72430911,72435378,72430911,72435378,111122580,XM_022464371.1,uncharacterized LOC111122580,4467
NC_035782.1,54121723,54125825,54122083,54125825,111122584,XM_022464375.1,uncharacterized LOC111122584,3742
NC_035782.1,54121723,54125825,54122082,54125825,111122584,XM_022464373.1,uncharacterized LOC111122584,3743
NC_035782.1,54121723,54125825,54121723,54125825,111122584,XM_022464374.1,uncharacterized LOC111122584,4102
NC_035782.1,14055775,14072612,14055775,14072612,111122586,XM_022464376.1,uncharacterized LOC111122586,16837
NC_035782.1,68235237,68250220,68235237,68250212,111122591,XM_022464384.1,uncharacterized LOC111122591,14975
NC_035782.1,68235237,68250220,68235243,68236889,111122591,XM_022464383.1,uncharacterized LOC111122591,1646
NC_035782.1,68235237,68250220,68248115,68250220,111122591,XM_022464388.1,uncharacterized LOC111122591,2105
NC_035782.1,68235237,68250220,68245225,68250220,111122591,XM_022464387.1,uncharacterized LOC111122591,4995
NC_035782.1,68235237,68250220,68245175,68250220,111122591,XM_022464385.1,uncharacterized LOC111122591,5045
NC_035782.1,68253271,68254564,68253271,68254564,111122592,XM_022464390.1,uncharacterized LOC111122592,1293
NC_035782.1,68255919,68257282,68255919,68257282,111122593,XM_022464391.1,uncharacterized LOC111122593,1363
NC_035782.1,17328774,17332944,17328774,17332944,111122595,XM_022464395.1,uncharacterized LOC111122595,4170
NC_035782.1,2722956,2733413,2722956,2733413,111122598,XM_022464397.1,uncharacterized LOC111122598,10457
NC_035782.1,43163205,43169821,43167050,43169821,111122601,XM_022464405.1,uncharacterized LOC111122601,2771
NC_035782.1,43163205,43169821,43163205,43169821,111122601,XM_022464404.1,uncharacterized LOC111122601,6616
NC_035782.1,34948660,35082023,34948660,35048859,111122604,XM_022464420.1,uncharacterized LOC111122604,100199
NC_035782.1,34948660,35082023,34948660,35051423,111122604,XM_022464417.1,uncharacterized LOC111122604,102763
NC_035782.1,34948660,35082023,34948660,35082014,111122604,XM_022464419.1,uncharacterized LOC111122604,133354
NC_035782.1,34948660,35082023,34948660,35082016,111122604,XM_022464418.1,uncharacterized LOC111122604,133356
NC_035782.1,34948660,35082023,35074930,35082023,111122604,XM_022464421.1,uncharacterized LOC111122604,7093
NC_035782.1,34948660,35082023,34948660,35047184,111122604,XM_022464416.1,uncharacterized LOC111122604,98524
NC_035782.1,35267115,35268755,35267115,35268755,111122613,XM_022464424.1,uncharacterized LOC111122613,1640
NC_035782.1,68815025,68816621,68815025,68816621,111122618,XM_022464428.1,uncharacterized LOC111122618,1596
NC_035782.1,9177831,9235765,9184436,9235765,111122621,XM_022464437.1,uncharacterized LOC111122621,51329
NC_035782.1,9177831,9235765,9180483,9235765,111122621,XM_022464435.1,uncharacterized LOC111122621,55282
NC_035782.1,9177831,9235765,9177831,9235765,111122621,XM_022464434.1,uncharacterized LOC111122621,57934
NC_035782.1,72254347,72264464,72254349,72264464,111122626,XM_022464443.1,uncharacterized LOC111122626,10115
NC_035782.1,72254347,72264464,72254347,72262848,111122626,XM_022464444.1,uncharacterized LOC111122626,8501
NC_035782.1,55972702,55977182,55972702,55977182,111122628,XM_022464450.1,uncharacterized LOC111122628,4480
NC_035782.1,5352465,5385779,5352465,5385779,111122631,XM_022464457.1,uncharacterized LOC111122631,33314
NC_035780.1,5404872,5420338,5404872,5420119,111122632,XM_022464498.1,uncharacterized LOC111122632,15247
NC_035780.1,5404872,5420338,5404872,5420299,111122632,XM_022464471.1,uncharacterized LOC111122632,15427
NC_035780.1,5404872,5420338,5404872,5420300,111122632,XM_022464481.1,uncharacterized LOC111122632,15428
NC_035780.1,5404872,5420338,5404872,5420338,111122632,XM_022464490.1,uncharacterized LOC111122632,15466
NC_035782.1,58836977,58841485,58836977,58841485,111122634,XM_022464459.1,uncharacterized LOC111122634,4508
NC_035782.1,7335905,7337299,7335905,7337299,111122635,XM_022464461.1,uncharacterized LOC111122635,1394
NC_035782.1,37103850,37105714,37103850,37105714,111122637,XM_022464479.1,uncharacterized LOC111122637,1864
NC_035782.1,75549898,75554964,75549898,75554964,111122638,XM_022464480.1,uncharacterized LOC111122638,5066
NC_035782.1,51249592,51257551,51249592,51257551,111122640,XM_022464485.1,uncharacterized LOC111122640,7959
NC_035782.1,51278513,51280538,51278513,51280538,111122643,XM_022464491.1,uncharacterized LOC111122643,2025
NC_035782.1,14919452,14926098,14919452,14926098,111122644,XM_022464492.1,uncharacterized LOC111122644,6646
NC_035782.1,45007841,45030006,45015670,45030006,111122647,XM_022464494.1,uncharacterized LOC111122647,14336
NC_035782.1,45007841,45030006,45008117,45030006,111122647,XM_022464495.1,uncharacterized LOC111122647,21889
NC_035782.1,45007841,45030006,45008052,45030006,111122647,XM_022464497.1,uncharacterized LOC111122647,21954
NC_035782.1,45007841,45030006,45007841,45030006,111122647,XM_022464496.1,uncharacterized LOC111122647,22165
NC_035782.1,7521176,7529164,7521176,7529164,111122653,XM_022464505.1,uncharacterized LOC111122653,7988
NC_035782.1,47282973,47288318,47282999,47288318,111122656,XM_022464510.1,uncharacterized LOC111122656,5319
NC_035782.1,47282973,47288318,47282973,47288318,111122656,XM_022464509.1,uncharacterized LOC111122656,5345
NC_035782.1,26737509,26749040,26737526,26749040,111122657,XM_022464511.1,uncharacterized LOC111122657,11514
NC_035782.1,26737509,26749040,26737509,26742404,111122657,XM_022464513.1,uncharacterized LOC111122657,4895
NC_035782.1,26737509,26749040,26737509,26746531,111122657,XM_022464512.1,uncharacterized LOC111122657,9022
NC_035782.1,42518802,42520839,42518802,42520839,111122658,XM_022464514.1,uncharacterized LOC111122658,2037
NC_035780.1,51696699,51707454,51696699,51707454,111122659,XM_022464518.1,uncharacterized LOC111122659,10755
NC_035782.1,7614187,7617280,7614187,7617280,111122661,XM_022464516.1,uncharacterized LOC111122661,3093
NC_035782.1,54194026,54197868,54194026,54197866,111122662,XM_022464519.1,uncharacterized LOC111122662,3840
NC_035782.1,54194026,54197868,54194026,54197868,111122662,XM_022464517.1,uncharacterized LOC111122662,3842
NC_035782.1,57700158,57711760,57700158,57711760,111122663,XM_022464520.1,uncharacterized LOC111122663,11602
NC_035782.1,20115854,20134559,20122588,20134552,111122665,XM_022464524.1,uncharacterized LOC111122665,11964
NC_035782.1,20115854,20134559,20121000,20134551,111122665,XM_022464525.1,uncharacterized LOC111122665,13551
NC_035782.1,20115854,20134559,20115854,20134559,111122665,XM_022464523.1,uncharacterized LOC111122665,18705
NC_035782.1,4701035,4716501,4701035,4716501,111122666,XM_022464526.1,uncharacterized LOC111122666,15466
NC_035780.1,5329422,5345609,5329422,5345609,111122667,XM_022464539.1,uncharacterized LOC111122667,16187
NC_035782.1,7911545,7922741,7911545,7922741,111122668,XM_022464527.1,uncharacterized LOC111122668,11196
NC_035782.1,40975687,40979124,40976201,40979124,111122671,XM_022464533.1,uncharacterized LOC111122671,2923
NC_035782.1,40975687,40979124,40975899,40979124,111122671,XM_022464535.1,uncharacterized LOC111122671,3225
NC_035782.1,40975687,40979124,40975687,40979124,111122671,XM_022464534.1,uncharacterized LOC111122671,3437
NC_035782.1,12251817,12253795,12251817,12253795,111122675,XM_022464540.1,uncharacterized LOC111122675,1978
NC_035782.1,7941736,7945508,7941736,7945508,111122679,XM_022464546.1,uncharacterized LOC111122679,3772
NC_035782.1,61014844,61017643,61014844,61017643,111122684,XM_022464552.1,uncharacterized LOC111122684,2799
NC_035782.1,64038862,64041878,64038862,64041878,111122685,XM_022464553.1,uncharacterized LOC111122685,3016
NC_035782.1,7960476,7962089,7960476,7962089,111122687,XM_022464556.1,uncharacterized LOC111122687,1613
NC_035782.1,23776442,23779867,23776442,23779867,111122688,XM_022464557.1,uncharacterized LOC111122688,3425
NC_035782.1,7977269,7978396,7977269,7978396,111122690,XM_022464564.1,uncharacterized LOC111122690,1127
NC_035782.1,73320949,73323272,73320949,73323272,111122691,XM_022464565.1,uncharacterized LOC111122691,2323
NC_035782.1,32836122,32838055,32836122,32838055,111122694,XM_022464567.1,uncharacterized LOC111122694,1933
NC_035782.1,72131824,72133175,72131824,72133175,111122695,XM_022464568.1,uncharacterized LOC111122695,1351
NC_035782.1,8147658,8151151,8147658,8151151,111122698,XM_022464571.1,uncharacterized LOC111122698,3493
NC_035782.1,55874232,55880274,55874232,55880274,111122702,XM_022464575.1,uncharacterized LOC111122702,6042
NC_035780.1,6911722,6947002,6911722,6947002,111122704,XM_022464581.1,uncharacterized LOC111122704,35280
NC_035780.1,21532197,21541118,21532197,21541118,111122711,XM_022464601.1,uncharacterized LOC111122711,8921
NC_035782.1,75768103,75785738,75768103,75785738,111122713,XM_022464591.1,uncharacterized LOC111122713,17635
NC_035782.1,52934766,52937747,52934766,52937747,111122714,XM_022464592.1,uncharacterized LOC111122714,2981
NC_035782.1,7322546,7393683,7322546,7374819,111122719,XM_022464600.1,uncharacterized LOC111122719,52273
NC_035782.1,7322546,7393683,7322546,7393683,111122719,XM_022464598.1,uncharacterized LOC111122719,71137
NC_035782.1,8330608,8331276,8330608,8331276,111122721,XM_022464603.1,uncharacterized LOC111122721,668
NC_035782.1,18328127,18331049,18328127,18331049,111122722,XM_022464604.1,uncharacterized LOC111122722,2922
NC_035782.1,38871591,38873868,38871591,38873868,111122723,XM_022464605.1,uncharacterized LOC111122723,2277
NC_035782.1,61714375,61723700,61714375,61723700,111122728,XM_022464609.1,uncharacterized LOC111122728,9325
NC_035782.1,27728304,27731715,27728304,27731209,111122731,XM_022464613.1,uncharacterized LOC111122731,2905
NC_035782.1,27728304,27731715,27728304,27731689,111122731,XM_022464614.1,uncharacterized LOC111122731,3385
NC_035782.1,27728304,27731715,27728304,27731715,111122731,XM_022464612.1,uncharacterized LOC111122731,3411
NC_035780.1,63757527,63792498,63757527,63768342,111122732,XM_022464641.1,uncharacterized LOC111122732,10815
NC_035780.1,63757527,63792498,63757527,63768373,111122732,XM_022464626.1,uncharacterized LOC111122732,10846
NC_035780.1,63757527,63792498,63757527,63792498,111122732,XM_022464651.1,uncharacterized LOC111122732,34971
NC_035780.1,63757527,63792498,63788446,63792493,111122732,XM_022464617.1,uncharacterized LOC111122732,4047
NC_035780.1,63757527,63792498,63757527,63765802,111122732,XM_022464632.1,uncharacterized LOC111122732,8275
NC_035782.1,33512458,33517124,33512458,33517124,111122734,XM_022464616.1,uncharacterized LOC111122734,4666
NC_035782.1,61344591,61353052,61344591,61353052,111122739,XM_022464624.1,uncharacterized LOC111122739,8461
NC_035782.1,28285218,28287676,28285218,28287676,111122740,XM_022464627.1,uncharacterized LOC111122740,2458
NC_035782.1,10086211,10090296,10086211,10090296,111122744,XM_022464629.1,uncharacterized LOC111122744,4085
NC_035782.1,11692320,11695665,11692320,11695665,111122747,XM_022464635.1,uncharacterized LOC111122747,3345
NC_035782.1,11543698,11550249,11543698,11549736,111122748,XM_022464637.1,uncharacterized LOC111122748,6038
NC_035782.1,11543698,11550249,11543698,11550249,111122748,XM_022464636.1,uncharacterized LOC111122748,6551
NC_035782.1,11690883,11694842,11690883,11694842,111122751,XM_022464642.1,uncharacterized LOC111122751,3959
NC_035782.1,11687500,11688451,11687500,11688451,111122754,XM_022464655.1,uncharacterized LOC111122754,951
NC_035782.1,11589660,11593796,11589660,11593796,111122760,XM_022464660.1,uncharacterized LOC111122760,4136
NC_035782.1,11569375,11571368,11569375,11571368,111122761,XM_022464661.1,uncharacterized LOC111122761,1993
NC_035782.1,11564101,11566079,11564101,11566079,111122762,XM_022464662.1,uncharacterized LOC111122762,1978
NC_035782.1,11718747,11722541,11718747,11722541,111122763,XM_022464664.1,uncharacterized LOC111122763,3794
NC_035782.1,11809098,11811400,11809098,11811400,111122764,XM_022464665.1,uncharacterized LOC111122764,2302
NC_035782.1,8588268,8615476,8588268,8615476,111122769,XM_022464668.1,uncharacterized LOC111122769,27208
NC_035782.1,23229,26085,23229,26085,111122772,XM_022464669.1,uncharacterized LOC111122772,2856
NC_035780.1,50403484,50404313,50403484,50404313,111122774,XM_022464704.1,uncharacterized LOC111122774,829
NC_035782.1,14176750,14211901,14176750,14207054,111122777,XM_022464705.1,uncharacterized LOC111122777,30304
NC_035782.1,14176750,14211901,14176750,14211901,111122777,XM_022464706.1,uncharacterized LOC111122777,35151
NC_035782.1,10064436,10067506,10064436,10067506,111122778,XM_022464708.1,uncharacterized LOC111122778,3070
NC_035782.1,10054212,10058965,10054212,10058965,111122780,XM_022464709.1,uncharacterized LOC111122780,4753
NC_035782.1,10058515,10070960,10058515,10070960,111122781,XM_022464710.1,uncharacterized LOC111122781,12445
NC_035782.1,10058515,10070960,10067090,10070960,111122781,XM_022464711.1,uncharacterized LOC111122781,3870
NC_035780.1,26107891,26110261,26107891,26110261,111122782,XM_022464715.1,uncharacterized LOC111122782,2370
NC_035782.1,8757752,8761299,8757752,8761299,111122786,XM_022464716.1,uncharacterized LOC111122786,3547
NC_035782.1,6280261,6288275,6280261,6285986,111122787,XM_022464717.1,uncharacterized LOC111122787,5725
NC_035782.1,6280261,6288275,6280261,6288275,111122787,XM_022464718.1,uncharacterized LOC111122787,8014
NC_035782.1,70670370,70675167,70670370,70675167,111122790,XM_022464721.1,uncharacterized LOC111122790,4797
NC_035782.1,8903265,8916699,8903265,8916699,111122792,XM_022464723.1,uncharacterized LOC111122792,13434
NC_035782.1,41442918,41450716,41442918,41450716,111122796,XM_022464727.1,uncharacterized LOC111122796,7798
NC_035782.1,74285606,74293440,74285606,74293440,111122799,XM_022464733.1,uncharacterized LOC111122799,7834
NC_035782.1,17298226,17304049,17298226,17304047,111122803,XM_022464749.1,uncharacterized LOC111122803,5821
NC_035782.1,17298226,17304049,17298226,17304048,111122803,XM_022464747.1,uncharacterized LOC111122803,5822
NC_035782.1,17298226,17304049,17298226,17304049,111122803,XM_022464752.1,uncharacterized LOC111122803,5823
NC_035780.1,20458896,20463750,20458897,20463406,111122804,XM_022464764.1,uncharacterized LOC111122804,4509
NC_035780.1,20458896,20463750,20458897,20463750,111122804,XM_022464784.1,uncharacterized LOC111122804,4853
NC_035780.1,20458896,20463750,20458896,20463750,111122804,XM_022464794.1,uncharacterized LOC111122804,4854
NC_035782.1,8936716,8938368,8936716,8938368,111122810,XM_022464769.1,uncharacterized LOC111122810,1652
NC_035782.1,73138656,73141819,73138656,73141819,111122812,XM_022464792.1,uncharacterized LOC111122812,3163
NC_035782.1,59051921,59058868,59051921,59057894,111122814,XM_022464795.1,uncharacterized LOC111122814,5973
NC_035782.1,59051921,59058868,59051921,59058868,111122814,XM_022464796.1,uncharacterized LOC111122814,6947
NC_035782.1,9240782,9250620,9240782,9250620,111122818,XM_022464804.1,uncharacterized LOC111122818,9838
NC_035782.1,38710779,38717050,38710779,38713979,111122822,XM_022464811.1,uncharacterized LOC111122822,3200
NC_035782.1,38710779,38717050,38710779,38717050,111122822,XM_022464810.1,uncharacterized LOC111122822,6271
NC_035782.1,38706645,38707894,38706645,38707894,111122824,XM_022464814.1,uncharacterized LOC111122824,1249
NC_035782.1,23814554,23822286,23814655,23822286,111122828,XM_022464821.1,uncharacterized LOC111122828,7631
NC_035782.1,23814554,23822286,23814555,23822286,111122828,XM_022464819.1,uncharacterized LOC111122828,7731
NC_035782.1,23814554,23822286,23814554,23822286,111122828,XM_022464820.1,uncharacterized LOC111122828,7732
NC_035780.1,53359993,53361424,53359993,53361220,111122831,XM_022464831.1,uncharacterized LOC111122831,1227
NC_035782.1,22868451,22879867,22868451,22879867,111122832,XM_022464830.1,uncharacterized LOC111122832,11416
NC_035782.1,9518510,9548699,9518510,9548699,111122835,XM_022464836.1,uncharacterized LOC111122835,30189
NC_035782.1,51578815,51603239,51586593,51603239,111122837,XM_022464847.1,uncharacterized LOC111122837,16646
NC_035782.1,51578815,51603239,51585047,51603239,111122837,XM_022464846.1,uncharacterized LOC111122837,18192
NC_035782.1,51578815,51603239,51581677,51603239,111122837,XM_022464839.1,uncharacterized LOC111122837,21562
NC_035782.1,51578815,51603239,51578815,51603239,111122837,XM_022464838.1,uncharacterized LOC111122837,24424
NC_035782.1,71964855,71975733,71964855,71975733,111122841,XM_022464849.1,uncharacterized LOC111122841,10878
NC_035782.1,36965523,36969584,36965523,36969584,111122843,XM_022464851.1,uncharacterized LOC111122843,4061
NC_035782.1,68073702,68083116,68073702,68083116,111122850,XM_022464857.1,uncharacterized LOC111122850,9414
NC_035782.1,67141712,67151584,67142691,67151584,111122855,XM_022464863.1,uncharacterized LOC111122855,8893
NC_035782.1,67141712,67151584,67141953,67151584,111122855,XM_022464864.1,uncharacterized LOC111122855,9631
NC_035782.1,67141712,67151584,67141712,67151584,111122855,XM_022464861.1,uncharacterized LOC111122855,9872
NC_035782.1,38266658,38269358,38266658,38269358,111122858,XM_022464866.1,uncharacterized LOC111122858,2700
NC_035782.1,9923473,9965844,9923473,9965844,111122859,XM_022464867.1,uncharacterized LOC111122859,42371
NC_035782.1,6600467,6604640,6600467,6604640,111122862,XM_022464872.1,uncharacterized LOC111122862,4173
NC_035782.1,36089058,36117024,36089058,36117019,111122863,XM_022464873.1,uncharacterized LOC111122863,27961
NC_035782.1,36089058,36117024,36089058,36117024,111122863,XM_022464874.1,uncharacterized LOC111122863,27966
NC_035782.1,70761723,70774645,70761723,70774645,111122869,XM_022464882.1,uncharacterized LOC111122869,12922
NC_035782.1,18520880,18524305,18520880,18524305,111122870,XM_022464883.1,uncharacterized LOC111122870,3425
NC_035782.1,73302858,73310102,73302858,73310102,111122873,XM_022464887.1,uncharacterized LOC111122873,7244
NC_035782.1,38366212,38371616,38366213,38371615,111122878,XM_022464896.1,uncharacterized LOC111122878,5402
NC_035782.1,38366212,38371616,38366212,38371616,111122878,XM_022464897.1,uncharacterized LOC111122878,5404
NC_035782.1,64976220,65023904,64976220,65021410,111122881,XM_022464905.1,uncharacterized LOC111122881,45190
NC_035782.1,64976220,65023904,64976220,65022164,111122881,XM_022464901.1,uncharacterized LOC111122881,45944
NC_035782.1,64976220,65023904,64976220,65022725,111122881,XM_022464904.1,uncharacterized LOC111122881,46505
NC_035782.1,64976220,65023904,64976220,65023904,111122881,XM_022464902.1,uncharacterized LOC111122881,47684
NC_035782.1,70237008,70239760,70237008,70239486,111122891,XM_022464921.1,uncharacterized LOC111122891,2478
NC_035782.1,70237008,70239760,70237008,70239760,111122891,XM_022464919.1,uncharacterized LOC111122891,2752
NC_035782.1,70418873,70420134,70418873,70420134,111122892,XM_022464922.1,uncharacterized LOC111122892,1261
NC_035782.1,18335385,18340838,18335385,18340838,111122899,XM_022464932.1,uncharacterized LOC111122899,5453
NC_035782.1,10351783,10363831,10351783,10363831,111122900,XM_022464933.1,uncharacterized LOC111122900,12048
NC_035782.1,10365120,10393518,10365120,10393518,111122901,XM_022464934.1,uncharacterized LOC111122901,28398
NC_035782.1,10426766,10448543,10426766,10448543,111122905,XM_022464940.1,uncharacterized LOC111122905,21777
NC_035782.1,41415448,41420016,41415448,41420016,111122906,XM_022464941.1,uncharacterized LOC111122906,4568
NC_035782.1,10532668,10533859,10532668,10533859,111122908,XM_022464943.1,uncharacterized LOC111122908,1191
NC_035782.1,10534164,10557470,10534164,10557470,111122909,XM_022464944.1,uncharacterized LOC111122909,23306
NC_035782.1,25381357,25385699,25381357,25385699,111122914,XM_022464950.1,uncharacterized LOC111122914,4342
NC_035782.1,41424005,41431256,41424667,41431256,111122918,XM_022464955.1,uncharacterized LOC111122918,6589
NC_035782.1,41424005,41431256,41424005,41431256,111122918,XM_022464954.1,uncharacterized LOC111122918,7251
NC_035782.1,10813974,10832987,10813974,10832987,111122919,XM_022464956.1,uncharacterized LOC111122919,19013
NC_035780.1,37027282,37031715,37027282,37031715,111122920,XM_022464960.1,uncharacterized LOC111122920,4433
NC_035782.1,61847612,61863312,61847612,61863312,111122921,XM_022464957.1,uncharacterized LOC111122921,15700
NC_035782.1,1204763,1206254,1204763,1206254,111122925,XM_022464961.1,uncharacterized LOC111122925,1491
NC_035782.1,38109625,38113908,38109625,38113908,111122928,XM_022464963.1,uncharacterized LOC111122928,4283
NC_035780.1,10751537,10761623,10751537,10761623,111122930,XM_022464970.1,uncharacterized LOC111122930,10086
NC_035782.1,11080457,11103830,11080457,11103830,111122931,XM_022464967.1,uncharacterized LOC111122931,23373
NC_035782.1,11106171,11111032,11106171,11111032,111122936,XM_022464973.1,uncharacterized LOC111122936,4861
NC_035782.1,11111363,11138828,11111363,11138828,111122938,XM_022464976.1,uncharacterized LOC111122938,27465
NC_035782.1,6334834,6338735,6334834,6338735,111122942,XM_022464979.1,uncharacterized LOC111122942,3901
NC_035782.1,72524309,72529374,72527124,72529374,111122945,XM_022464982.1,uncharacterized LOC111122945,2250
NC_035782.1,41475231,41485473,41475231,41485473,111122949,XM_022464986.1,uncharacterized LOC111122949,10242
NC_035782.1,45062903,45069179,45065154,45069179,111122951,XM_022464992.1,uncharacterized LOC111122951,4025
NC_035782.1,45062903,45069179,45062912,45069179,111122951,XM_022464991.1,uncharacterized LOC111122951,6267
NC_035782.1,45062903,45069179,45062903,45069179,111122951,XM_022464990.1,uncharacterized LOC111122951,6276
NC_035782.1,46548284,46551228,46548284,46551228,111122953,XM_022464995.1,uncharacterized LOC111122953,2944
NC_035782.1,73952786,73962218,73952786,73960602,111122954,XM_022464997.1,uncharacterized LOC111122954,7816
NC_035782.1,73952786,73962218,73952787,73962218,111122954,XM_022464998.1,uncharacterized LOC111122954,9431
NC_035782.1,71988253,71992203,71988253,71992203,111122955,XM_022464999.1,uncharacterized LOC111122955,3950
NC_035782.1,50508781,50511572,50508781,50511567,111122958,XM_022465002.1,uncharacterized LOC111122958,2786
NC_035782.1,50508781,50511572,50508781,50511572,111122958,XM_022465003.1,uncharacterized LOC111122958,2791
NC_035782.1,44507726,44538326,44507726,44538326,111122960,XM_022465006.1,uncharacterized LOC111122960,30600
NC_035782.1,51035784,51046872,51035784,51046872,111122961,XM_022465008.1,uncharacterized LOC111122961,11088
NC_035782.1,51035784,51046872,51039935,51046872,111122961,XM_022465007.1,uncharacterized LOC111122961,6937
NC_035782.1,58459735,58462604,58459735,58462604,111122963,XM_022465010.1,uncharacterized LOC111122963,2869
NC_035782.1,11576111,11577208,11576111,11577208,111122964,XM_022465011.1,uncharacterized LOC111122964,1097
NC_035782.1,7892367,7894623,7892367,7894623,111122965,XM_022465013.1,uncharacterized LOC111122965,2256
NC_035782.1,30584282,30588706,30584282,30588706,111122966,XM_022465014.1,uncharacterized LOC111122966,4424
NC_035782.1,41410181,41414545,41410181,41414545,111122972,XM_022465022.1,uncharacterized LOC111122972,4364
NC_035782.1,76432500,76501355,76432500,76499296,111122977,XM_022465030.1,uncharacterized LOC111122977,66796
NC_035782.1,76432500,76501355,76432500,76501355,111122977,XM_022465028.1,uncharacterized LOC111122977,68855
NC_035782.1,39228044,39242236,39228044,39242005,111122981,XM_022465035.1,uncharacterized LOC111122981,13961
NC_035782.1,39228044,39242236,39228049,39242236,111122981,XM_022465033.1,uncharacterized LOC111122981,14187
NC_035782.1,11708107,11711281,11708107,11711281,111122982,XM_022465036.1,uncharacterized LOC111122982,3174
NC_035782.1,17337718,17351902,17337722,17351902,111122983,XM_022465037.1,uncharacterized LOC111122983,14180
NC_035782.1,25628743,25629742,25628743,25629742,111122985,XM_022465040.1,uncharacterized LOC111122985,999
NC_035782.1,36050195,36054184,36050195,36052941,111122989,XM_022465049.1,uncharacterized LOC111122989,2746
NC_035782.1,36050195,36054184,36050197,36054184,111122989,XM_022465048.1,uncharacterized LOC111122989,3987
NC_035782.1,51804909,51809120,51804909,51807419,111122990,XM_022465054.1,uncharacterized LOC111122990,2510
NC_035782.1,51804909,51809120,51804909,51808226,111122990,XM_022465050.1,uncharacterized LOC111122990,3317
NC_035782.1,51804909,51809120,51804909,51809119,111122990,XM_022465053.1,uncharacterized LOC111122990,4210
NC_035782.1,51804909,51809120,51804909,51809120,111122990,XM_022465055.1,uncharacterized LOC111122990,4211
NC_035782.1,44844376,44856149,44844376,44856149,111122993,XM_022465063.1,uncharacterized LOC111122993,11773
NC_035782.1,44860690,44875579,44860690,44875579,111122994,XM_022465064.1,uncharacterized LOC111122994,14889
NC_035780.1,38243027,38247401,38243027,38247401,111122999,XM_022465074.1,uncharacterized LOC111122999,4374
NC_035782.1,56180204,56183765,56180204,56183765,111123001,XM_022465077.1,uncharacterized LOC111123001,3561
NC_035782.1,6624335,6658363,6624358,6635416,111123002,XM_022465078.1,uncharacterized LOC111123002,11058
NC_035782.1,6624335,6658363,6624335,6658363,111123002,XM_022465079.1,uncharacterized LOC111123002,34028
NC_035782.1,21382070,21387916,21382070,21387916,111123004,XM_022465081.1,uncharacterized LOC111123004,5846
NC_035782.1,57652286,57667425,57652286,57667425,111123010,XM_022465087.1,uncharacterized LOC111123010,15139
NC_035782.1,43156857,43158187,43156857,43158187,111123017,XM_022465094.1,uncharacterized LOC111123017,1330
NC_035782.1,43158265,43160737,43158265,43160737,111123018,XM_022465095.1,uncharacterized LOC111123018,2472
NC_035782.1,12215861,12217184,12215861,12217184,111123020,XM_022465097.1,uncharacterized LOC111123020,1323
NC_035782.1,12265309,12279241,12265309,12279241,111123022,XM_022465103.1,uncharacterized LOC111123022,13932
NC_035782.1,20025298,20027209,20025298,20027209,111123026,XM_022465106.1,uncharacterized LOC111123026,1911
NC_035782.1,38163573,38165048,38163573,38165048,111123029,XM_022465111.1,uncharacterized LOC111123029,1475
NC_035782.1,12379834,12385469,12379834,12385469,111123034,XM_022465117.1,uncharacterized LOC111123034,5635
NC_035782.1,74496148,74501740,74496148,74501740,111123037,XM_022465120.1,uncharacterized LOC111123037,5592
NC_035782.1,56898606,56902180,56900363,56902180,111123041,XM_022465126.1,uncharacterized LOC111123041,1817
NC_035782.1,56898606,56902180,56898606,56902180,111123041,XM_022465128.1,uncharacterized LOC111123041,3574
NC_035782.1,12506416,12507247,12506416,12507247,111123042,XM_022465130.1,uncharacterized LOC111123042,831
NC_035782.1,12516366,12517578,12516366,12517578,111123043,XM_022465131.1,uncharacterized LOC111123043,1212
NC_035782.1,12527388,12529138,12527388,12529138,111123044,XM_022465132.1,uncharacterized LOC111123044,1750
NC_035782.1,24248432,24287673,24248432,24287673,111123050,XM_022465138.1,uncharacterized LOC111123050,39241
NC_035782.1,24278418,24321500,24278418,24321500,111123051,XM_022465139.1,uncharacterized LOC111123051,43082
NC_035780.1,43136171,43138692,43136171,43138692,111123055,XM_022465148.1,uncharacterized LOC111123055,2521
NC_035782.1,13065332,13066163,13065332,13066163,111123057,XM_022465147.1,uncharacterized LOC111123057,831
NC_035782.1,13067729,13068953,13067729,13068953,111123060,XM_022465150.1,uncharacterized LOC111123060,1224
NC_035782.1,74521369,74528491,74521369,74528491,111123062,XM_022465152.1,uncharacterized LOC111123062,7122
NC_035782.1,74502413,74513928,74502413,74513928,111123063,XM_022465153.1,uncharacterized LOC111123063,11515
NC_035782.1,74703264,74705656,74703264,74705656,111123067,XM_022465156.1,uncharacterized LOC111123067,2392
NC_035782.1,23877739,23879553,23877739,23879553,111123071,XM_022465163.1,uncharacterized LOC111123071,1814
NC_035782.1,57173192,57187179,57173192,57187179,111123076,XM_022465168.1,uncharacterized LOC111123076,13987
NC_035782.1,75019305,75029894,75019305,75029654,111123085,XM_022465179.1,uncharacterized LOC111123085,10349
NC_035782.1,75019305,75029894,75019305,75029853,111123085,XM_022465180.1,uncharacterized LOC111123085,10548
NC_035782.1,75019305,75029894,75019305,75029894,111123085,XM_022465181.1,uncharacterized LOC111123085,10589
NC_035780.1,39175787,39191371,39175787,39190212,111123092,XM_022465210.1,uncharacterized LOC111123092,14425
NC_035780.1,39175787,39191371,39175787,39191371,111123092,XM_022465193.1,uncharacterized LOC111123092,15584
NC_035782.1,46587590,46591088,46587590,46591088,111123101,XM_022465205.1,uncharacterized LOC111123101,3498
NC_035782.1,25399432,25493085,25452934,25493052,111123104,XM_022465211.1,uncharacterized LOC111123104,40118
NC_035782.1,25399432,25493085,25452934,25493085,111123104,XM_022465214.1,uncharacterized LOC111123104,40151
NC_035782.1,25399432,25493085,25399432,25493085,111123104,XM_022465212.1,uncharacterized LOC111123104,93653
NC_035782.1,25494661,25503774,25494661,25503774,111123105,XM_022465215.1,uncharacterized LOC111123105,9113
NC_035782.1,25389043,25394174,25389043,25394174,111123106,XM_022465216.1,uncharacterized LOC111123106,5131
NC_035782.1,25441483,25442880,25441483,25442880,111123107,XM_022465217.1,uncharacterized LOC111123107,1397
NC_035782.1,25438077,25441207,25438077,25440958,111123108,XM_022465218.1,uncharacterized LOC111123108,2881
NC_035780.1,34349292,34355296,34349292,34355296,111123109,XM_022465222.1,uncharacterized LOC111123109,6004
NC_035782.1,7283920,7314112,7284060,7314112,111123112,XM_022465223.1,uncharacterized LOC111123112,30052
NC_035782.1,7283920,7314112,7283920,7314112,111123112,XM_022465221.1,uncharacterized LOC111123112,30192
NC_035782.1,18814528,18817841,18814528,18817841,111123116,XM_022465229.1,uncharacterized LOC111123116,3313
NC_035780.1,24992749,24995259,24992749,24995259,111123118,XM_022465235.1,uncharacterized LOC111123118,2510
NC_035782.1,65090949,65095872,65093389,65095872,111123119,XM_022465234.1,uncharacterized LOC111123119,2483
NC_035782.1,65090949,65095872,65090950,65093845,111123119,XM_022465236.1,uncharacterized LOC111123119,2895
NC_035782.1,65090949,65095872,65090949,65094435,111123119,XM_022465233.1,uncharacterized LOC111123119,3486
NC_035782.1,46591355,46595140,46591355,46595140,111123120,XM_022465237.1,uncharacterized LOC111123120,3785
NC_035782.1,18577986,18583550,18577986,18583550,111123122,XM_022465239.1,uncharacterized LOC111123122,5564
NC_035782.1,30918828,30923221,30918828,30923209,111123135,XM_022465277.1,uncharacterized LOC111123135,4381
NC_035782.1,30918828,30923221,30918828,30923221,111123135,XM_022465275.1,uncharacterized LOC111123135,4393
NC_035782.1,43009127,43014991,43009127,43014991,111123137,XM_022465281.1,uncharacterized LOC111123137,5864
NC_035782.1,63697483,63702649,63697483,63702643,111123138,XM_022465283.1,uncharacterized LOC111123138,5160
NC_035782.1,63694146,63695816,63694146,63695816,111123139,XM_022465284.1,uncharacterized LOC111123139,1670
NC_035780.1,37963182,37965430,37963182,37965430,111123140,XM_022465288.1,uncharacterized LOC111123140,2248
NC_035782.1,54108767,54119651,54108838,54119651,111123143,XM_022465291.1,uncharacterized LOC111123143,10813
NC_035782.1,54108767,54119651,54108767,54119651,111123143,XM_022465289.1,uncharacterized LOC111123143,10884
NC_035782.1,54108767,54119651,54109959,54119651,111123143,XM_022465290.1,uncharacterized LOC111123143,9692
NC_035782.1,17365442,17373423,17365442,17373423,111123158,XM_022465312.1,uncharacterized LOC111123158,7981
NC_035782.1,17359627,17365431,17359627,17365431,111123160,XM_022465313.1,uncharacterized LOC111123160,5804
NC_035782.1,36026046,36040170,36026046,36040170,111123161,XM_022465314.1,uncharacterized LOC111123161,14124
NC_035780.1,11491370,11500079,11491370,11500079,111123163,XM_022465320.1,uncharacterized LOC111123163,8709
NC_035782.1,2830835,2838193,2830835,2835920,111123165,XM_022465322.1,uncharacterized LOC111123165,5085
NC_035782.1,2830835,2838193,2830835,2838193,111123165,XM_022465323.1,uncharacterized LOC111123165,7358
NC_035782.1,2800567,2803101,2800567,2803101,111123167,XM_022465325.1,uncharacterized LOC111123167,2534
NC_035780.1,30794918,30802139,30794918,30802139,111123169,XM_022465333.1,uncharacterized LOC111123169,7221
NC_035782.1,2938880,2947722,2938883,2947722,111123170,XM_022465331.1,uncharacterized LOC111123170,8839
NC_035782.1,2938880,2947722,2938880,2947722,111123170,XM_022465330.1,uncharacterized LOC111123170,8842
NC_035782.1,2910807,2925968,2910807,2925968,111123171,XM_022465332.1,uncharacterized LOC111123171,15161
NC_035782.1,3095589,3098540,3095589,3098540,111123172,XM_022465335.1,uncharacterized LOC111123172,2951
NC_035782.1,2931128,2938504,2931128,2938504,111123173,XM_022465336.1,uncharacterized LOC111123173,7376
NC_035782.1,3224035,3228843,3224035,3228843,111123175,XM_022465337.1,uncharacterized LOC111123175,4808
NC_035782.1,3268758,3273423,3268758,3273423,111123177,XM_022465339.1,uncharacterized LOC111123177,4665
NC_035782.1,2901987,2906078,2901987,2906078,111123179,XM_022465341.1,uncharacterized LOC111123179,4091
NC_035782.1,4475067,4487413,4475067,4487413,111123183,XM_022465349.1,uncharacterized LOC111123183,12346
NC_035780.1,17434177,17436750,17434177,17436750,111123185,XM_022465355.1,uncharacterized LOC111123185,2573
NC_035782.1,18461949,18464664,18461949,18464664,111123188,XM_022465356.1,uncharacterized LOC111123188,2715
NC_035782.1,17096800,17098708,17096800,17098708,111123189,XM_022465357.1,uncharacterized LOC111123189,1908
NC_035782.1,10143656,10151063,10147010,10151063,111123190,XM_022465359.1,uncharacterized LOC111123190,4053
NC_035782.1,10143656,10151063,10143656,10151063,111123190,XM_022465358.1,uncharacterized LOC111123190,7407
NC_035782.1,53159376,53161327,53159376,53161327,111123191,XM_022465360.1,uncharacterized LOC111123191,1951
NC_035782.1,38278164,38285062,38278164,38285062,111123193,XM_022465362.1,uncharacterized LOC111123193,6898
NC_035780.1,31909730,31915107,31909730,31915107,111123195,XM_022465367.1,uncharacterized LOC111123195,5377
NC_035782.1,68339234,68351635,68339234,68351635,111123197,XM_022465365.1,uncharacterized LOC111123197,12401
NC_035782.1,60872328,60891861,60872328,60891861,111123198,XM_022465366.1,uncharacterized LOC111123198,19533
NC_035782.1,9864769,9866978,9864769,9866802,111123206,XM_022465377.1,uncharacterized LOC111123206,2033
NC_035782.1,9864769,9866978,9864769,9866978,111123206,XM_022465376.1,uncharacterized LOC111123206,2209
NC_035782.1,27767110,27776881,27767110,27776881,111123212,XM_022465391.1,uncharacterized LOC111123212,9771
NC_035782.1,61624045,61631780,61624045,61631780,111123217,XM_022465397.1,uncharacterized LOC111123217,7735
NC_035782.1,33145075,33152277,33145075,33151130,111123219,XM_022465404.1,uncharacterized LOC111123219,6055
NC_035782.1,33145075,33152277,33145075,33152277,111123219,XM_022465405.1,uncharacterized LOC111123219,7202
NC_035782.1,71107090,71112308,71107090,71112308,111123227,XM_022465418.1,uncharacterized LOC111123227,5218
NC_035782.1,71271108,71280623,71271108,71277514,111123233,XM_022465427.1,uncharacterized LOC111123233,6406
NC_035782.1,71271108,71280623,71271108,71280623,111123233,XM_022465426.1,uncharacterized LOC111123233,9515
NC_035782.1,38987504,38995105,38987504,38995105,111123234,XM_022465428.1,uncharacterized LOC111123234,7601
NC_035782.1,26993283,27007735,26993283,27007735,111123258,XM_022465489.1,uncharacterized LOC111123258,14452
NC_035782.1,27013933,27034202,27013933,27034202,111123259,XM_022465490.1,uncharacterized LOC111123259,20269
NC_035782.1,27142389,27160688,27142408,27160685,111123269,XM_022465510.1,uncharacterized LOC111123269,18277
NC_035782.1,27142389,27160688,27142408,27160688,111123269,XM_022465508.1,uncharacterized LOC111123269,18280
NC_035782.1,27142389,27160688,27142400,27160687,111123269,XM_022465511.1,uncharacterized LOC111123269,18287
NC_035782.1,27142389,27160688,27142408,27145993,111123269,XM_022465509.1,uncharacterized LOC111123269,3585
NC_035782.1,27142389,27160688,27142389,27145989,111123269,XM_022465512.1,uncharacterized LOC111123269,3600
NC_035782.1,27204602,27208316,27204602,27208316,111123272,XM_022465514.1,uncharacterized LOC111123272,3714
NC_035782.1,27217147,27223575,27217147,27223530,111123273,XM_022465518.1,uncharacterized LOC111123273,6383
NC_035782.1,27217147,27223575,27217147,27223559,111123273,XM_022465516.1,uncharacterized LOC111123273,6412
NC_035782.1,27217147,27223575,27217147,27223575,111123273,XM_022465517.1,uncharacterized LOC111123273,6428
NC_035782.1,27106635,27109883,27106635,27109883,111123274,XM_022465519.1,uncharacterized LOC111123274,3248
NC_035782.1,27165077,27171435,27165077,27171435,111123275,XM_022465521.1,uncharacterized LOC111123275,6358
NC_035782.1,27192873,27194722,27192876,27194722,111123276,XM_022465522.1,uncharacterized LOC111123276,1846
NC_035782.1,27192873,27194722,27192873,27194722,111123276,XM_022465523.1,uncharacterized LOC111123276,1849
NC_035782.1,27111742,27123002,27111742,27123002,111123277,XM_022465524.1,uncharacterized LOC111123277,11260
NC_035782.1,70459991,70462821,70459991,70462471,111123283,XM_022465527.1,uncharacterized LOC111123283,2480
NC_035782.1,70459991,70462821,70459991,70462821,111123283,XM_022465525.1,uncharacterized LOC111123283,2830
NC_035782.1,7886272,7891064,7886272,7891064,111123284,XM_022465528.1,uncharacterized LOC111123284,4792
NC_035782.1,11461064,11474446,11461064,11474446,111123289,XM_022465532.1,uncharacterized LOC111123289,13382
NC_035782.1,75797588,75815931,75797588,75814144,111123290,XM_022465536.1,uncharacterized LOC111123290,16556
NC_035782.1,75797588,75815931,75797588,75815920,111123290,XM_022465535.1,uncharacterized LOC111123290,18332
NC_035782.1,75797588,75815931,75797588,75815931,111123290,XM_022465534.1,uncharacterized LOC111123290,18343
NC_035782.1,44216426,44218067,44216426,44218067,111123299,XM_022465551.1,uncharacterized LOC111123299,1641
NC_035782.1,31413157,31425043,31413157,31425043,111123302,XM_022465554.1,uncharacterized LOC111123302,11886
NC_035782.1,31781504,31792615,31781504,31792615,111123303,XM_022465555.1,uncharacterized LOC111123303,11111
NC_035780.1,50004086,50013724,50004101,50013724,111123306,XM_022465570.1,uncharacterized LOC111123306,9623
NC_035780.1,50004086,50013724,50004086,50013724,111123306,XM_022465562.1,uncharacterized LOC111123306,9638
NC_035782.1,31433374,31448978,31433374,31448978,111123309,XM_022465563.1,uncharacterized LOC111123309,15604
NC_035782.1,31744558,31753352,31744558,31753352,111123311,XM_022465565.1,uncharacterized LOC111123311,8794
NC_035782.1,20611488,20617140,20611488,20617140,111123319,XM_022465574.1,uncharacterized LOC111123319,5652
NC_035780.1,50020372,50036212,50020372,50036212,111123322,XM_022465580.1,uncharacterized LOC111123322,15840
NC_035782.1,72934598,72940814,72934598,72940814,111123323,XM_022465578.1,uncharacterized LOC111123323,6216
NC_035782.1,51984632,51996719,51988372,51996719,111123328,XM_022465587.1,uncharacterized LOC111123328,8347
NC_035782.1,51984632,51996719,51984638,51993427,111123328,XM_022465586.1,uncharacterized LOC111123328,8789
NC_035780.1,49994903,50001595,49994998,50001595,111123329,XM_022465600.1,uncharacterized LOC111123329,6597
NC_035780.1,49994903,50001595,49994903,50001595,111123329,XM_022465592.1,uncharacterized LOC111123329,6692
NC_035782.1,60901337,60904011,60901337,60904011,111123336,XM_022465601.1,uncharacterized LOC111123336,2674
NC_035782.1,26026535,26039687,26026539,26039687,111123338,XM_022465605.1,uncharacterized LOC111123338,13148
NC_035782.1,26026535,26039687,26026535,26039687,111123338,XM_022465604.1,uncharacterized LOC111123338,13152
NC_035782.1,2079198,2086268,2079198,2086268,111123339,XM_022465606.1,uncharacterized LOC111123339,7070
NC_035782.1,2166159,2188318,2173527,2188318,111123341,XM_022465615.1,uncharacterized LOC111123341,14791
NC_035782.1,2166159,2188318,2172525,2188318,111123341,XM_022465616.1,uncharacterized LOC111123341,15793
NC_035782.1,2166159,2188318,2167621,2188318,111123341,XM_022465609.1,uncharacterized LOC111123341,20697
NC_035782.1,2166159,2188318,2166160,2188318,111123341,XM_022465614.1,uncharacterized LOC111123341,22158
NC_035782.1,2166159,2188318,2166159,2188318,111123341,XM_022465608.1,uncharacterized LOC111123341,22159
NC_035782.1,2106992,2112918,2106992,2112918,111123345,XM_022465627.1,uncharacterized LOC111123345,5926
NC_035782.1,2232965,2235536,2232965,2235536,111123346,XM_022465628.1,uncharacterized LOC111123346,2571
NC_035782.1,19507826,19524713,19513382,19524713,111123356,XM_022465638.1,uncharacterized LOC111123356,11331
NC_035782.1,19507826,19524713,19507826,19524713,111123356,XM_022465639.1,uncharacterized LOC111123356,16887
NC_035782.1,21442174,21452674,21442174,21452674,111123359,XM_022465644.1,uncharacterized LOC111123359,10500
NC_035782.1,49925544,49930740,49925544,49930740,111123362,XM_022465646.1,uncharacterized LOC111123362,5196
NC_035782.1,28317848,28330049,28317963,28330049,111123364,XM_022465649.1,uncharacterized LOC111123364,12086
NC_035782.1,28317848,28330049,28317854,28330049,111123364,XM_022465651.1,uncharacterized LOC111123364,12195
NC_035782.1,28317848,28330049,28317848,28330049,111123364,XM_022465650.1,uncharacterized LOC111123364,12201
NC_035782.1,63862034,63867266,63862034,63867266,111123370,XM_022465658.1,uncharacterized LOC111123370,5232
NC_035782.1,63896445,63908114,63896445,63908114,111123373,XM_022465666.1,uncharacterized LOC111123373,11669
NC_035782.1,63896445,63908114,63899156,63908114,111123373,XM_022465667.1,uncharacterized LOC111123373,8958
NC_035782.1,63764194,63766533,63764194,63766533,111123377,XM_022465677.1,uncharacterized LOC111123377,2339
NC_035782.1,63869509,63873073,63869509,63873073,111123382,XM_022465683.1,uncharacterized LOC111123382,3564
NC_035782.1,63949186,63952193,63949186,63952193,111123386,XM_022465686.1,uncharacterized LOC111123386,3007
NC_035782.1,63952201,63956152,63952201,63956152,111123387,XM_022465687.1,uncharacterized LOC111123387,3951
NC_035782.1,63757249,63758522,63757249,63758522,111123389,XM_022465690.1,uncharacterized LOC111123389,1273
NC_035782.1,63754259,63756490,63754259,63755629,111123390,XM_022465691.1,uncharacterized LOC111123390,1370
NC_035782.1,63754259,63756490,63754259,63756489,111123390,XM_022465692.1,uncharacterized LOC111123390,2230
NC_035782.1,63754259,63756490,63754259,63756490,111123390,XM_022465694.1,uncharacterized LOC111123390,2231
NC_035782.1,63761490,63762641,63761490,63762641,111123391,XM_022465695.1,uncharacterized LOC111123391,1151
NC_035780.1,50185138,50188092,50185138,50187880,111123395,XM_022465705.1,uncharacterized LOC111123395,2742
NC_035780.1,50185138,50188092,50185138,50188092,111123395,XM_022465697.1,uncharacterized LOC111123395,2954
NC_035782.1,73103407,73108618,73103407,73108618,111123404,XM_022465703.1,uncharacterized LOC111123404,5211
NC_035782.1,6501481,6502290,6501481,6502290,111123405,XM_022465704.1,uncharacterized LOC111123405,809
NC_035782.1,55532323,55547904,55532323,55543928,111123409,XM_022465707.1,uncharacterized LOC111123409,11605
NC_035782.1,55532323,55547904,55532323,55547904,111123409,XM_022465710.1,uncharacterized LOC111123409,15581
NC_035782.1,55532323,55547904,55532323,55538691,111123409,XM_022465709.1,uncharacterized LOC111123409,6368
NC_035780.1,50166867,50176803,50169340,50176803,111123411,XM_022465717.1,uncharacterized LOC111123411,7463
NC_035780.1,50166867,50176803,50166867,50176803,111123411,XM_022465726.1,uncharacterized LOC111123411,9936
NC_035782.1,6195619,6206321,6195619,6206321,111123413,XM_022465715.1,uncharacterized LOC111123413,10702
NC_035782.1,6144617,6149550,6144617,6149550,111123416,XM_022465723.1,uncharacterized LOC111123416,4933
NC_035782.1,44931702,44953338,44931702,44953338,111123420,XM_022465730.1,uncharacterized LOC111123420,21636
NC_035780.1,50188832,50192154,50188832,50192154,111123424,XM_022465738.1,uncharacterized LOC111123424,3322
NC_035782.1,14409525,14456024,14409525,14456024,111123425,XM_022465736.1,uncharacterized LOC111123425,46499
NC_035782.1,14575984,14592167,14575984,14592167,111123426,XM_022465737.1,uncharacterized LOC111123426,16183
NC_035782.1,14615235,14623302,14615235,14623302,111123428,XM_022465740.1,uncharacterized LOC111123428,8067
NC_035782.1,14529091,14561936,14529091,14561936,111123429,XM_022465742.1,uncharacterized LOC111123429,32845
NC_035782.1,67195422,67203645,67197226,67203645,111123432,XM_022465744.1,uncharacterized LOC111123432,6419
NC_035782.1,67195422,67203645,67195422,67203645,111123432,XM_022465746.1,uncharacterized LOC111123432,8223
NC_035782.1,34059055,34063924,34059187,34063924,111123435,XM_022465748.1,uncharacterized LOC111123435,4737
NC_035782.1,34059055,34063924,34059055,34063924,111123435,XM_022465751.1,uncharacterized LOC111123435,4869
NC_035782.1,34068029,34071723,34068595,34071723,111123436,XM_022465753.1,uncharacterized LOC111123436,3128
NC_035782.1,34068029,34071723,34068029,34071723,111123436,XM_022465752.1,uncharacterized LOC111123436,3694
NC_035782.1,34438564,34442935,34438564,34442935,111123437,XM_022465754.1,uncharacterized LOC111123437,4371
NC_035782.1,34322322,34329863,34322322,34329863,111123438,XM_022465755.1,uncharacterized LOC111123438,7541
NC_035782.1,34183780,34186330,34183780,34186330,111123441,XM_022465759.1,uncharacterized LOC111123441,2550
NC_035782.1,34334671,34336391,34334671,34336391,111123442,XM_022465760.1,uncharacterized LOC111123442,1720
NC_035782.1,34111242,34114141,34112021,34114141,111123443,XM_022465761.1,uncharacterized LOC111123443,2120
NC_035782.1,34503554,34506645,34503554,34506645,111123444,XM_022465762.1,uncharacterized LOC111123444,3091
NC_035782.1,27740411,27745100,27740411,27745100,111123448,XM_022465763.1,uncharacterized LOC111123448,4689
NC_035782.1,22975374,22998503,22975374,22998503,111123449,XM_022465765.1,uncharacterized LOC111123449,23129
NC_035782.1,27732803,27737002,27732803,27737002,111123450,XM_022465766.1,uncharacterized LOC111123450,4199
NC_035782.1,15547530,15553635,15547530,15553635,111123459,XM_022465773.1,uncharacterized LOC111123459,6105
NC_035780.1,49219396,49222834,49219396,49222834,111123461,XM_022465780.1,uncharacterized LOC111123461,3438
NC_035780.1,61853900,61874193,61853900,61874193,111123464,XM_022465829.1,uncharacterized LOC111123464,20293
NC_035782.1,74233061,74234619,74233061,74234574,111123466,XM_022465790.1,uncharacterized LOC111123466,1513
NC_035782.1,74233061,74234619,74233061,74234619,111123466,XM_022465791.1,uncharacterized LOC111123466,1558
NC_035782.1,33090824,33092330,33090824,33092330,111123468,XM_022465793.1,uncharacterized LOC111123468,1506
NC_035782.1,16035566,16043763,16035566,16043763,111123469,XM_022465794.1,uncharacterized LOC111123469,8197
NC_035780.1,17236828,17264067,17236831,17264067,111123472,XM_022465806.1,uncharacterized LOC111123472,27236
NC_035780.1,17236828,17264067,17236828,17264067,111123472,XM_022465799.1,uncharacterized LOC111123472,27239
NC_035782.1,47414742,47417824,47414742,47417824,111123474,XM_022465797.1,uncharacterized LOC111123474,3082
NC_035782.1,28340113,28349009,28340113,28349009,111123475,XM_022465798.1,uncharacterized LOC111123475,8896
NC_035782.1,19338541,19346154,19338541,19346154,111123481,XM_022465808.1,uncharacterized LOC111123481,7613
NC_035782.1,26492006,26494540,26492006,26494540,111123482,XM_022465809.1,uncharacterized LOC111123482,2534
NC_035782.1,37765314,37795757,37777797,37795757,111123483,XM_022465822.1,uncharacterized LOC111123483,17960
NC_035782.1,37765314,37795757,37774843,37795757,111123483,XM_022465812.1,uncharacterized LOC111123483,20914
NC_035782.1,37765314,37795757,37772046,37795757,111123483,XM_022465816.1,uncharacterized LOC111123483,23711
NC_035782.1,37765314,37795757,37771728,37795757,111123483,XM_022465823.1,uncharacterized LOC111123483,24029
NC_035782.1,37765314,37795757,37771573,37795757,111123483,XM_022465814.1,uncharacterized LOC111123483,24184
NC_035782.1,37765314,37795757,37771505,37795757,111123483,XM_022465820.1,uncharacterized LOC111123483,24252
NC_035782.1,37765314,37795757,37770869,37795757,111123483,XM_022465813.1,uncharacterized LOC111123483,24888
NC_035782.1,37765314,37795757,37770692,37795757,111123483,XM_022465817.1,uncharacterized LOC111123483,25065
NC_035782.1,37765314,37795757,37767669,37794564,111123483,XM_022465818.1,uncharacterized LOC111123483,26895
NC_035782.1,37765314,37795757,37768640,37795757,111123483,XM_022465824.1,uncharacterized LOC111123483,27117
NC_035782.1,37765314,37795757,37768638,37795757,111123483,XM_022465815.1,uncharacterized LOC111123483,27119
NC_035782.1,37765314,37795757,37767669,37795757,111123483,XM_022465810.1,uncharacterized LOC111123483,28088
NC_035782.1,37765314,37795757,37765314,37795757,111123483,XM_022465819.1,uncharacterized LOC111123483,30443
NC_035782.1,64175323,64177597,64175323,64177597,111123487,XM_022465826.1,uncharacterized LOC111123487,2274
NC_035782.1,50306001,50316368,50306001,50316368,111123490,XM_022465832.1,uncharacterized LOC111123490,10367
NC_035782.1,43790257,43814306,43790257,43814306,111123495,XM_022465870.1,uncharacterized LOC111123495,24049
NC_035782.1,43680128,43692554,43680128,43692554,111123501,XM_022465888.1,uncharacterized LOC111123501,12426
NC_035782.1,43698423,43710068,43698423,43710068,111123502,XM_022465890.1,uncharacterized LOC111123502,11645
NC_035782.1,43714456,43729326,43714456,43729326,111123503,XM_022465891.1,uncharacterized LOC111123503,14870
NC_035782.1,43907876,43912175,43907876,43912175,111123508,XM_022465896.1,uncharacterized LOC111123508,4299
NC_035782.1,43676648,43679438,43676648,43679438,111123510,XM_022465899.1,uncharacterized LOC111123510,2790
NC_035782.1,43878279,43880902,43878279,43880902,111123511,XM_022465900.1,uncharacterized LOC111123511,2623
NC_035782.1,43780430,43787879,43780430,43781917,111123512,XM_022465903.1,uncharacterized LOC111123512,1487
NC_035782.1,43780430,43787879,43785957,43787879,111123512,XM_022465902.1,uncharacterized LOC111123512,1922
NC_035782.1,43780430,43787879,43780438,43787879,111123512,XM_022465901.1,uncharacterized LOC111123512,7441
NC_035782.1,21396226,21408465,21396237,21408464,111123514,XM_022465904.1,uncharacterized LOC111123514,12227
NC_035782.1,21396226,21408465,21396226,21408465,111123514,XM_022465906.1,uncharacterized LOC111123514,12239
NC_035782.1,11948629,11951857,11948629,11951857,111123519,XM_022465910.1,uncharacterized LOC111123519,3228
NC_035782.1,51212998,51215457,51212998,51215457,111123525,XM_022465915.1,uncharacterized LOC111123525,2459
NC_035780.1,61892491,61909117,61892491,61909117,111123528,XM_022465957.1,uncharacterized LOC111123528,16626
NC_035780.1,54870508,54873805,54870508,54873805,111123529,XM_022465922.1,uncharacterized LOC111123529,3297
NC_035782.1,25510395,25511810,25510395,25511810,111123530,XM_022465918.1,uncharacterized LOC111123530,1415
NC_035782.1,45754451,45761670,45754451,45761670,111123531,XM_022465919.1,uncharacterized LOC111123531,7219
NC_035782.1,18567115,18573307,18567115,18570886,111123532,XM_022465921.1,uncharacterized LOC111123532,3771
NC_035782.1,18567115,18573307,18567115,18573307,111123532,XM_022465920.1,uncharacterized LOC111123532,6192
NC_035782.1,71054780,71065009,71054780,71065009,111123533,XM_022465923.1,uncharacterized LOC111123533,10229
NC_035782.1,71054780,71065009,71056217,71065009,111123533,XM_022465925.1,uncharacterized LOC111123533,8792
NC_035782.1,38786338,38792173,38790343,38792173,111123537,XM_022465928.1,uncharacterized LOC111123537,1830
NC_035782.1,18960396,18965090,18960396,18965090,111123541,XM_022465931.1,uncharacterized LOC111123541,4694
NC_035782.1,59415713,59416826,59415713,59416826,111123542,XM_022465933.1,uncharacterized LOC111123542,1113
NC_035782.1,51713970,51733506,51713970,51733506,111123549,XM_022465943.1,uncharacterized LOC111123549,19536
NC_035782.1,9462117,9509291,9462117,9506592,111123550,XM_022465945.1,uncharacterized LOC111123550,44475
NC_035782.1,9462117,9509291,9462117,9506610,111123550,XM_022465946.1,uncharacterized LOC111123550,44493
NC_035782.1,9462117,9509291,9462117,9506634,111123550,XM_022465954.1,uncharacterized LOC111123550,44517
NC_035782.1,9462117,9509291,9462117,9509291,111123550,XM_022465947.1,uncharacterized LOC111123550,47174
NC_035782.1,26050428,26058556,26050428,26058556,111123552,XM_022465955.1,uncharacterized LOC111123552,8128
NC_035782.1,43375072,43393017,43377111,43393017,111123557,XM_022465961.1,uncharacterized LOC111123557,15906
NC_035782.1,43375072,43393017,43375072,43393017,111123557,XM_022465959.1,uncharacterized LOC111123557,17945
NC_035782.1,76213636,76219970,76214893,76219970,111123558,XM_022465964.1,uncharacterized LOC111123558,5077
NC_035782.1,76213636,76219970,76213636,76219970,111123558,XM_022465965.1,uncharacterized LOC111123558,6334
NC_035782.1,25519574,25522390,25519574,25522390,111123559,XM_022465966.1,uncharacterized LOC111123559,2816
NC_035782.1,69515069,69522686,69515069,69522686,111123561,XM_022465968.1,uncharacterized LOC111123561,7617
NC_035782.1,65034953,65038737,65034953,65038737,111123562,XM_022465969.1,uncharacterized LOC111123562,3784
NC_035782.1,39392777,39398566,39396736,39398566,111123563,XM_022465971.1,uncharacterized LOC111123563,1830
NC_035782.1,9597933,9614636,9597933,9614636,111123564,XM_022465972.1,uncharacterized LOC111123564,16703
NC_035782.1,20204310,20222556,20204310,20222556,111123565,XM_022465973.1,uncharacterized LOC111123565,18246
NC_035782.1,49049864,49051956,49049864,49051956,111123566,XM_022465974.1,uncharacterized LOC111123566,2092
NC_035782.1,50824388,50832572,50828934,50831169,111123571,XM_022465979.1,uncharacterized LOC111123571,2235
NC_035782.1,50824388,50832572,50828928,50831167,111123571,XM_022465976.1,uncharacterized LOC111123571,2239
NC_035782.1,50824388,50832572,50828928,50831614,111123571,XM_022465978.1,uncharacterized LOC111123571,2686
NC_035782.1,50824388,50832572,50828928,50832572,111123571,XM_022465977.1,uncharacterized LOC111123571,3644
NC_035782.1,50824388,50832572,50824388,50831167,111123571,XM_022465980.1,uncharacterized LOC111123571,6779
NC_035782.1,50824388,50832572,50824388,50831169,111123571,XM_022465981.1,uncharacterized LOC111123571,6781
NC_035782.1,69347676,69352758,69347676,69352758,111123572,XM_022465982.1,uncharacterized LOC111123572,5082
NC_035782.1,24979692,24980174,24979692,24980174,111123573,XM_022465983.1,uncharacterized LOC111123573,482
NC_035782.1,18478860,18482184,18478860,18482184,111123577,XM_022465997.1,uncharacterized LOC111123577,3324
NC_035782.1,39317799,39324124,39317799,39321004,111123585,XM_022466008.1,uncharacterized LOC111123585,3205
NC_035782.1,39317799,39324124,39317799,39321005,111123585,XM_022466009.1,uncharacterized LOC111123585,3206
NC_035782.1,39317799,39324124,39317799,39324121,111123585,XM_022466007.1,uncharacterized LOC111123585,6322
NC_035782.1,39317799,39324124,39317799,39324123,111123585,XM_022466011.1,uncharacterized LOC111123585,6324
NC_035782.1,39317799,39324124,39317799,39324124,111123585,XM_022466013.1,uncharacterized LOC111123585,6325
NC_035782.1,53949628,53952259,53949628,53952259,111123589,XM_022466021.1,uncharacterized LOC111123589,2631
NC_035782.1,53952608,53954815,53952608,53954815,111123590,XM_022466022.1,uncharacterized LOC111123590,2207
NC_035782.1,26875990,26879879,26875990,26877844,111123596,XM_022466028.1,uncharacterized LOC111123596,1854
NC_035782.1,26875990,26879879,26875990,26879879,111123596,XM_022466029.1,uncharacterized LOC111123596,3889
NC_035782.1,63604816,63608914,63604816,63608914,111123599,XM_022466032.1,uncharacterized LOC111123599,4098
NC_035782.1,3730179,3748722,3730179,3748722,111123600,XM_022466033.1,uncharacterized LOC111123600,18543
NC_035780.1,61843407,61846126,61843407,61846126,111123603,XM_022466080.1,uncharacterized LOC111123603,2719
NC_035782.1,6552501,6562402,6552501,6562402,111123606,XM_022466040.1,uncharacterized LOC111123606,9901
NC_035782.1,25994230,25996616,25994230,25996616,111123609,XM_022466044.1,uncharacterized LOC111123609,2386
NC_035782.1,73833845,73855112,73833845,73855112,111123612,XM_022466060.1,uncharacterized LOC111123612,21267
NC_035780.1,37889694,37896991,37889694,37896991,111123613,XM_022466065.1,uncharacterized LOC111123613,7297
NC_035782.1,36306642,36307509,36306642,36307509,111123614,XM_022466064.1,uncharacterized LOC111123614,867
NC_035782.1,36305193,36306018,36305193,36306018,111123615,XM_022466066.1,uncharacterized LOC111123615,825
NC_035782.1,23751180,23756729,23751183,23752326,111123619,XM_022466073.1,uncharacterized LOC111123619,1143
NC_035782.1,23751180,23756729,23751184,23752337,111123619,XM_022466072.1,uncharacterized LOC111123619,1153
NC_035782.1,23751180,23756729,23751180,23756729,111123619,XM_022466074.1,uncharacterized LOC111123619,5549
NC_035780.1,64727402,64748487,64727402,64748487,111123632,XM_022466095.1,uncharacterized LOC111123632,21085
NC_035782.1,36779752,36807824,36779752,36807824,111123634,XM_022466093.1,uncharacterized LOC111123634,28072
NC_035782.1,26302057,26308023,26302057,26308023,111123635,XM_022466094.1,uncharacterized LOC111123635,5966
NC_035782.1,41759936,41762221,41759936,41762218,111123636,XM_022466096.1,uncharacterized LOC111123636,2282
NC_035782.1,41759936,41762221,41759936,41762221,111123636,XM_022466097.1,uncharacterized LOC111123636,2285
NC_035782.1,17309177,17312097,17309177,17312097,111123638,XM_022466100.1,uncharacterized LOC111123638,2920
NC_035782.1,73906109,73922141,73907087,73922141,111123640,XM_022466102.1,uncharacterized LOC111123640,15054
NC_035782.1,73906109,73922141,73906109,73922141,111123640,XM_022466101.1,uncharacterized LOC111123640,16032
NC_035782.1,42581185,42601524,42581185,42601524,111123642,XM_022466103.1,uncharacterized LOC111123642,20339
NC_035782.1,42045650,42051820,42045650,42051820,111123645,XM_022466108.1,uncharacterized LOC111123645,6170
NC_035780.1,17028227,17036813,17028227,17036813,111123649,XM_022466121.1,uncharacterized LOC111123649,8586
NC_035782.1,68840053,68844375,68840053,68844375,111123651,XM_022466130.1,uncharacterized LOC111123651,4322
NC_035782.1,1714855,1724436,1714855,1724436,111123653,XM_022466131.1,uncharacterized LOC111123653,9581
NC_035782.1,23382400,23390931,23382414,23390931,111123654,XM_022466132.1,uncharacterized LOC111123654,8517
NC_035782.1,23382400,23390931,23382400,23390931,111123654,XM_022466133.1,uncharacterized LOC111123654,8531
NC_035782.1,23390956,23395178,23390956,23395178,111123655,XM_022466135.1,uncharacterized LOC111123655,4222
NC_035782.1,29877829,29885840,29877829,29885840,111123663,XM_022466156.1,uncharacterized LOC111123663,8011
NC_035780.1,52074344,52079728,52074344,52079728,111123668,XM_022466210.1,uncharacterized LOC111123668,5384
NC_035782.1,8342597,8373140,8342597,8373140,111123678,XM_022466180.1,uncharacterized LOC111123678,30543
NC_035782.1,20696780,20713524,20696780,20713524,111123685,XM_022466186.1,uncharacterized LOC111123685,16744
NC_035782.1,12671627,12678155,12671628,12678135,111123687,XM_022466189.1,uncharacterized LOC111123687,6507
NC_035782.1,12671627,12678155,12671627,12678155,111123687,XM_022466188.1,uncharacterized LOC111123687,6528
NC_035782.1,57724018,57733947,57724159,57733946,111123689,XM_022466192.1,uncharacterized LOC111123689,9787
NC_035782.1,57724018,57733947,57724158,57733947,111123689,XM_022466193.1,uncharacterized LOC111123689,9789
NC_035782.1,57724018,57733947,57724018,57733945,111123689,XM_022466194.1,uncharacterized LOC111123689,9927
NC_035782.1,5159760,5161006,5159760,5161006,111123690,XM_022466195.1,uncharacterized LOC111123690,1246
NC_035782.1,50350133,50357908,50350133,50357908,111123694,XM_022466214.1,uncharacterized LOC111123694,7775
NC_035782.1,50343100,50350233,50343100,50350233,111123695,XM_022466216.1,uncharacterized LOC111123695,7133
NC_035782.1,42862649,42864999,42862649,42864999,111123697,XM_022466218.1,uncharacterized LOC111123697,2350
NC_035782.1,62283767,62290160,62283767,62290160,111123701,XM_022466227.1,uncharacterized LOC111123701,6393
NC_035782.1,62320957,62325658,62320957,62325658,111123704,XM_022466234.1,uncharacterized LOC111123704,4701
NC_035782.1,62291034,62293407,62291034,62293407,111123711,XM_022466243.1,uncharacterized LOC111123711,2373
NC_035782.1,62276697,62279028,62276697,62279028,111123712,XM_022466244.1,uncharacterized LOC111123712,2331
NC_035782.1,62332232,62334632,62332279,62334632,111123714,XM_022466248.1,uncharacterized LOC111123714,2353
NC_035782.1,62332232,62334632,62332232,62334632,111123714,XM_022466247.1,uncharacterized LOC111123714,2400
NC_035782.1,4404353,4414689,4404353,4414689,111123716,XM_022466249.1,uncharacterized LOC111123716,10336
NC_035782.1,4404353,4414689,4404750,4414674,111123716,XM_022466250.1,uncharacterized LOC111123716,9924
NC_035782.1,40367038,40371682,40367038,40368223,111123717,XM_022466251.1,uncharacterized LOC111123717,1185
NC_035782.1,27465697,27470731,27465697,27470731,111123718,XM_022466252.1,uncharacterized LOC111123718,5034
NC_035782.1,29982197,29985735,29982197,29985735,111123719,XM_022466253.1,uncharacterized LOC111123719,3538
NC_035782.1,31253915,31259076,31253915,31259076,111123720,XM_022466254.1,uncharacterized LOC111123720,5161
NC_035782.1,6519510,6522856,6519518,6522856,111123721,XM_022466255.1,uncharacterized LOC111123721,3338
NC_035782.1,6519510,6522856,6519510,6522856,111123721,XM_022466256.1,uncharacterized LOC111123721,3346
NC_035780.1,34944360,34947721,34944360,34947721,111123722,XM_022466260.1,uncharacterized LOC111123722,3361
NC_035782.1,71589636,71598660,71589636,71598660,111123725,XM_022466262.1,uncharacterized LOC111123725,9024
NC_035782.1,29364190,29373052,29364190,29373050,111123726,XM_022466264.1,uncharacterized LOC111123726,8860
NC_035782.1,29364190,29373052,29364190,29373052,111123726,XM_022466263.1,uncharacterized LOC111123726,8862
NC_035782.1,29391296,29395770,29391296,29395770,111123727,XM_022466265.1,uncharacterized LOC111123727,4474
NC_035782.1,51223538,51244110,51223539,51244110,111123734,XM_022466273.1,uncharacterized LOC111123734,20571
NC_035782.1,51223538,51244110,51223538,51244110,111123734,XM_022466271.1,uncharacterized LOC111123734,20572
NC_035782.1,4414901,4423278,4414901,4423278,111123737,XM_022466277.1,uncharacterized LOC111123737,8377
NC_035782.1,10276930,10279936,10276930,10279936,111123739,XM_022466279.1,uncharacterized LOC111123739,3006
NC_035782.1,26519957,26525173,26519957,26525173,111123740,XM_022466281.1,uncharacterized LOC111123740,5216
NC_035780.1,2897281,2904164,2898726,2904164,111123745,XM_022466322.1,uncharacterized LOC111123745,5438
NC_035780.1,2897281,2904164,2897377,2904164,111123745,XM_022466305.1,uncharacterized LOC111123745,6787
NC_035780.1,2897281,2904164,2897281,2904164,111123745,XM_022466314.1,uncharacterized LOC111123745,6883
NC_035782.1,65406630,65421934,65406630,65420102,111123749,XM_022466309.1,uncharacterized LOC111123749,13472
NC_035782.1,65406630,65421934,65406630,65421801,111123749,XM_022466308.1,uncharacterized LOC111123749,15171
NC_035782.1,65406630,65421934,65406630,65421934,111123749,XM_022466307.1,uncharacterized LOC111123749,15304
NC_035782.1,65442225,65444538,65442225,65444538,111123750,XM_022466310.1,uncharacterized LOC111123750,2313
NC_035782.1,65409056,65410391,65409056,65410391,111123752,XM_022466312.1,uncharacterized LOC111123752,1335
NC_035782.1,1792237,1816091,1792237,1816091,111123755,XM_022466315.1,uncharacterized LOC111123755,23854
NC_035782.1,6610272,6616996,6610272,6616996,111123757,XM_022466320.1,uncharacterized LOC111123757,6724
NC_035782.1,29002967,29005884,29002967,29005884,111123758,XM_022466321.1,uncharacterized LOC111123758,2917
NC_035782.1,46122696,46126648,46122696,46126648,111123760,XM_022466324.1,uncharacterized LOC111123760,3952
NC_035782.1,46763265,46765470,46763265,46765470,111123761,XM_022466325.1,uncharacterized LOC111123761,2205
NC_035780.1,11264267,11268841,11264267,11268841,111123766,XM_022467481.1,uncharacterized LOC111123766,4574
NC_035782.1,61612888,61620247,61612888,61620233,111123768,XM_022466329.1,uncharacterized LOC111123768,7345
NC_035780.1,45791059,45793603,45791059,45793603,111123777,XM_022466343.1,uncharacterized LOC111123777,2544
NC_035782.1,59674851,59691414,59674851,59691414,111123778,XM_022466339.1,uncharacterized LOC111123778,16563
NC_035782.1,59709042,59767384,59709042,59767384,111123779,XM_022466341.1,uncharacterized LOC111123779,58342
NC_035782.1,59709042,59767384,59758831,59767384,111123779,XM_022466340.1,uncharacterized LOC111123779,8553
NC_035782.1,59635121,59640558,59635121,59640558,111123780,XM_022466342.1,uncharacterized LOC111123780,5437
NC_035782.1,59747207,59752200,59747207,59752200,111123782,XM_022466345.1,uncharacterized LOC111123782,4993
NC_035782.1,49985319,49991849,49985319,49991849,111123785,XM_022466347.1,uncharacterized LOC111123785,6530
NC_035782.1,48696387,48699855,48696387,48699855,111123786,XM_022466349.1,uncharacterized LOC111123786,3468
NC_035782.1,20736384,20738556,20736384,20738556,111123795,XM_022466367.1,uncharacterized LOC111123795,2172
NC_035780.1,21026795,21033637,21026795,21033637,111123798,XM_022466384.1,uncharacterized LOC111123798,6842
NC_035782.1,7804127,7808470,7804127,7808470,111123799,XM_022466371.1,uncharacterized LOC111123799,4343
NC_035782.1,48090921,48123303,48103361,48123303,111123801,XM_022466373.1,uncharacterized LOC111123801,19942
NC_035782.1,48090921,48123303,48091238,48123303,111123801,XM_022466375.1,uncharacterized LOC111123801,32065
NC_035782.1,48090921,48123303,48090921,48123303,111123801,XM_022466376.1,uncharacterized LOC111123801,32382
NC_035782.1,28570549,28572293,28570549,28572293,111123803,XM_022466392.1,uncharacterized LOC111123803,1744
NC_035780.1,47092851,47101564,47092851,47101564,111123807,XM_022466407.1,uncharacterized LOC111123807,8713
NC_035782.1,73744884,73755096,73744888,73755089,111123810,XM_022466405.1,uncharacterized LOC111123810,10201
NC_035782.1,73744884,73755096,73744884,73755096,111123810,XM_022466406.1,uncharacterized LOC111123810,10212
NC_035782.1,32791109,32792750,32791109,32792750,111123812,XM_022466409.1,uncharacterized LOC111123812,1641
NC_035782.1,47913075,47916563,47913075,47916563,111123819,XM_022466427.1,uncharacterized LOC111123819,3488
NC_035782.1,47915703,47919252,47915939,47918909,111123820,XM_022466429.1,uncharacterized LOC111123820,2970
NC_035782.1,47915703,47919252,47916073,47919248,111123820,XM_022466431.1,uncharacterized LOC111123820,3175
NC_035782.1,47915703,47919252,47915939,47919244,111123820,XM_022466428.1,uncharacterized LOC111123820,3305
NC_035782.1,50139452,50196211,50139452,50196211,111123822,XM_022466437.1,uncharacterized LOC111123822,56759
NC_035782.1,20825685,20829677,20825685,20829677,111123827,XM_022466452.1,uncharacterized LOC111123827,3992
NC_035782.1,20966843,20967519,20966843,20967519,111123829,XM_022466453.1,uncharacterized LOC111123829,676
NC_035782.1,11191778,11199044,11191778,11199044,111123832,XM_022466458.1,uncharacterized LOC111123832,7266
NC_035782.1,46848685,46878952,46848685,46878952,111123833,XM_022466459.1,uncharacterized LOC111123833,30267
NC_035782.1,26527134,26533167,26527134,26533167,111123834,XM_022466460.1,uncharacterized LOC111123834,6033
NC_035782.1,56142037,56156512,56142037,56156512,111123837,XM_022466464.1,uncharacterized LOC111123837,14475
NC_035780.1,20673030,20683447,20673030,20683447,111123838,XM_022466468.1,uncharacterized LOC111123838,10417
NC_035782.1,60790073,60867412,60790073,60867412,111123845,XM_022466473.1,uncharacterized LOC111123845,77339
NC_035782.1,20145549,20148164,20145549,20148164,111123846,XM_022466474.1,uncharacterized LOC111123846,2615
NC_035782.1,51619105,51624434,51619105,51624434,111123851,XM_022466488.1,uncharacterized LOC111123851,5329
NC_035782.1,59856706,59860690,59856706,59860690,111123859,XM_022466498.1,uncharacterized LOC111123859,3984
NC_035782.1,59861570,59866987,59862204,59866987,111123861,XM_022466499.1,uncharacterized LOC111123861,4783
NC_035782.1,59861570,59866987,59861570,59866987,111123861,XM_022466500.1,uncharacterized LOC111123861,5417
NC_035780.1,20685937,20687552,20685937,20687552,111123862,XM_022466504.1,uncharacterized LOC111123862,1615
NC_035780.1,20642142,20646080,20642142,20646080,111123868,XM_022466513.1,uncharacterized LOC111123868,3938
NC_035782.1,53140324,53144667,53140324,53144667,111123877,XM_022466521.1,uncharacterized LOC111123877,4343
NC_035782.1,1011668,1028925,1011668,1028925,111123880,XM_022466525.1,uncharacterized LOC111123880,17257
NC_035782.1,5195510,5213839,5195510,5207747,111123881,XM_022466526.1,uncharacterized LOC111123881,12237
NC_035782.1,5195510,5213839,5195510,5213839,111123881,XM_022466527.1,uncharacterized LOC111123881,18329
NC_035782.1,5195510,5213839,5195510,5201276,111123881,XM_022466528.1,uncharacterized LOC111123881,5766
NC_035782.1,60755711,60761765,60755711,60761595,111123886,XM_022466537.1,uncharacterized LOC111123886,5884
NC_035782.1,60755711,60761765,60755711,60761765,111123886,XM_022466535.1,uncharacterized LOC111123886,6054
NC_035782.1,29354214,29355421,29354214,29355421,111123887,XM_022466538.1,uncharacterized LOC111123887,1207
NC_035780.1,55140427,55168505,55140427,55156149,111123892,XM_022466564.1,uncharacterized LOC111123892,15722
NC_035780.1,55140427,55168505,55140427,55168505,111123892,XM_022466581.1,uncharacterized LOC111123892,28078
NC_035780.1,55140427,55168505,55140427,55146303,111123892,XM_022466600.1,uncharacterized LOC111123892,5876
NC_035780.1,55140427,55168505,55140427,55146660,111123892,XM_022466590.1,uncharacterized LOC111123892,6233
NC_035782.1,8508757,8517513,8508757,8517513,111123902,XM_022466585.1,uncharacterized LOC111123902,8756
NC_035782.1,15918668,15929666,15918668,15929666,111123906,XM_022466605.1,uncharacterized LOC111123906,10998
NC_035782.1,68413201,68441642,68413201,68441642,111123909,XM_022466611.1,uncharacterized LOC111123909,28441
NC_035780.1,8566212,8575984,8566212,8575984,111123914,XM_022466634.1,uncharacterized LOC111123914,9772
NC_035782.1,68402253,68404220,68402253,68404220,111123915,XM_022466631.1,uncharacterized LOC111123915,1967
NC_035782.1,68406055,68407257,68406055,68407257,111123916,XM_022466632.1,uncharacterized LOC111123916,1202
NC_035782.1,68382809,68385024,68383383,68385024,111123917,XM_022466635.1,uncharacterized LOC111123917,1641
NC_035782.1,68382809,68385024,68383382,68385024,111123917,XM_022466637.1,uncharacterized LOC111123917,1642
NC_035782.1,68382809,68385024,68382809,68385024,111123917,XM_022466633.1,uncharacterized LOC111123917,2215
NC_035782.1,37536572,37615921,37536572,37615921,111123918,XM_022466638.1,uncharacterized LOC111123918,79349
NC_035782.1,37598675,37603011,37598675,37603011,111123919,XM_022466639.1,uncharacterized LOC111123919,4336
NC_035782.1,37545695,37549618,37546706,37549618,111123920,XM_022466641.1,uncharacterized LOC111123920,2912
NC_035782.1,37545695,37549618,37545695,37549618,111123920,XM_022466640.1,uncharacterized LOC111123920,3923
NC_035782.1,30847499,30853081,30847499,30853081,111123924,XM_022466644.1,uncharacterized LOC111123924,5582
NC_035782.1,30839476,30845581,30839476,30845581,111123925,XM_022466645.1,uncharacterized LOC111123925,6105
NC_035782.1,30859794,30866739,30860986,30866739,111123926,XM_022466650.1,uncharacterized LOC111123926,5753
NC_035782.1,30859794,30866739,30860751,30866739,111123926,XM_022466649.1,uncharacterized LOC111123926,5988
NC_035782.1,30859794,30866739,30860693,30866739,111123926,XM_022466648.1,uncharacterized LOC111123926,6046
NC_035782.1,30859794,30866739,30859794,30866739,111123926,XM_022466647.1,uncharacterized LOC111123926,6945
NC_035782.1,30673598,30680584,30673598,30680584,111123931,XM_022466659.1,uncharacterized LOC111123931,6986
NC_035782.1,30855192,30856763,30855192,30856763,111123933,XM_022466661.1,uncharacterized LOC111123933,1571
NC_035782.1,30693469,30719845,30707070,30719845,111123934,XM_022466665.1,uncharacterized LOC111123934,12775
NC_035782.1,30693469,30719845,30696649,30719845,111123934,XM_022466663.1,uncharacterized LOC111123934,23196
NC_035782.1,30693469,30719845,30693469,30719845,111123934,XM_022466662.1,uncharacterized LOC111123934,26376
NC_035782.1,30730887,30732809,30730887,30732790,111123935,XM_022466667.1,uncharacterized LOC111123935,1903
NC_035782.1,30730887,30732809,30730889,30732809,111123935,XM_022466666.1,uncharacterized LOC111123935,1920
NC_035782.1,61520579,61585889,61522402,61570025,111123938,XM_022466675.1,uncharacterized LOC111123938,47623
NC_035782.1,61520579,61585889,61522401,61577942,111123938,XM_022466673.1,uncharacterized LOC111123938,55541
NC_035782.1,61520579,61585889,61522398,61585889,111123938,XM_022466670.1,uncharacterized LOC111123938,63491
NC_035782.1,61520579,61585889,61522395,61585889,111123938,XM_022466674.1,uncharacterized LOC111123938,63494
NC_035782.1,61520579,61585889,61520579,61585889,111123938,XM_022466671.1,uncharacterized LOC111123938,65310
NC_035782.1,32785138,32787830,32785138,32787830,111123944,XM_022466681.1,uncharacterized LOC111123944,2692
NC_035782.1,1738382,1750360,1738382,1750360,111123945,XM_022466682.1,uncharacterized LOC111123945,11978
NC_035782.1,70802712,70819333,70802712,70819333,111123948,XM_022466689.1,uncharacterized LOC111123948,16621
NC_035782.1,70920604,70931431,70920604,70931431,111123949,XM_022466690.1,uncharacterized LOC111123949,10827
NC_035782.1,70827325,70837177,70827325,70837177,111123950,XM_022466691.1,uncharacterized LOC111123950,9852
NC_035780.1,24876346,24880275,24876346,24880275,111123957,XM_022466754.1,uncharacterized LOC111123957,3929
NC_035782.1,6883827,6896331,6883827,6896331,111123962,XM_022466720.1,uncharacterized LOC111123962,12504
NC_035782.1,6883827,6896331,6883827,6888834,111123962,XM_022466718.1,uncharacterized LOC111123962,5007
NC_035782.1,6883827,6896331,6883827,6890916,111123962,XM_022466719.1,uncharacterized LOC111123962,7089
NC_035782.1,22841972,22843114,22841972,22843114,111123974,XM_022466755.1,uncharacterized LOC111123974,1142
NC_035782.1,61335892,61342785,61335892,61342785,111123999,XM_022466828.1,uncharacterized LOC111123999,6893
NC_035782.1,62012299,62014374,62012299,62014374,111124009,XM_022466851.1,uncharacterized LOC111124009,2075
NC_035782.1,62030595,62032415,62030595,62032415,111124010,XM_022466852.1,uncharacterized LOC111124010,1820
NC_035782.1,24047217,24049883,24047217,24049883,111124015,XM_022466859.1,uncharacterized LOC111124015,2666
NC_035782.1,58752844,58773960,58752844,58773960,111124021,XM_022466873.1,uncharacterized LOC111124021,21116
NC_035780.1,32038297,32038827,32038297,32038827,111124024,XM_022466877.1,uncharacterized LOC111124024,530
NC_035780.1,17269675,17276487,17269675,17276487,111124027,XM_022466891.1,uncharacterized LOC111124027,6812
NC_035782.1,25203302,25205832,25203302,25205832,111124028,XM_022466888.1,uncharacterized LOC111124028,2530
NC_035782.1,13628733,13668721,13628733,13668721,111124033,XM_022466896.1,uncharacterized LOC111124033,39988
NC_035782.1,13751167,13766906,13751167,13766906,111124037,XM_022466899.1,uncharacterized LOC111124037,15739
NC_035782.1,14836616,14838109,14836616,14838109,111124042,XM_022466903.1,uncharacterized LOC111124042,1493
NC_035782.1,15461854,15463273,15461854,15463273,111124047,XM_022466907.1,uncharacterized LOC111124047,1419
NC_035782.1,15742478,15746602,15742478,15746602,111124048,XM_022466908.1,uncharacterized LOC111124048,4124
NC_035782.1,15746759,15747631,15746759,15747631,111124049,XM_022466909.1,uncharacterized LOC111124049,872
NC_035782.1,15747652,15748155,15747652,15748155,111124050,XM_022466911.1,uncharacterized LOC111124050,503
NC_035782.1,15858569,15863355,15858569,15863355,111124051,XM_022466912.1,uncharacterized LOC111124051,4786
NC_035782.1,15885167,15888331,15885167,15888331,111124052,XM_022466913.1,uncharacterized LOC111124052,3164
NC_035782.1,16096309,16097409,16096309,16097409,111124055,XM_022466916.1,uncharacterized LOC111124055,1100
NC_035782.1,16372729,16373904,16372729,16373904,111124056,XM_022466917.1,uncharacterized LOC111124056,1175
NC_035782.1,16379455,16381425,16379455,16381425,111124058,XM_022466919.1,uncharacterized LOC111124058,1970
NC_035782.1,16451972,16466682,16451972,16466682,111124059,XM_022466920.1,uncharacterized LOC111124059,14710
NC_035782.1,16744427,16745750,16744427,16745750,111124060,XM_022466921.1,uncharacterized LOC111124060,1323
NC_035782.1,16883190,16885001,16883190,16885001,111124061,XM_022466922.1,uncharacterized LOC111124061,1811
NC_035782.1,16991701,16992183,16991701,16992183,111124063,XM_022466924.1,uncharacterized LOC111124063,482
NC_035782.1,17374884,17377449,17374884,17377449,111124065,XM_022466926.1,uncharacterized LOC111124065,2565
NC_035782.1,17474182,17478195,17474182,17478195,111124067,XM_022466928.1,uncharacterized LOC111124067,4013
NC_035782.1,17689298,17699237,17689298,17699237,111124069,XM_022466931.1,uncharacterized LOC111124069,9939
NC_035782.1,17978069,17980807,17978069,17980807,111124074,XM_022466936.1,uncharacterized LOC111124074,2738
NC_035782.1,17980814,18003312,17980814,18003312,111124075,XM_022466937.1,uncharacterized LOC111124075,22498
NC_035782.1,18176265,18193239,18176265,18193239,111124078,XM_022466939.1,uncharacterized LOC111124078,16974
NC_035782.1,18810310,18812835,18810310,18812835,111124082,XM_022466944.1,uncharacterized LOC111124082,2525
NC_035782.1,18987720,18988313,18987720,18988313,111124083,XM_022466945.1,uncharacterized LOC111124083,593
NC_035782.1,19224139,19228413,19224139,19228413,111124085,XM_022466947.1,uncharacterized LOC111124085,4274
NC_035782.1,19380143,19380633,19380143,19380633,111124086,XM_022466948.1,uncharacterized LOC111124086,490
NC_035782.1,19382777,19385167,19382777,19385167,111124087,XM_022466949.1,uncharacterized LOC111124087,2390
NC_035782.1,20034099,20035452,20034099,20035452,111124093,XM_022466957.1,uncharacterized LOC111124093,1353
NC_035782.1,20362690,20363934,20362690,20363934,111124097,XM_022466961.1,uncharacterized LOC111124097,1244
NC_035782.1,20459533,20461420,20459533,20461420,111124099,XM_022466963.1,uncharacterized LOC111124099,1887
NC_035782.1,20580238,20581185,20580238,20581185,111124100,XM_022466964.1,uncharacterized LOC111124100,947
NC_035782.1,20745879,20746796,20745879,20746796,111124103,XM_022466968.1,uncharacterized LOC111124103,917
NC_035782.1,21044665,21068073,21044665,21068073,111124107,XM_022466972.1,uncharacterized LOC111124107,23408
NC_035782.1,21125727,21132681,21125727,21132681,111124108,XM_022466973.1,uncharacterized LOC111124108,6954
NC_035780.1,4368778,4372780,4368778,4372780,111124109,XM_022466976.1,uncharacterized LOC111124109,4002
NC_035782.1,21185858,21207411,21185858,21207411,111124111,XM_022466974.1,uncharacterized LOC111124111,21553
NC_035782.1,21337892,21351514,21337892,21351514,111124112,XM_022466975.1,uncharacterized LOC111124112,13622
NC_035782.1,21392259,21392900,21392259,21392900,111124113,XM_022466977.1,uncharacterized LOC111124113,641
NC_035782.1,22455605,22458472,22455605,22458472,111124117,XM_022466981.1,uncharacterized LOC111124117,2867
NC_035782.1,22668691,22680916,22668691,22680916,111124121,XM_022466984.1,uncharacterized LOC111124121,12225
NC_035782.1,22998486,23036667,22998486,23036667,111124123,XM_022466987.1,uncharacterized LOC111124123,38181
NC_035782.1,23037505,23060506,23037505,23060506,111124124,XM_022466988.1,uncharacterized LOC111124124,23001
NC_035782.1,23758848,23761053,23758848,23761053,111124127,XM_022466990.1,uncharacterized LOC111124127,2205
NC_035782.1,23811376,23811986,23811376,23811986,111124128,XM_022466992.1,uncharacterized LOC111124128,610
NC_035782.1,24298897,24308484,24298897,24308484,111124130,XM_022466994.1,uncharacterized LOC111124130,9587
NC_035782.1,24605699,24606751,24605699,24606751,111124132,XM_022466996.1,uncharacterized LOC111124132,1052
NC_035782.1,24767795,24821061,24767795,24821061,111124133,XM_022466997.1,uncharacterized LOC111124133,53266
NC_035782.1,24887079,24887780,24887079,24887780,111124135,XM_022466999.1,uncharacterized LOC111124135,701
NC_035782.1,24982595,24983045,24982595,24983045,111124138,XM_022467002.1,uncharacterized LOC111124138,450
NC_035782.1,25021962,25071613,25021962,25071613,111124139,XM_022467003.1,uncharacterized LOC111124139,49651
NC_035782.1,25513604,25519190,25513604,25519190,111124140,XM_022467005.1,uncharacterized LOC111124140,5586
NC_035782.1,25921268,25927502,25921268,25927502,111124141,XM_022467006.1,uncharacterized LOC111124141,6234
NC_035782.1,25944495,25947535,25944495,25947535,111124142,XM_022467007.1,uncharacterized LOC111124142,3040
NC_035782.1,26452839,26453564,26452839,26453564,111124144,XM_022467008.1,uncharacterized LOC111124144,725
NC_035782.1,26704731,26722751,26704731,26722751,111124146,XM_022467009.1,uncharacterized LOC111124146,18020
NC_035782.1,26859385,26861040,26859385,26861040,111124148,XM_022467012.1,uncharacterized LOC111124148,1655
NC_035782.1,26916704,26918692,26916704,26918692,111124150,XM_022467014.1,uncharacterized LOC111124150,1988
NC_035782.1,26946695,26948689,26946695,26948689,111124151,XM_022467015.1,uncharacterized LOC111124151,1994
NC_035782.1,27182228,27184889,27182228,27184889,111124153,XM_022467017.1,uncharacterized LOC111124153,2661
NC_035782.1,27636380,27638129,27636380,27638129,111124159,XM_022467021.1,uncharacterized LOC111124159,1749
NC_035782.1,27917681,27921567,27917681,27921567,111124160,XM_022467022.1,uncharacterized LOC111124160,3886
NC_035782.1,28210615,28217022,28210615,28217022,111124161,XM_022467023.1,uncharacterized LOC111124161,6407
NC_035782.1,28352109,28354951,28352109,28354951,111124163,XM_022467025.1,uncharacterized LOC111124163,2842
NC_035782.1,28604030,28605839,28604030,28605839,111124164,XM_022467026.1,uncharacterized LOC111124164,1809
NC_035782.1,29994639,30027198,29994639,30027198,111124169,XM_022467032.1,uncharacterized LOC111124169,32559
NC_035782.1,30310351,30313670,30310351,30313670,111124170,XM_022467033.1,uncharacterized LOC111124170,3319
NC_035782.1,31334761,31341479,31334761,31341479,111124176,XM_022467038.1,uncharacterized LOC111124176,6718
NC_035782.1,31388514,31389518,31388514,31389518,111124178,XM_022467041.1,uncharacterized LOC111124178,1004
NC_035782.1,31491473,31500589,31491473,31500589,111124181,XM_022467043.1,uncharacterized LOC111124181,9116
NC_035782.1,31800503,31809630,31800503,31809630,111124188,XM_022467050.1,uncharacterized LOC111124188,9127
NC_035782.1,31825365,31843865,31825365,31843865,111124189,XM_022467051.1,uncharacterized LOC111124189,18500
NC_035782.1,32101378,32113825,32101378,32113825,111124192,XM_022467054.1,uncharacterized LOC111124192,12447
NC_035782.1,32304583,32337788,32304583,32337788,111124196,XM_022467057.1,uncharacterized LOC111124196,33205
NC_035782.1,32810563,32814798,32810563,32814798,111124197,XM_022467058.1,uncharacterized LOC111124197,4235
NC_035782.1,33319093,33351947,33319093,33351947,111124199,XM_022467060.1,uncharacterized LOC111124199,32854
NC_035782.1,34931740,34932291,34931740,34932291,111124201,XM_022467061.1,uncharacterized LOC111124201,551
NC_035782.1,35930464,35931099,35930464,35931099,111124203,XM_022467062.1,uncharacterized LOC111124203,635
NC_035782.1,36078968,36080047,36078968,36080047,111124204,XM_022467063.1,uncharacterized LOC111124204,1079
NC_035782.1,36588911,36589979,36588911,36589979,111124206,XM_022467065.1,uncharacterized LOC111124206,1068
NC_035780.1,22271150,22275246,22271150,22275246,111124207,XM_022467069.1,uncharacterized LOC111124207,4096
NC_035782.1,36620946,36641518,36620946,36641518,111124208,XM_022467066.1,uncharacterized LOC111124208,20572
NC_035782.1,36650858,36665532,36650858,36665532,111124209,XM_022467067.1,uncharacterized LOC111124209,14674
NC_035782.1,36685914,36689507,36685914,36689507,111124210,XM_022467068.1,uncharacterized LOC111124210,3593
NC_035782.1,36706193,36708936,36706193,36708936,111124211,XM_022467070.1,uncharacterized LOC111124211,2743
NC_035782.1,36710381,36714008,36710381,36714008,111124212,XM_022467071.1,uncharacterized LOC111124212,3627
NC_035782.1,36723710,36741899,36723710,36741899,111124213,XM_022467072.1,uncharacterized LOC111124213,18189
NC_035782.1,37189194,37192228,37189194,37192228,111124214,XM_022467073.1,uncharacterized LOC111124214,3034
NC_035782.1,37650161,37653607,37650161,37653607,111124215,XM_022467074.1,uncharacterized LOC111124215,3446
NC_035782.1,37655789,37658313,37655789,37658313,111124216,XM_022467075.1,uncharacterized LOC111124216,2524
NC_035780.1,22269635,22278631,22270425,22278631,111124218,XM_022467088.1,uncharacterized LOC111124218,8206
NC_035780.1,22269635,22278631,22269635,22278631,111124218,XM_022467080.1,uncharacterized LOC111124218,8996
NC_035782.1,37830276,37832665,37830276,37832665,111124219,XM_022467077.1,uncharacterized LOC111124219,2389
NC_035782.1,38062461,38068502,38062461,38068502,111124221,XM_022467079.1,uncharacterized LOC111124221,6041
NC_035782.1,38118187,38126206,38118187,38126206,111124222,XM_022467081.1,uncharacterized LOC111124222,8019
NC_035782.1,38131416,38139016,38131416,38139016,111124223,XM_022467082.1,uncharacterized LOC111124223,7600
NC_035782.1,39121412,39125639,39121412,39125639,111124226,XM_022467085.1,uncharacterized LOC111124226,4227
NC_035782.1,39465993,39472169,39465993,39472169,111124227,XM_022467086.1,uncharacterized LOC111124227,6176
NC_035782.1,40059288,40063150,40059288,40063150,111124229,XM_022467089.1,uncharacterized LOC111124229,3862
NC_035782.1,40083805,40089678,40083805,40089678,111124230,XM_022467090.1,uncharacterized LOC111124230,5873
NC_035782.1,41186748,41196649,41186748,41196649,111124235,XM_022467092.1,uncharacterized LOC111124235,9901
NC_035782.1,41909190,41936911,41909190,41936911,111124239,XM_022467094.1,uncharacterized LOC111124239,27721
NC_035782.1,42185461,42232697,42185461,42232697,111124243,XM_022467099.1,uncharacterized LOC111124243,47236
NC_035782.1,42346117,42363756,42346117,42363756,111124244,XM_022467100.1,uncharacterized LOC111124244,17639
NC_035782.1,42464313,42466042,42464313,42466042,111124245,XM_022467101.1,uncharacterized LOC111124245,1729
NC_035780.1,39458888,39523044,39458888,39523044,111124247,XM_022467106.1,uncharacterized LOC111124247,64156
NC_035782.1,42497748,42499012,42497748,42499012,111124248,XM_022467103.1,uncharacterized LOC111124248,1264
NC_035782.1,42673222,42674235,42673222,42674235,111124249,XM_022467104.1,uncharacterized LOC111124249,1013
NC_035782.1,43186078,43195695,43186078,43195695,111124252,XM_022467108.1,uncharacterized LOC111124252,9617
NC_035782.1,43357203,43360030,43357203,43360030,111124255,XM_022467110.1,uncharacterized LOC111124255,2827
NC_035782.1,43599312,43600266,43599312,43600266,111124256,XM_022467111.1,uncharacterized LOC111124256,954
NC_035780.1,39531098,39537137,39531098,39537137,111124258,XM_022467116.1,uncharacterized LOC111124258,6039
NC_035782.1,44245210,44260962,44245210,44260962,111124261,XM_022467115.1,uncharacterized LOC111124261,15752
NC_035782.1,24530488,24537158,24530488,24535627,111124263,XM_022467118.1,uncharacterized LOC111124263,5139
NC_035782.1,24530488,24537158,24530488,24537158,111124263,XM_022467117.1,uncharacterized LOC111124263,6670
NC_035782.1,24546110,24559730,24546110,24559730,111124266,XM_022467122.1,uncharacterized LOC111124266,13620
NC_035782.1,44832514,44839117,44832514,44839117,111124267,XM_022467123.1,uncharacterized LOC111124267,6603
NC_035780.1,39408425,39412302,39408425,39412302,111124268,XM_022467127.1,uncharacterized LOC111124268,3877
NC_035782.1,45931162,45933614,45931162,45933614,111124275,XM_022467130.1,uncharacterized LOC111124275,2452
NC_035782.1,45947193,45953689,45947193,45953689,111124276,XM_022467131.1,uncharacterized LOC111124276,6496
NC_035782.1,46441786,46443100,46441786,46443100,111124278,XM_022467133.1,uncharacterized LOC111124278,1314
NC_035780.1,39544594,39547051,39544594,39547051,111124279,XM_022467137.1,uncharacterized LOC111124279,2457
NC_035782.1,46604619,46635197,46604619,46635197,111124280,XM_022467134.1,uncharacterized LOC111124280,30578
NC_035782.1,47789628,47794782,47789628,47794782,111124281,XM_022467135.1,uncharacterized LOC111124281,5154
NC_035782.1,48517472,48518011,48517472,48518011,111124283,XM_022467138.1,uncharacterized LOC111124283,539
NC_035782.1,49438955,49440337,49438955,49440337,111124285,XM_022467140.1,uncharacterized LOC111124285,1382
NC_035782.1,49525189,49527454,49525189,49527454,111124288,XM_022467142.1,uncharacterized LOC111124288,2265
NC_035782.1,49855531,49856154,49855531,49856154,111124289,XM_022467143.1,uncharacterized LOC111124289,623
NC_035782.1,49919440,49923584,49919440,49923584,111124291,XM_022467144.1,uncharacterized LOC111124291,4144
NC_035782.1,50469251,50473631,50469251,50473631,111124293,XM_022467146.1,uncharacterized LOC111124293,4380
NC_035782.1,51522050,51523156,51522050,51523156,111124298,XM_022467150.1,uncharacterized LOC111124298,1106
NC_035782.1,51811898,51858800,51811898,51858800,111124300,XM_022467152.1,uncharacterized LOC111124300,46902
NC_035782.1,52402255,52411483,52402255,52411483,111124301,XM_022467154.1,uncharacterized LOC111124301,9228
NC_035782.1,52443423,52451747,52443423,52451747,111124302,XM_022467155.1,uncharacterized LOC111124302,8324
NC_035782.1,52532696,52533437,52532696,52533437,111124303,XM_022467156.1,uncharacterized LOC111124303,741
NC_035782.1,53104254,53140357,53104254,53140357,111124304,XM_022467157.1,uncharacterized LOC111124304,36103
NC_035782.1,53554120,53589492,53554120,53589492,111124306,XM_022467159.1,uncharacterized LOC111124306,35372
NC_035782.1,54841951,54863392,54841951,54863392,111124311,XM_022467164.1,uncharacterized LOC111124311,21441
NC_035782.1,55563158,55588279,55563158,55588279,111124316,XM_022467168.1,uncharacterized LOC111124316,25121
NC_035780.1,31308070,31315345,31308070,31315345,111124318,XM_022467173.1,uncharacterized LOC111124318,7275
NC_035782.1,55792061,55795626,55792061,55795626,111124321,XM_022467172.1,uncharacterized LOC111124321,3565
NC_035782.1,55854368,55858778,55854368,55858778,111124322,XM_022467174.1,uncharacterized LOC111124322,4410
NC_035782.1,55960946,55963325,55960946,55963325,111124324,XM_022467176.1,uncharacterized LOC111124324,2379
NC_035782.1,56009287,56016068,56009287,56016068,111124326,XM_022467178.1,uncharacterized LOC111124326,6781
NC_035782.1,56474397,56475656,56474397,56475656,111124328,XM_022467180.1,uncharacterized LOC111124328,1259
NC_035782.1,56864611,56870332,56864611,56870332,111124330,XM_022467181.1,uncharacterized LOC111124330,5721
NC_035782.1,59417392,59420107,59417392,59420107,111124338,XM_022467189.1,uncharacterized LOC111124338,2715
NC_035782.1,59773483,59780460,59773483,59780460,111124341,XM_022467190.1,uncharacterized LOC111124341,6977
NC_035782.1,59981265,59982198,59981265,59982198,111124344,XM_022467194.1,uncharacterized LOC111124344,933
NC_035782.1,60458594,60466782,60458594,60466782,111124347,XM_022467197.1,uncharacterized LOC111124347,8188
NC_035782.1,60474299,60478098,60474299,60478098,111124348,XM_022467198.1,uncharacterized LOC111124348,3799
NC_035782.1,60663747,60664465,60663747,60664465,111124349,XM_022467199.1,uncharacterized LOC111124349,718
NC_035782.1,61670865,61680716,61670865,61680716,111124356,XM_022467206.1,uncharacterized LOC111124356,9851
NC_035782.1,62329861,62346299,62329861,62346299,111124358,XM_022467208.1,uncharacterized LOC111124358,16438
NC_035782.1,63853857,63855917,63853857,63855917,111124367,XM_022467217.1,uncharacterized LOC111124367,2060
NC_035782.1,63857370,63861752,63857370,63861752,111124368,XM_022467219.1,uncharacterized LOC111124368,4382
NC_035782.1,65504322,65505374,65504322,65505374,111124380,XM_022467231.1,uncharacterized LOC111124380,1052
NC_035782.1,65622140,65624415,65622140,65624415,111124382,XM_022467233.1,uncharacterized LOC111124382,2275
NC_035782.1,66107900,66109872,66107900,66109872,111124386,XM_022467237.1,uncharacterized LOC111124386,1972
NC_035782.1,66169902,66170947,66169902,66170947,111124387,XM_022467238.1,uncharacterized LOC111124387,1045
NC_035782.1,66589073,66590925,66589073,66590925,111124388,XM_022467239.1,uncharacterized LOC111124388,1852
NC_035782.1,67222448,67287441,67222448,67287441,111124392,XM_022467244.1,uncharacterized LOC111124392,64993
NC_035782.1,67289235,67294457,67289235,67294457,111124393,XM_022467245.1,uncharacterized LOC111124393,5222
NC_035782.1,67364701,67378867,67364701,67378867,111124395,XM_022467247.1,uncharacterized LOC111124395,14166
NC_035782.1,67736195,67741193,67736195,67741193,111124397,XM_022467249.1,uncharacterized LOC111124397,4998
NC_035782.1,67914680,67918933,67914680,67918933,111124398,XM_022467250.1,uncharacterized LOC111124398,4253
NC_035782.1,68538027,68543987,68538027,68543987,111124403,XM_022467255.1,uncharacterized LOC111124403,5960
NC_035782.1,68719421,68722454,68719421,68722454,111124407,XM_022467259.1,uncharacterized LOC111124407,3033
NC_035782.1,68824290,68825204,68824290,68825204,111124408,XM_022467260.1,uncharacterized LOC111124408,914
NC_035782.1,69934679,69945186,69934679,69945186,111124412,XM_022467263.1,uncharacterized LOC111124412,10507
NC_035782.1,70085211,70092705,70085211,70092705,111124415,XM_022467267.1,uncharacterized LOC111124415,7494
NC_035782.1,70195374,70197423,70195374,70197423,111124416,XM_022467268.1,uncharacterized LOC111124416,2049
NC_035780.1,65371284,65433569,65371284,65433569,111124421,XM_022467276.1,uncharacterized LOC111124421,62285
NC_035782.1,70481427,70482806,70481427,70482806,111124423,XM_022467274.1,uncharacterized LOC111124423,1379
NC_035782.1,70482819,70484306,70482819,70484306,111124424,XM_022467275.1,uncharacterized LOC111124424,1487
NC_035782.1,70605955,70610325,70605955,70610325,111124425,XM_022467277.1,uncharacterized LOC111124425,4370
NC_035782.1,71141332,71143518,71141332,71143518,111124427,XM_022467279.1,uncharacterized LOC111124427,2186
NC_035782.1,71144056,71146639,71144056,71146639,111124428,XM_022467280.1,uncharacterized LOC111124428,2583
NC_035782.1,72147475,72149968,72147475,72149968,111124432,XM_022467283.1,uncharacterized LOC111124432,2493
NC_035782.1,73522398,73525527,73522398,73525527,111124436,XM_022467288.1,uncharacterized LOC111124436,3129
NC_035782.1,73573892,73575910,73573892,73575910,111124437,XM_022467290.1,uncharacterized LOC111124437,2018
NC_035782.1,73576672,73585925,73576672,73585925,111124438,XM_022467291.1,uncharacterized LOC111124438,9253
NC_035782.1,74424218,74425773,74424218,74425773,111124443,XM_022467297.1,uncharacterized LOC111124443,1555
NC_035782.1,74673915,74677147,74673915,74677147,111124444,XM_022467298.1,uncharacterized LOC111124444,3232
NC_035782.1,75234072,75241034,75234072,75241034,111124448,XM_022467301.1,uncharacterized LOC111124448,6962
NC_035782.1,75373865,75381541,75373865,75381541,111124450,XM_022467303.1,uncharacterized LOC111124450,7676
NC_035782.1,75385640,75402001,75385640,75402001,111124452,XM_022467305.1,uncharacterized LOC111124452,16361
NC_035782.1,75409071,75415689,75409071,75415689,111124453,XM_022467306.1,uncharacterized LOC111124453,6618
NC_035782.1,75429190,75437072,75429190,75437072,111124454,XM_022467307.1,uncharacterized LOC111124454,7882
NC_035782.1,75696468,75698503,75696468,75698503,111124457,XM_022467309.1,uncharacterized LOC111124457,2035
NC_035782.1,75785922,75787328,75785922,75787328,111124458,XM_022467310.1,uncharacterized LOC111124458,1406
NC_035782.1,75787355,75788349,75787355,75788349,111124459,XM_022467311.1,uncharacterized LOC111124459,994
NC_035780.1,1357834,1359771,1357834,1359771,111124462,XM_022467317.1,uncharacterized LOC111124462,1937
NC_035782.1,52346197,52357067,52346197,52357037,111124469,XM_022467330.1,uncharacterized LOC111124469,10840
NC_035782.1,52346197,52357067,52346197,52357048,111124469,XM_022467329.1,uncharacterized LOC111124469,10851
NC_035782.1,52294660,52311040,52294660,52311040,111124470,XM_022467333.1,uncharacterized LOC111124470,16380
NC_035782.1,52248792,52284530,52248792,52273691,111124471,XM_022467335.1,uncharacterized LOC111124471,24899
NC_035782.1,52248792,52284530,52248793,52284530,111124471,XM_022467334.1,uncharacterized LOC111124471,35737
NC_035782.1,52276814,52278914,52276814,52278914,111124475,XM_022467340.1,uncharacterized LOC111124475,2100
NC_035782.1,64277836,64281827,64277836,64281827,111124483,XM_022467354.1,uncharacterized LOC111124483,3991
NC_035782.1,9762846,9771774,9762846,9771623,111124492,XM_022467366.1,uncharacterized LOC111124492,8777
NC_035782.1,9762846,9771774,9762846,9771774,111124492,XM_022467365.1,uncharacterized LOC111124492,8928
NC_035782.1,9691414,9756904,9718261,9733181,111124493,XM_022467378.1,uncharacterized LOC111124493,14920
NC_035782.1,9691414,9756904,9718261,9733198,111124493,XM_022467376.1,uncharacterized LOC111124493,14937
NC_035782.1,9691414,9756904,9718257,9733203,111124493,XM_022467387.1,uncharacterized LOC111124493,14946
NC_035782.1,9691414,9756904,9718261,9735340,111124493,XM_022467377.1,uncharacterized LOC111124493,17079
NC_035782.1,9691414,9756904,9718261,9743880,111124493,XM_022467371.1,uncharacterized LOC111124493,25619
NC_035782.1,9691414,9756904,9718261,9743930,111124493,XM_022467374.1,uncharacterized LOC111124493,25669
NC_035782.1,9691414,9756904,9709036,9743930,111124493,XM_022467383.1,uncharacterized LOC111124493,34894
NC_035782.1,9691414,9756904,9718263,9753609,111124493,XM_022467372.1,uncharacterized LOC111124493,35346
NC_035782.1,9691414,9756904,9718263,9756904,111124493,XM_022467369.1,uncharacterized LOC111124493,38641
NC_035782.1,9691414,9756904,9718262,9756904,111124493,XM_022467384.1,uncharacterized LOC111124493,38642
NC_035782.1,9691414,9756904,9718256,9756904,111124493,XM_022467379.1,uncharacterized LOC111124493,38648
NC_035782.1,9691414,9756904,9709037,9756904,111124493,XM_022467382.1,uncharacterized LOC111124493,47867
NC_035782.1,9691414,9756904,9691414,9756904,111124493,XM_022467375.1,uncharacterized LOC111124493,65490
NC_035782.1,9691414,9756904,9709029,9716493,111124493,XM_022467388.1,uncharacterized LOC111124493,7464
NC_035782.1,9691414,9756904,9691414,9699963,111124493,XM_022467386.1,uncharacterized LOC111124493,8549
NC_035782.1,9691414,9756904,9691414,9701162,111124493,XM_022467385.1,uncharacterized LOC111124493,9748
NC_035780.1,54341773,54346493,54341989,54346493,111124495,XM_022467406.1,uncharacterized LOC111124495,4504
NC_035780.1,54341773,54346493,54341773,54346493,111124495,XM_022467395.1,uncharacterized LOC111124495,4720
NC_035782.1,26272725,26274328,26272725,26274328,111124496,XM_022467405.1,uncharacterized LOC111124496,1603
NC_035782.1,75185311,75188000,75185311,75188000,111124499,XM_022467408.1,uncharacterized LOC111124499,2689
NC_035782.1,75456410,75459389,75456410,75459389,111124503,XM_022467418.1,uncharacterized LOC111124503,2979
NC_035782.1,4865916,4917303,4865916,4917303,111124504,XM_022467419.1,uncharacterized LOC111124504,51387
NC_035782.1,4859979,4862805,4859979,4862805,111124508,XM_022467425.1,uncharacterized LOC111124508,2826
NC_035782.1,4939125,4942195,4939125,4942195,111124509,XM_022467427.1,uncharacterized LOC111124509,3070
NC_035782.1,4892038,4895623,4892038,4895623,111124510,XM_022467428.1,uncharacterized LOC111124510,3585
NC_035782.1,4962202,4964806,4962202,4964806,111124511,XM_022467429.1,uncharacterized LOC111124511,2604
NC_035782.1,4878436,4879870,4878436,4879870,111124515,XM_022467436.1,uncharacterized LOC111124515,1434
NC_035782.1,53954901,53956342,53954901,53956342,111124526,XM_022467454.1,uncharacterized LOC111124526,1441
NC_035782.1,3537468,3556628,3537468,3551663,111124529,XM_022467464.1,uncharacterized LOC111124529,14195
NC_035782.1,3537468,3556628,3537468,3551669,111124529,XM_022467463.1,uncharacterized LOC111124529,14201
NC_035782.1,3537468,3556628,3537468,3551672,111124529,XM_022467461.1,uncharacterized LOC111124529,14204
NC_035782.1,3537468,3556628,3537468,3551676,111124529,XM_022467462.1,uncharacterized LOC111124529,14208
NC_035782.1,3537468,3556628,3537468,3556628,111124529,XM_022467465.1,uncharacterized LOC111124529,19160
NC_035782.1,3568818,3573101,3568818,3573101,111124536,XM_022467477.1,uncharacterized LOC111124536,4283
NC_035782.1,3449822,3452148,3449822,3451202,111124538,XM_022467479.1,uncharacterized LOC111124538,1380
NC_035782.1,3449822,3452148,3449822,3452148,111124538,XM_022467478.1,uncharacterized LOC111124538,2326
NC_035780.1,32451393,32465249,32451393,32465249,111124544,XM_022467496.1,uncharacterized LOC111124544,13856
NC_035782.1,15871796,15878759,15871796,15878759,111124548,XM_022467490.1,uncharacterized LOC111124548,6963
NC_035782.1,47536749,47545379,47537700,47545379,111124551,XM_022467493.1,uncharacterized LOC111124551,7679
NC_035782.1,47536749,47545379,47536749,47545379,111124551,XM_022467494.1,uncharacterized LOC111124551,8630
NC_035780.1,55693675,55707557,55693675,55707557,111124558,XM_022467524.1,uncharacterized LOC111124558,13882
NC_035780.1,55693675,55707557,55703113,55707557,111124558,XM_022467547.1,uncharacterized LOC111124558,4444
NC_035780.1,55693675,55707557,55702819,55707557,111124558,XM_022467537.1,uncharacterized LOC111124558,4738
NC_035780.1,55693675,55707557,55701583,55707557,111124558,XM_022467557.1,uncharacterized LOC111124558,5974
NC_035780.1,55693675,55707557,55700427,55707557,111124558,XM_022467530.1,uncharacterized LOC111124558,7130
NC_035782.1,63457867,63462222,63457867,63462222,111124568,XM_022467529.1,uncharacterized LOC111124568,4355
NC_035782.1,42343986,42346392,42343986,42346392,111124571,XM_022467534.1,uncharacterized LOC111124571,2406
NC_035782.1,53022672,53039002,53022672,53038997,111124575,XM_022467541.1,uncharacterized LOC111124575,16325
NC_035782.1,53022672,53039002,53022672,53039002,111124575,XM_022467539.1,uncharacterized LOC111124575,16330
NC_035782.1,63227254,63256489,63227254,63256489,111124594,XM_022467576.1,uncharacterized LOC111124594,29235
NC_035780.1,29271584,29321094,29271584,29321094,111124596,XM_022467582.1,uncharacterized LOC111124596,49510
NC_035780.1,29336869,29340129,29336869,29340129,111124600,XM_022467593.1,uncharacterized LOC111124600,3260
NC_035782.1,3956296,3958235,3956296,3958235,111124601,XM_022467592.1,uncharacterized LOC111124601,1939
NC_035782.1,9319755,9406361,9346191,9406360,111124602,XM_022467606.1,uncharacterized LOC111124602,60169
NC_035782.1,9319755,9406361,9325805,9406360,111124602,XM_022467596.1,uncharacterized LOC111124602,80555
NC_035782.1,9319755,9406361,9325670,9406360,111124602,XM_022467600.1,uncharacterized LOC111124602,80690
NC_035782.1,9319755,9406361,9325665,9406360,111124602,XM_022467599.1,uncharacterized LOC111124602,80695
NC_035782.1,9319755,9406361,9325621,9406360,111124602,XM_022467595.1,uncharacterized LOC111124602,80739
NC_035782.1,9319755,9406361,9319755,9406360,111124602,XM_022467604.1,uncharacterized LOC111124602,86605
NC_035782.1,9319755,9406361,9319755,9406361,111124602,XM_022467613.1,uncharacterized LOC111124602,86606
NC_035782.1,9354257,9359410,9354257,9359410,111124605,XM_022467618.1,uncharacterized LOC111124605,5153
NC_035782.1,55504663,55515741,55504663,55515728,111124612,XM_022467638.1,uncharacterized LOC111124612,11065
NC_035782.1,55504663,55515741,55504663,55515732,111124612,XM_022467632.1,uncharacterized LOC111124612,11069
NC_035782.1,55504663,55515741,55504663,55515735,111124612,XM_022467635.1,uncharacterized LOC111124612,11072
NC_035782.1,55504663,55515741,55504663,55515736,111124612,XM_022467631.1,uncharacterized LOC111124612,11073
NC_035782.1,55504663,55515741,55504663,55515738,111124612,XM_022467633.1,uncharacterized LOC111124612,11075
NC_035782.1,55504663,55515741,55504663,55515739,111124612,XM_022467630.1,uncharacterized LOC111124612,11076
NC_035782.1,55504663,55515741,55504663,55515740,111124612,XM_022467628.1,uncharacterized LOC111124612,11077
NC_035782.1,55504663,55515741,55504663,55515741,111124612,XM_022467626.1,uncharacterized LOC111124612,11078
NC_035780.1,23194724,23196955,23194724,23196955,111124624,XM_022467662.1,uncharacterized LOC111124624,2231
NC_035782.1,45190529,45193713,45190529,45193332,111124630,XM_022467668.1,uncharacterized LOC111124630,2803
NC_035782.1,45190529,45193713,45190529,45193713,111124630,XM_022467667.1,uncharacterized LOC111124630,3184
NC_035782.1,53506868,53518414,53506875,53518414,111124635,XM_022467682.1,uncharacterized LOC111124635,11539
NC_035782.1,53506868,53518414,53506874,53518414,111124635,XM_022467683.1,uncharacterized LOC111124635,11540
NC_035782.1,53506868,53518414,53506868,53518414,111124635,XM_022467684.1,uncharacterized LOC111124635,11546
NC_035782.1,9779756,9813606,9779756,9792192,111124642,XM_022467710.1,uncharacterized LOC111124642,12436
NC_035782.1,9779756,9813606,9779756,9792310,111124642,XM_022467711.1,uncharacterized LOC111124642,12554
NC_035782.1,9779756,9813606,9779756,9792953,111124642,XM_022467709.1,uncharacterized LOC111124642,13197
NC_035782.1,9779756,9813606,9779756,9811427,111124642,XM_022467708.1,uncharacterized LOC111124642,31671
NC_035782.1,9779756,9813606,9805319,9810237,111124642,XM_022467712.1,uncharacterized LOC111124642,4918
NC_035782.1,10469054,10532699,10469054,10532699,111124644,XM_022467714.1,uncharacterized LOC111124644,63645
NC_035782.1,10629369,10655934,10629369,10655934,111124645,XM_022467715.1,uncharacterized LOC111124645,26565
NC_035780.1,23214795,23219112,23214795,23219112,111124646,XM_022467718.1,uncharacterized LOC111124646,4317
NC_035782.1,10588774,10614759,10588774,10614759,111124647,XM_022467716.1,uncharacterized LOC111124647,25985
NC_035782.1,50545067,50568888,50545067,50568888,111124656,XM_022467733.1,uncharacterized LOC111124656,23821
NC_035782.1,25639005,25650032,25639005,25650032,111124658,XM_022467735.1,uncharacterized LOC111124658,11027
NC_035782.1,25653019,25684452,25669412,25684452,111124659,XM_022467739.1,uncharacterized LOC111124659,15040
NC_035782.1,25653019,25684452,25653019,25684452,111124659,XM_022467738.1,uncharacterized LOC111124659,31433
NC_035782.1,25664585,25667418,25664585,25667418,111124661,XM_022467741.1,uncharacterized LOC111124661,2833
NC_035782.1,66228615,66234659,66228615,66234659,111124677,XM_022467774.1,uncharacterized LOC111124677,6044
NC_035782.1,65966002,65973055,65966002,65972826,111124683,XM_022467786.1,uncharacterized LOC111124683,6824
NC_035782.1,65966002,65973055,65966002,65973055,111124683,XM_022467785.1,uncharacterized LOC111124683,7053
NC_035782.1,66060225,66062754,66060225,66062754,111124685,XM_022467787.1,uncharacterized LOC111124685,2529
NC_035782.1,65927791,65930208,65927792,65930208,111124686,XM_022467788.1,uncharacterized LOC111124686,2416
NC_035782.1,65927791,65930208,65927791,65930208,111124686,XM_022467789.1,uncharacterized LOC111124686,2417
NC_035782.1,66013934,66015413,66013934,66015413,111124687,XM_022467791.1,uncharacterized LOC111124687,1479
NC_035782.1,10308107,10351534,10308107,10351534,111124693,XM_022467806.1,uncharacterized LOC111124693,43427
NC_035782.1,58908062,58921034,58908071,58921034,111124703,XM_022467828.1,uncharacterized LOC111124703,12963
NC_035782.1,58908062,58921034,58908062,58921034,111124703,XM_022467827.1,uncharacterized LOC111124703,12972
NC_035782.1,65816401,65819125,65816401,65819125,111124718,XM_022467846.1,uncharacterized LOC111124718,2724
NC_035782.1,37053395,37072009,37053395,37064512,111124719,XM_022467852.1,uncharacterized LOC111124719,11117
NC_035782.1,37053395,37072009,37053395,37065622,111124719,XM_022467854.1,uncharacterized LOC111124719,12227
NC_035782.1,37053395,37072009,37053395,37069806,111124719,XM_022467851.1,uncharacterized LOC111124719,16411
NC_035782.1,37053395,37072009,37053395,37070964,111124719,XM_022467853.1,uncharacterized LOC111124719,17569
NC_035782.1,37053395,37072009,37053395,37072009,111124719,XM_022467856.1,uncharacterized LOC111124719,18614
NC_035782.1,37053395,37072009,37053395,37060935,111124719,XM_022467848.1,uncharacterized LOC111124719,7540
NC_035782.1,37053395,37072009,37053395,37061303,111124719,XM_022467849.1,uncharacterized LOC111124719,7908
NC_035782.1,37005182,37053297,37027171,37053297,111124720,XM_022467859.1,uncharacterized LOC111124720,26126
NC_035782.1,37005182,37053297,37005182,37053297,111124720,XM_022467857.1,uncharacterized LOC111124720,48115
NC_035782.1,56956967,56974125,56963200,56974125,111124724,XM_022467866.1,uncharacterized LOC111124724,10925
NC_035782.1,56956967,56974125,56958063,56974125,111124724,XM_022467867.1,uncharacterized LOC111124724,16062
NC_035782.1,56956967,56974125,56956967,56974125,111124724,XM_022467865.1,uncharacterized LOC111124724,17158
NC_035782.1,74918038,74923264,74918038,74923264,111124728,XM_022467876.1,uncharacterized LOC111124728,5226
NC_035782.1,18116315,18123058,18116315,18123058,111124734,XM_022467885.1,uncharacterized LOC111124734,6743
NC_035782.1,18114770,18125487,18114770,18125487,111124738,XM_022467890.1,uncharacterized LOC111124738,10717
NC_035782.1,31062432,31086819,31062433,31086819,111124749,XM_022467911.1,uncharacterized LOC111124749,24386
NC_035782.1,31062432,31086819,31062432,31086819,111124749,XM_022467910.1,uncharacterized LOC111124749,24387
NC_035782.1,53878073,53883313,53878073,53883313,111124750,XM_022467912.1,uncharacterized LOC111124750,5240
NC_035782.1,56401000,56408215,56401000,56408215,111124753,XM_022467916.1,uncharacterized LOC111124753,7215
NC_035782.1,60719593,60725703,60719593,60725703,111124757,XM_022467925.1,uncharacterized LOC111124757,6110
NC_035782.1,39857811,39977961,39857811,39977961,111124763,XM_022467934.1,uncharacterized LOC111124763,120150
NC_035782.1,39710379,39720960,39710379,39720960,111124777,XM_022467965.1,uncharacterized LOC111124777,10581
NC_035782.1,40098216,40108913,40098216,40108913,111124779,XM_022467966.1,uncharacterized LOC111124779,10697
NC_035782.1,39704727,39709050,39704904,39709050,111124783,XM_022467973.1,uncharacterized LOC111124783,4146
NC_035782.1,39704727,39709050,39704727,39709050,111124783,XM_022467974.1,uncharacterized LOC111124783,4323
NC_035782.1,40091637,40096519,40092165,40096519,111124785,XM_022467976.1,uncharacterized LOC111124785,4354
NC_035782.1,40091637,40096519,40091637,40096519,111124785,XM_022467975.1,uncharacterized LOC111124785,4882
NC_035782.1,39690688,39702951,39690688,39702951,111124786,XM_022467977.1,uncharacterized LOC111124786,12263
NC_035780.1,19343383,19377787,19343383,19377787,111124790,XM_022467985.1,uncharacterized LOC111124790,34404
NC_035782.1,40111531,40115198,40111531,40115198,111124792,XM_022467983.1,uncharacterized LOC111124792,3667
NC_035780.1,53582820,53588779,53582820,53588779,111124794,XM_022468026.1,uncharacterized LOC111124794,5959
NC_035782.1,40275776,40280968,40275776,40280968,111124795,XM_022467986.1,uncharacterized LOC111124795,5192
NC_035782.1,39978180,39983564,39978180,39983564,111124796,XM_022467987.1,uncharacterized LOC111124796,5384
NC_035782.1,39811132,39812546,39811132,39812546,111124799,XM_022467990.1,uncharacterized LOC111124799,1414
NC_035782.1,40184498,40185829,40184498,40185829,111124800,XM_022467991.1,uncharacterized LOC111124800,1331
NC_035780.1,258108,272839,261478,272839,111124802,XM_022468021.1,uncharacterized LOC111124802,11361
NC_035780.1,258108,272839,258108,272839,111124802,XM_022468012.1,uncharacterized LOC111124802,14731
NC_035780.1,258108,272839,266196,272839,111124802,XM_022468030.1,uncharacterized LOC111124802,6643
NC_035780.1,258108,272839,263244,272826,111124802,XM_022468004.1,uncharacterized LOC111124802,9582
NC_035780.1,258108,272839,263245,272839,111124802,XM_022467995.1,uncharacterized LOC111124802,9594
NC_035782.1,15776804,15783237,15776804,15783074,111124809,XM_022468006.1,uncharacterized LOC111124809,6270
NC_035782.1,15776804,15783237,15776804,15783237,111124809,XM_022468007.1,uncharacterized LOC111124809,6433
NC_035782.1,24085451,24089451,24085451,24089451,111124811,XM_022468011.1,uncharacterized LOC111124811,4000
NC_035782.1,18656570,18658945,18656570,18658945,111124819,XM_022468025.1,uncharacterized LOC111124819,2375
NC_035782.1,18766837,18773238,18766837,18770738,111124820,XM_022468028.1,uncharacterized LOC111124820,3901
NC_035782.1,18766837,18773238,18766838,18773238,111124820,XM_022468027.1,uncharacterized LOC111124820,6400
NC_035782.1,18723593,18726712,18723593,18726712,111124821,XM_022468029.1,uncharacterized LOC111124821,3119
NC_035782.1,18712466,18715516,18712466,18715516,111124822,XM_022468031.1,uncharacterized LOC111124822,3050
NC_035782.1,18717064,18721816,18717064,18721816,111124823,XM_022468032.1,uncharacterized LOC111124823,4752
NC_035782.1,18663717,18668095,18663717,18668095,111124824,XM_022468033.1,uncharacterized LOC111124824,4378
NC_035782.1,18776747,18782782,18776747,18782782,111124830,XM_022468038.1,uncharacterized LOC111124830,6035
NC_035782.1,18823707,18845206,18830369,18845206,111124833,XM_022468045.1,uncharacterized LOC111124833,14837
NC_035782.1,18823707,18845206,18828900,18845206,111124833,XM_022468046.1,uncharacterized LOC111124833,16306
NC_035782.1,18823707,18845206,18828163,18845206,111124833,XM_022468044.1,uncharacterized LOC111124833,17043
NC_035782.1,18823707,18845206,18823707,18845206,111124833,XM_022468043.1,uncharacterized LOC111124833,21499
NC_035782.1,6434957,6455681,6442090,6455681,111124835,XM_022468049.1,uncharacterized LOC111124835,13591
NC_035782.1,6434957,6455681,6442035,6455681,111124835,XM_022468047.1,uncharacterized LOC111124835,13646
NC_035782.1,6434957,6455681,6434957,6455681,111124835,XM_022468048.1,uncharacterized LOC111124835,20724
NC_035782.1,29711114,29712005,29711114,29712005,111124841,XM_022468055.1,uncharacterized LOC111124841,891
NC_035782.1,72139666,72148184,72139666,72148184,111124846,XM_022468065.1,uncharacterized LOC111124846,8518
NC_035780.1,3996432,4013875,3996432,4009438,111124850,XM_022468072.1,uncharacterized LOC111124850,13006
NC_035782.1,1960924,1979791,1963257,1979791,111124854,XM_022468075.1,uncharacterized LOC111124854,16534
NC_035782.1,1960924,1979791,1960924,1979791,111124854,XM_022468074.1,uncharacterized LOC111124854,18867
NC_035782.1,1960924,1979791,1970608,1979791,111124854,XM_022468078.1,uncharacterized LOC111124854,9183
NC_035782.1,2012823,2015922,2012823,2015922,111124857,XM_022468082.1,uncharacterized LOC111124857,3099
NC_035780.1,3977190,3992465,3977190,3992465,111124863,XM_022468098.1,uncharacterized LOC111124863,15275
NC_035782.1,41871011,41894427,41871011,41894427,111124864,XM_022468103.1,uncharacterized LOC111124864,23416
NC_035780.1,28082230,28086360,28082230,28086360,111124866,XM_022468149.1,uncharacterized LOC111124866,4130
NC_035782.1,67953242,67974669,67953242,67974669,111124883,XM_022468140.1,uncharacterized LOC111124883,21427
NC_035782.1,67922678,67928272,67922678,67928272,111124884,XM_022468141.1,uncharacterized LOC111124884,5594
NC_035782.1,67987620,67993881,67987620,67993881,111124886,XM_022468143.1,uncharacterized LOC111124886,6261
NC_035782.1,35778021,35779580,35778021,35779580,111124888,XM_022468146.1,uncharacterized LOC111124888,1559
NC_035782.1,14893055,14906851,14893055,14904979,111124889,XM_022468147.1,uncharacterized LOC111124889,11924
NC_035782.1,14893055,14906851,14893912,14906851,111124889,XM_022468148.1,uncharacterized LOC111124889,12939
NC_035782.1,30328802,30339142,30328802,30339142,111124892,XM_022468153.1,uncharacterized LOC111124892,10340
NC_035782.1,19241063,19243306,19241063,19243306,111124896,XM_022468161.1,uncharacterized LOC111124896,2243
NC_035782.1,19249809,19258441,19249809,19258441,111124898,XM_022468163.1,uncharacterized LOC111124898,8632
NC_035782.1,32165708,32191314,32165708,32191314,111124899,XM_022468164.1,uncharacterized LOC111124899,25606
NC_035782.1,53071689,53088772,53071689,53088772,111124902,XM_022468173.1,uncharacterized LOC111124902,17083
NC_035782.1,32657963,32664266,32657963,32664266,111124907,XM_022468200.1,uncharacterized LOC111124907,6303
NC_035782.1,47301211,47378111,47301504,47378111,111124909,XM_022468207.1,uncharacterized LOC111124909,76607
NC_035782.1,47301211,47378111,47301408,47378111,111124909,XM_022468205.1,uncharacterized LOC111124909,76703
NC_035782.1,47301211,47378111,47301211,47378111,111124909,XM_022468208.1,uncharacterized LOC111124909,76900
NC_035782.1,61210453,61217079,61210453,61217079,111124915,XM_022468218.1,uncharacterized LOC111124915,6626
NC_035782.1,69270994,69292962,69271000,69292953,111124920,XM_022468225.1,uncharacterized LOC111124920,21953
NC_035782.1,69270994,69292962,69270994,69292962,111124920,XM_022468226.1,uncharacterized LOC111124920,21968
NC_035782.1,69239094,69257316,69239915,69257316,111124923,XM_022468231.1,uncharacterized LOC111124923,17401
NC_035782.1,38645940,38670048,38645940,38670048,111124926,XM_022468232.1,uncharacterized LOC111124926,24108
NC_035782.1,38621358,38636706,38621358,38636542,111124928,XM_022468234.1,uncharacterized LOC111124928,15184
NC_035782.1,38621358,38636706,38621358,38636706,111124928,XM_022468235.1,uncharacterized LOC111124928,15348
NC_035782.1,2361342,2382385,2361342,2382385,111124933,XM_022468242.1,uncharacterized LOC111124933,21043
NC_035782.1,41820275,41839917,41820275,41834060,111124935,XM_022468247.1,uncharacterized LOC111124935,13785
NC_035782.1,41820275,41839917,41820275,41834063,111124935,XM_022468248.1,uncharacterized LOC111124935,13788
NC_035782.1,41820275,41839917,41820275,41839917,111124935,XM_022468246.1,uncharacterized LOC111124935,19642
NC_035782.1,16432138,16446003,16432138,16446003,111124941,XM_022468272.1,uncharacterized LOC111124941,13865
NC_035780.1,12685427,12691585,12685427,12691585,111124945,XM_022468300.1,uncharacterized LOC111124945,6158
NC_035782.1,16576041,16580395,16576041,16579014,111124946,XM_022468303.1,uncharacterized LOC111124946,2973
NC_035782.1,17000875,17018626,17000875,17018626,111124947,XM_022468304.1,uncharacterized LOC111124947,17751
NC_035782.1,17000875,17018626,17016450,17018626,111124947,XM_022468305.1,uncharacterized LOC111124947,2176
NC_035782.1,16387290,16390445,16387290,16390394,111124948,XM_022468307.1,uncharacterized LOC111124948,3104
NC_035782.1,16387290,16390445,16387290,16390445,111124948,XM_022468306.1,uncharacterized LOC111124948,3155
NC_035782.1,16545160,16547754,16545160,16547754,111124951,XM_022468309.1,uncharacterized LOC111124951,2594
NC_035780.1,56613354,56622032,56613354,56622032,111124961,XM_022468739.1,uncharacterized LOC111124961,8678
NC_035780.1,39102730,39127237,39103107,39117637,111124962,XM_022468574.1,uncharacterized LOC111124962,14530
NC_035780.1,39102730,39127237,39102732,39117634,111124962,XM_022468366.1,uncharacterized LOC111124962,14902
NC_035780.1,39102730,39127237,39102730,39118376,111124962,XM_022468455.1,uncharacterized LOC111124962,15646
NC_035780.1,39102730,39127237,39125190,39127237,111124962,XM_022468657.1,uncharacterized LOC111124962,2047
NC_035782.1,16740282,16742356,16740282,16742356,111124963,XM_022468330.1,uncharacterized LOC111124963,2074
NC_035782.1,16862649,16881101,16862649,16881101,111124965,XM_022468335.1,uncharacterized LOC111124965,18452
NC_035782.1,16862649,16881101,16862653,16870331,111124965,XM_022468334.1,uncharacterized LOC111124965,7678
NC_035782.1,16876588,16880875,16876588,16880875,111124966,XM_022468336.1,uncharacterized LOC111124966,4287
NC_035782.1,16763198,16767588,16763198,16767588,111124968,XM_022468337.1,uncharacterized LOC111124968,4390
NC_035782.1,17006803,17015112,17006803,17015112,111124969,XM_022468338.1,uncharacterized LOC111124969,8309
NC_035782.1,16897141,16904576,16900106,16904576,111124970,XM_022468340.1,uncharacterized LOC111124970,4470
NC_035782.1,16897141,16904576,16897141,16904576,111124970,XM_022468339.1,uncharacterized LOC111124970,7435
NC_035782.1,16908150,16918330,16908150,16918330,111124972,XM_022468341.1,uncharacterized LOC111124972,10180
NC_035782.1,16327926,16340926,16327926,16340926,111124973,XM_022468342.1,uncharacterized LOC111124973,13000
NC_035782.1,16870875,16875147,16870878,16875147,111124974,XM_022468345.1,uncharacterized LOC111124974,4269
NC_035782.1,16870875,16875147,16870875,16875147,111124974,XM_022468344.1,uncharacterized LOC111124974,4272
NC_035782.1,16678559,16692193,16678559,16692193,111124975,XM_022468346.1,uncharacterized LOC111124975,13634
NC_035782.1,16678559,16692193,16686687,16692193,111124975,XM_022468347.1,uncharacterized LOC111124975,5506
NC_035782.1,16353519,16362968,16353519,16362968,111124978,XM_022468350.1,uncharacterized LOC111124978,9449
NC_035782.1,16919960,16927062,16919960,16927062,111124979,XM_022468351.1,uncharacterized LOC111124979,7102
NC_035780.1,22514597,22516689,22514597,22516689,111124986,XM_022468362.1,uncharacterized LOC111124986,2092
NC_035782.1,62694538,62697572,62694538,62697572,111124993,XM_022468370.1,uncharacterized LOC111124993,3034
NC_035780.1,22533487,22535443,22533487,22535443,111124994,XM_022468375.1,uncharacterized LOC111124994,1956
NC_035782.1,62698492,62724787,62698492,62724725,111124995,XM_022468373.1,uncharacterized LOC111124995,26233
NC_035782.1,62698492,62724787,62698492,62724787,111124995,XM_022468372.1,uncharacterized LOC111124995,26295
NC_035782.1,62690372,62693647,62690372,62693647,111124996,XM_022468374.1,uncharacterized LOC111124996,3275
NC_035780.1,22404219,22406365,22404311,22406365,111125000,XM_022468397.1,uncharacterized LOC111125000,2054
NC_035780.1,22404219,22406365,22404219,22406365,111125000,XM_022468389.1,uncharacterized LOC111125000,2146
NC_035782.1,27542754,27554349,27542754,27554348,111125002,XM_022468390.1,uncharacterized LOC111125002,11594
NC_035782.1,27542754,27554349,27542754,27554349,111125002,XM_022468391.1,uncharacterized LOC111125002,11595
NC_035782.1,27336719,27339595,27336719,27339595,111125005,XM_022468399.1,uncharacterized LOC111125005,2876
NC_035782.1,4510493,4521505,4511485,4521505,111125010,XM_022468408.1,uncharacterized LOC111125010,10020
NC_035782.1,4510493,4521505,4510493,4521500,111125010,XM_022468407.1,uncharacterized LOC111125010,11007
NC_035780.1,22339310,22344148,22339310,22344148,111125028,XM_022468449.1,uncharacterized LOC111125028,4838
NC_035780.1,22351531,22354754,22351531,22354754,111125033,XM_022468464.1,uncharacterized LOC111125033,3223
NC_035782.1,55558898,55563154,55561568,55563154,111125034,XM_022468466.1,uncharacterized LOC111125034,1586
NC_035782.1,55558898,55563154,55558934,55563154,111125034,XM_022468467.1,uncharacterized LOC111125034,4220
NC_035782.1,11047501,11079676,11047501,11079676,111125037,XM_022468471.1,uncharacterized LOC111125037,32175
NC_035780.1,22471903,22479571,22471903,22473987,111125044,XM_022468501.1,uncharacterized LOC111125044,2084
NC_035782.1,42242439,42270462,42242440,42261200,111125047,XM_022468489.1,uncharacterized LOC111125047,18760
NC_035782.1,42242439,42270462,42242439,42261200,111125047,XM_022468490.1,uncharacterized LOC111125047,18761
NC_035782.1,42242439,42270462,42242441,42270462,111125047,XM_022468491.1,uncharacterized LOC111125047,28021
NC_035782.1,6814259,6816661,6815743,6816661,111125052,XM_022468500.1,uncharacterized LOC111125052,918
NC_035782.1,74817729,74831258,74817729,74831258,111125054,XM_022468503.1,uncharacterized LOC111125054,13529
NC_035782.1,64814074,64822930,64814074,64822413,111125060,XM_022468514.1,uncharacterized LOC111125060,8339
NC_035782.1,64814074,64822930,64814074,64822423,111125060,XM_022468512.1,uncharacterized LOC111125060,8349
NC_035782.1,64814074,64822930,64814074,64822930,111125060,XM_022468513.1,uncharacterized LOC111125060,8856
NC_035782.1,68866678,68868218,68866678,68868218,111125066,XM_022468523.1,uncharacterized LOC111125066,1540
NC_035782.1,68855287,68860672,68855287,68860672,111125067,XM_022468524.1,uncharacterized LOC111125067,5385
NC_035782.1,68852796,68854510,68852796,68854510,111125069,XM_022468525.1,uncharacterized LOC111125069,1714
NC_035782.1,39251355,39275982,39251355,39275982,111125071,XM_022468528.1,uncharacterized LOC111125071,24627
NC_035782.1,62567495,62575601,62567495,62575601,111125078,XM_022468535.1,uncharacterized LOC111125078,8106
NC_035782.1,71938256,71956028,71938256,71954737,111125086,XM_022468549.1,uncharacterized LOC111125086,16481
NC_035782.1,71938256,71956028,71938256,71954738,111125086,XM_022468551.1,uncharacterized LOC111125086,16482
NC_035782.1,71938256,71956028,71938256,71956028,111125086,XM_022468550.1,uncharacterized LOC111125086,17772
NC_035782.1,46961673,47013614,46961673,47013614,111125088,XM_022468552.1,uncharacterized LOC111125088,51941
NC_035782.1,68937987,68941010,68937987,68941010,111125093,XM_022468564.1,uncharacterized LOC111125093,3023
NC_035782.1,68935328,68937966,68935499,68937966,111125094,XM_022468566.1,uncharacterized LOC111125094,2467
NC_035782.1,68935328,68937966,68935328,68937962,111125094,XM_022468565.1,uncharacterized LOC111125094,2634
NC_035782.1,55637762,55648716,55637762,55648716,111125095,XM_022468567.1,uncharacterized LOC111125095,10954
NC_035782.1,45928094,45931061,45928116,45931061,111125108,XM_022468581.1,uncharacterized LOC111125108,2945
NC_035782.1,45928094,45931061,45928094,45931061,111125108,XM_022468580.1,uncharacterized LOC111125108,2967
NC_035782.1,45935943,45937906,45935943,45937906,111125109,XM_022468582.1,uncharacterized LOC111125109,1963
NC_035782.1,45926300,45928236,45926300,45928138,111125110,XM_022468583.1,uncharacterized LOC111125110,1838
NC_035782.1,45926300,45928236,45926300,45928236,111125110,XM_022468584.1,uncharacterized LOC111125110,1936
NC_035782.1,45924208,45925888,45924208,45925888,111125111,XM_022468585.1,uncharacterized LOC111125111,1680
NC_035782.1,70715776,70719960,70715776,70719960,111125114,XM_022468589.1,uncharacterized LOC111125114,4184
NC_035782.1,55940118,55955795,55940118,55955795,111125117,XM_022468598.1,uncharacterized LOC111125117,15677
NC_035782.1,71740204,71746184,71740204,71746184,111125126,XM_022468620.1,uncharacterized LOC111125126,5980
NC_035782.1,2286718,2289394,2286718,2289394,111125127,XM_022468621.1,uncharacterized LOC111125127,2676
NC_035782.1,60366584,60368666,60366584,60368666,111125133,XM_022468630.1,uncharacterized LOC111125133,2082
NC_035782.1,20290430,20294590,20290430,20294590,111125139,XM_022468642.1,uncharacterized LOC111125139,4160
NC_035782.1,56731128,56734418,56731128,56734418,111125141,XM_022468643.1,uncharacterized LOC111125141,3290
NC_035782.1,68918708,68929382,68918708,68929382,111125146,XM_022468648.1,uncharacterized LOC111125146,10674
NC_035782.1,45413387,45438078,45413387,45432697,111125154,XM_022468675.1,uncharacterized LOC111125154,19310
NC_035782.1,45413387,45438078,45413387,45434188,111125154,XM_022468676.1,uncharacterized LOC111125154,20801
NC_035782.1,45413387,45438078,45413387,45437284,111125154,XM_022468673.1,uncharacterized LOC111125154,23897
NC_035782.1,45413387,45438078,45413387,45438078,111125154,XM_022468674.1,uncharacterized LOC111125154,24691
NC_035782.1,45647622,45669378,45647622,45669378,111125158,XM_022468686.1,uncharacterized LOC111125158,21756
NC_035782.1,45220551,45225068,45220551,45225068,111125166,XM_022468700.1,uncharacterized LOC111125166,4517
NC_035780.1,48693261,48694714,48693261,48694714,111125172,XM_022468711.1,uncharacterized LOC111125172,1453
NC_035782.1,9827693,9852576,9827693,9852576,111125190,XM_022468727.1,uncharacterized LOC111125190,24883
NC_035782.1,35435825,35442258,35437257,35442258,111125196,XM_022468736.1,uncharacterized LOC111125196,5001
NC_035782.1,35435825,35442258,35435825,35442258,111125196,XM_022468735.1,uncharacterized LOC111125196,6433
NC_035782.1,60652209,60661578,60655209,60661578,111125199,XM_022468742.1,uncharacterized LOC111125199,6369
NC_035782.1,60652209,60661578,60652214,60661578,111125199,XM_022468743.1,uncharacterized LOC111125199,9364
NC_035782.1,60652209,60661578,60652209,60661578,111125199,XM_022468740.1,uncharacterized LOC111125199,9369
NC_035782.1,62229069,62249826,62238213,62249826,111125208,XM_022468759.1,uncharacterized LOC111125208,11613
NC_035782.1,62229069,62249826,62237805,62249826,111125208,XM_022468764.1,uncharacterized LOC111125208,12021
NC_035782.1,62229069,62249826,62234634,62249826,111125208,XM_022468760.1,uncharacterized LOC111125208,15192
NC_035782.1,62229069,62249826,62229069,62249826,111125208,XM_022468762.1,uncharacterized LOC111125208,20757
NC_035782.1,62229069,62249826,62240480,62249826,111125208,XM_022468763.1,uncharacterized LOC111125208,9346
NC_035780.1,31977503,31984341,31980117,31984341,111125212,XM_022468806.1,uncharacterized LOC111125212,4224
NC_035780.1,31977503,31984341,31977503,31984341,111125212,XM_022468774.1,uncharacterized LOC111125212,6838
NC_035782.1,67389576,67397247,67389576,67397247,111125213,XM_022468770.1,uncharacterized LOC111125213,7671
NC_035782.1,38882741,38896286,38882741,38896286,111125220,XM_022468781.1,uncharacterized LOC111125220,13545
NC_035782.1,56253016,56266549,56253016,56266549,111125225,XM_022468798.1,uncharacterized LOC111125225,13533
NC_035782.1,64377056,64382473,64377056,64382473,111125226,XM_022468799.1,uncharacterized LOC111125226,5417
NC_035782.1,64363735,64367185,64363735,64367185,111125228,XM_022468802.1,uncharacterized LOC111125228,3450
NC_035782.1,58580227,58581986,58580227,58581986,111125233,XM_022468807.1,uncharacterized LOC111125233,1759
NC_035782.1,26883432,26884977,26883432,26884977,111125235,XM_022468810.1,uncharacterized LOC111125235,1545
NC_035782.1,26880834,26883125,26880834,26883125,111125236,XM_022468811.1,uncharacterized LOC111125236,2291
NC_035782.1,51058948,51072988,51058948,51072968,111125238,XM_022468818.1,uncharacterized LOC111125238,14020
NC_035782.1,51058948,51072988,51058948,51072988,111125238,XM_022468820.1,uncharacterized LOC111125238,14040
NC_035782.1,10878131,10885679,10878131,10885679,111125244,XM_022468829.1,uncharacterized LOC111125244,7548
NC_035782.1,17221358,17229079,17221358,17229079,111125254,XM_022468844.1,uncharacterized LOC111125254,7721
NC_035782.1,204048,222862,204048,219836,111125255,XM_022468846.1,uncharacterized LOC111125255,15788
NC_035782.1,204048,222862,204048,222861,111125255,XM_022468847.1,uncharacterized LOC111125255,18813
NC_035782.1,204048,222862,204048,222862,111125255,XM_022468845.1,uncharacterized LOC111125255,18814
NC_035782.1,204048,222862,204048,213581,111125255,XM_022468848.1,uncharacterized LOC111125255,9533
NC_035782.1,317682,339149,317682,339149,111125257,XM_022468851.1,uncharacterized LOC111125257,21467
NC_035782.1,273007,275507,273007,275507,111125258,XM_022468852.1,uncharacterized LOC111125258,2500
NC_035780.1,30267130,30271883,30267130,30271883,111125268,XM_022468886.1,uncharacterized LOC111125268,4753
NC_035782.1,171359,172625,171359,172625,111125269,XM_022468865.1,uncharacterized LOC111125269,1266
NC_035782.1,161003,163802,161003,163802,111125270,XM_022468866.1,uncharacterized LOC111125270,2799
NC_035782.1,19368221,19374704,19368777,19374704,111125277,XM_022468882.1,uncharacterized LOC111125277,5927
NC_035782.1,19368221,19374704,19368238,19374704,111125277,XM_022468883.1,uncharacterized LOC111125277,6466
NC_035782.1,19368221,19374704,19368221,19374704,111125277,XM_022468880.1,uncharacterized LOC111125277,6483
NC_035782.1,19374866,19375409,19374866,19375409,111125279,XM_022468885.1,uncharacterized LOC111125279,543
NC_035780.1,30271711,30278057,30271711,30278050,111125285,XM_022468898.1,uncharacterized LOC111125285,6339
NC_035782.1,51345898,51354084,51352721,51354084,111125286,XM_022468897.1,uncharacterized LOC111125286,1363
NC_035782.1,51345898,51354084,51345898,51347272,111125286,XM_022468895.1,uncharacterized LOC111125286,1374
NC_035782.1,51345898,51354084,51345898,51354033,111125286,XM_022468896.1,uncharacterized LOC111125286,8135
NC_035782.1,51357158,51359030,51357158,51359030,111125287,XM_022468899.1,uncharacterized LOC111125287,1872
NC_035782.1,32210226,32284899,32210226,32284899,111125288,XM_022468900.1,uncharacterized LOC111125288,74673
NC_035782.1,61495956,61517196,61498905,61517196,111125290,XM_022468903.1,uncharacterized LOC111125290,18291
NC_035782.1,61495956,61517196,61498904,61517196,111125290,XM_022468904.1,uncharacterized LOC111125290,18292
NC_035782.1,61495956,61517196,61495956,61517196,111125290,XM_022468902.1,uncharacterized LOC111125290,21240
NC_035782.1,61080587,61091370,61080587,61091366,111125298,XM_022468918.1,uncharacterized LOC111125298,10779
NC_035782.1,61080587,61091370,61080587,61091370,111125298,XM_022468917.1,uncharacterized LOC111125298,10783
NC_035782.1,61080587,61091370,61080587,61087914,111125298,XM_022468920.1,uncharacterized LOC111125298,7327
NC_035782.1,61080587,61091370,61080587,61089335,111125298,XM_022468919.1,uncharacterized LOC111125298,8748
NC_035782.1,39495856,39508842,39495860,39508842,111125308,XM_022468936.1,uncharacterized LOC111125308,12982
NC_035782.1,39495856,39508842,39495857,39508842,111125308,XM_022468935.1,uncharacterized LOC111125308,12985
NC_035782.1,39495856,39508842,39495856,39508842,111125308,XM_022468937.1,uncharacterized LOC111125308,12986
NC_035780.1,62758210,62760408,62758210,62760408,111125309,XM_022468941.1,uncharacterized LOC111125309,2198
NC_035782.1,47021915,47074577,47021915,47074577,111125312,XM_022468944.1,uncharacterized LOC111125312,52662
NC_035782.1,47109945,47120943,47109945,47120027,111125314,XM_022468948.1,uncharacterized LOC111125314,10082
NC_035782.1,47077474,47096491,47077474,47096491,111125318,XM_022468954.1,uncharacterized LOC111125318,19017
NC_035780.1,30443977,30448816,30443977,30448816,111125321,XM_022468967.1,uncharacterized LOC111125321,4839
NC_035782.1,51890800,51904155,51890800,51904155,111125328,XM_022468983.1,uncharacterized LOC111125328,13355
NC_035782.1,15241545,15287834,15241545,15287834,111125335,XM_022469032.1,uncharacterized LOC111125335,46289
NC_035782.1,15237031,15253037,15237031,15248484,111125336,XM_022469041.1,uncharacterized LOC111125336,11453
NC_035782.1,15237031,15253037,15237031,15248492,111125336,XM_022469037.1,uncharacterized LOC111125336,11461
NC_035782.1,15237031,15253037,15237031,15253037,111125336,XM_022469036.1,uncharacterized LOC111125336,16006
NC_035782.1,15237031,15253037,15237031,15238924,111125336,XM_022469033.1,uncharacterized LOC111125336,1893
NC_035782.1,15237031,15253037,15237031,15239390,111125336,XM_022469040.1,uncharacterized LOC111125336,2359
NC_035782.1,15237031,15253037,15237031,15239935,111125336,XM_022469042.1,uncharacterized LOC111125336,2904
NC_035782.1,15237031,15253037,15237031,15244513,111125336,XM_022469035.1,uncharacterized LOC111125336,7482
NC_035782.1,62114265,62128839,62114265,62128839,111125340,XM_022469045.1,uncharacterized LOC111125340,14574
NC_035782.1,62138457,62150999,62138457,62150999,111125341,XM_022469046.1,uncharacterized LOC111125341,12542
NC_035782.1,62087675,62096819,62087675,62096819,111125342,XM_022469048.1,uncharacterized LOC111125342,9144
NC_035782.1,7970436,7974060,7970436,7974019,111125344,XM_022469051.1,uncharacterized LOC111125344,3583
NC_035782.1,7970436,7974060,7970436,7974051,111125344,XM_022469050.1,uncharacterized LOC111125344,3615
NC_035782.1,7970436,7974060,7970436,7974060,111125344,XM_022469049.1,uncharacterized LOC111125344,3624
NC_035782.1,7962876,7965267,7962876,7965267,111125345,XM_022469052.1,uncharacterized LOC111125345,2391
NC_035782.1,7979945,7981307,7979945,7981307,111125346,XM_022469054.1,uncharacterized LOC111125346,1362
NC_035782.1,75692099,75716529,75699048,75716529,111125365,XM_022469110.1,uncharacterized LOC111125365,17481
NC_035782.1,75692099,75716529,75699020,75716529,111125365,XM_022469111.1,uncharacterized LOC111125365,17509
NC_035782.1,75692099,75716529,75698719,75716529,111125365,XM_022469107.1,uncharacterized LOC111125365,17810
NC_035782.1,75692099,75716529,75692099,75716529,111125365,XM_022469108.1,uncharacterized LOC111125365,24430
NC_035782.1,75752609,75758367,75752609,75758367,111125366,XM_022469113.1,uncharacterized LOC111125366,5758
NC_035782.1,37713789,37719278,37713789,37717775,111125370,XM_022469118.1,uncharacterized LOC111125370,3986
NC_035782.1,68698338,68710601,68698338,68710592,111125372,XM_022469119.1,uncharacterized LOC111125372,12254
NC_035782.1,68698338,68710601,68699122,68706173,111125372,XM_022469120.1,uncharacterized LOC111125372,7051
NC_035782.1,68698338,68710601,68699122,68706174,111125372,XM_022469122.1,uncharacterized LOC111125372,7052
NC_035782.1,68698338,68710601,68699122,68706621,111125372,XM_022469121.1,uncharacterized LOC111125372,7499
NC_035782.1,30442085,30462179,30442085,30452190,111125375,XM_022469127.1,uncharacterized LOC111125375,10105
NC_035782.1,30442085,30462179,30442085,30453491,111125375,XM_022469132.1,uncharacterized LOC111125375,11406
NC_035782.1,30442085,30462179,30442085,30455487,111125375,XM_022469134.1,uncharacterized LOC111125375,13402
NC_035782.1,30442085,30462179,30442085,30456499,111125375,XM_022469126.1,uncharacterized LOC111125375,14414
NC_035782.1,30442085,30462179,30442085,30457969,111125375,XM_022469129.1,uncharacterized LOC111125375,15884
NC_035782.1,30442085,30462179,30442085,30458098,111125375,XM_022469133.1,uncharacterized LOC111125375,16013
NC_035782.1,30442085,30462179,30442085,30462179,111125375,XM_022469130.1,uncharacterized LOC111125375,20094
NC_035782.1,30442085,30462179,30442085,30451240,111125375,XM_022469131.1,uncharacterized LOC111125375,9155
NC_035782.1,42996071,43007829,42996071,43007829,111125377,XM_022469136.1,uncharacterized LOC111125377,11758
NC_035780.1,7260156,7262546,7260156,7262546,111125382,XM_022469144.1,uncharacterized LOC111125382,2390
NC_035782.1,46596050,46601057,46596050,46600379,111125388,XM_022469149.1,uncharacterized LOC111125388,4329
NC_035782.1,46596050,46601057,46596065,46601057,111125388,XM_022469148.1,uncharacterized LOC111125388,4992
NC_035782.1,9621634,9643413,9621634,9632483,111125394,XM_022469158.1,uncharacterized LOC111125394,10849
NC_035782.1,9621634,9643413,9621634,9643393,111125394,XM_022469160.1,uncharacterized LOC111125394,21759
NC_035782.1,9621634,9643413,9621634,9643413,111125394,XM_022469159.1,uncharacterized LOC111125394,21779
NC_035782.1,55750228,55761483,55752116,55755120,111125398,XM_022469163.1,uncharacterized LOC111125398,3004
NC_035782.1,55750228,55761483,55752116,55758088,111125398,XM_022469165.1,uncharacterized LOC111125398,5972
NC_035782.1,41076585,41081278,41076585,41081278,111125417,XM_022469202.1,uncharacterized LOC111125417,4693
NC_035782.1,41261692,41264645,41261692,41264645,111125422,XM_022469207.1,uncharacterized LOC111125422,2953
NC_035782.1,18310944,18313639,18310944,18313639,111125425,XM_022469208.1,uncharacterized LOC111125425,2695
NC_035782.1,18304311,18310696,18304311,18310696,111125426,XM_022469209.1,uncharacterized LOC111125426,6385
NC_035782.1,49632009,49655673,49642377,49655673,111125429,XM_022469221.1,uncharacterized LOC111125429,13296
NC_035782.1,49632009,49655673,49633572,49655673,111125429,XM_022469220.1,uncharacterized LOC111125429,22101
NC_035782.1,49632009,49655673,49632354,49655673,111125429,XM_022469217.1,uncharacterized LOC111125429,23319
NC_035782.1,49632009,49655673,49632009,49655673,111125429,XM_022469219.1,uncharacterized LOC111125429,23664
NC_035780.1,9974894,9977603,9974894,9977603,111125430,XM_022469225.1,uncharacterized LOC111125430,2709
NC_035782.1,57323486,57334741,57323486,57334741,111125432,XM_022469226.1,uncharacterized LOC111125432,11255
NC_035782.1,16105386,16114465,16105386,16114465,111125434,XM_022469232.1,uncharacterized LOC111125434,9079
NC_035782.1,16133760,16164485,16133760,16153546,111125436,XM_022469236.1,uncharacterized LOC111125436,19786
NC_035782.1,16133760,16164485,16133760,16164485,111125436,XM_022469235.1,uncharacterized LOC111125436,30725
NC_035782.1,16133760,16164485,16133760,16142332,111125436,XM_022469237.1,uncharacterized LOC111125436,8572
NC_035782.1,16126821,16133145,16128160,16130947,111125437,XM_022469244.1,uncharacterized LOC111125437,2787
NC_035782.1,16126821,16133145,16126821,16130274,111125437,XM_022469241.1,uncharacterized LOC111125437,3453
NC_035782.1,16126821,16133145,16129572,16133145,111125437,XM_022469242.1,uncharacterized LOC111125437,3573
NC_035782.1,16126821,16133145,16129542,16133145,111125437,XM_022469243.1,uncharacterized LOC111125437,3603
NC_035782.1,16126821,16133145,16126821,16130817,111125437,XM_022469240.1,uncharacterized LOC111125437,3996
NC_035782.1,16126821,16133145,16126821,16130947,111125437,XM_022469239.1,uncharacterized LOC111125437,4126
NC_035780.1,17847903,17871519,17847903,17871519,111125438,XM_022469248.1,uncharacterized LOC111125438,23616
NC_035780.1,57477200,57538707,57477200,57538707,111125444,XM_022469263.1,uncharacterized LOC111125444,61507
NC_035782.1,75111598,75120312,75111598,75120312,111125449,XM_022469268.1,uncharacterized LOC111125449,8714
NC_035780.1,57679840,57737553,57679841,57737552,111125451,XM_022469286.1,uncharacterized LOC111125451,57711
NC_035780.1,57679840,57737553,57679840,57737553,111125451,XM_022469276.1,uncharacterized LOC111125451,57713
NC_035782.1,41456714,41474947,41456714,41474947,111125453,XM_022469285.1,uncharacterized LOC111125453,18233
NC_035782.1,41452023,41456568,41452023,41456568,111125454,XM_022469287.1,uncharacterized LOC111125454,4545
NC_035782.1,55230634,55233732,55230634,55233732,111125456,XM_022469289.1,uncharacterized LOC111125456,3098
NC_035782.1,14387573,14390771,14387573,14390771,111125467,XM_022469349.1,uncharacterized LOC111125467,3198
NC_035782.1,49205667,49222713,49205667,49222713,111125479,XM_022469365.1,uncharacterized LOC111125479,17046
NC_035782.1,49332061,49334216,49332061,49334216,111125482,XM_022469370.1,uncharacterized LOC111125482,2155
NC_035780.1,36111492,36120975,36111492,36120975,111125484,XM_022469378.1,uncharacterized LOC111125484,9483
NC_035782.1,72486950,72493742,72486950,72493742,111125485,XM_022469375.1,uncharacterized LOC111125485,6792
NC_035782.1,72123282,72130992,72123282,72130992,111125487,XM_022469381.1,uncharacterized LOC111125487,7710
NC_035782.1,75359830,75368443,75359830,75368443,111125493,XM_022469396.1,uncharacterized LOC111125493,8613
NC_035782.1,62738228,62909326,62738228,62909326,111125499,XM_022469401.1,uncharacterized LOC111125499,171098
NC_035782.1,62845560,62852548,62845560,62852548,111125500,XM_022469403.1,uncharacterized LOC111125500,6988
NC_035782.1,62788672,62799992,62788672,62799992,111125508,XM_022469419.1,uncharacterized LOC111125508,11320
NC_035782.1,62788672,62799992,62794136,62799992,111125508,XM_022469420.1,uncharacterized LOC111125508,5856
NC_035782.1,62808294,62839396,62808294,62839396,111125510,XM_022469422.1,uncharacterized LOC111125510,31102
NC_035782.1,62878418,62880850,62878418,62880850,111125512,XM_022469423.1,uncharacterized LOC111125512,2432
NC_035782.1,62912342,62919199,62912342,62919198,111125513,XM_022469424.1,uncharacterized LOC111125513,6856
NC_035782.1,62912342,62919199,62912342,62919199,111125513,XM_022469425.1,uncharacterized LOC111125513,6857
NC_035782.1,62890039,62898847,62890104,62898847,111125514,XM_022469430.1,uncharacterized LOC111125514,8743
NC_035782.1,62890039,62898847,62890084,62898847,111125514,XM_022469429.1,uncharacterized LOC111125514,8763
NC_035782.1,62890039,62898847,62890039,62898847,111125514,XM_022469427.1,uncharacterized LOC111125514,8808
NC_035782.1,63085382,63091831,63085382,63087461,111125515,XM_022469432.1,uncharacterized LOC111125515,2079
NC_035782.1,63085382,63091831,63085382,63091831,111125515,XM_022469431.1,uncharacterized LOC111125515,6449
NC_035782.1,63056073,63063679,63056073,63063679,111125516,XM_022469433.1,uncharacterized LOC111125516,7606
NC_035782.1,4241427,4264973,4241427,4264973,111125531,XM_022469449.1,uncharacterized LOC111125531,23546
NC_035780.1,10225937,10255008,10225937,10255008,111125536,XM_022469460.1,uncharacterized LOC111125536,29071
NC_035782.1,75594056,75597596,75594056,75597596,111125542,XM_022469467.1,uncharacterized LOC111125542,3540
NC_035782.1,10100838,10112665,10101889,10112665,111125543,XM_022469472.1,uncharacterized LOC111125543,10776
NC_035782.1,10100838,10112665,10101888,10112665,111125543,XM_022469468.1,uncharacterized LOC111125543,10777
NC_035782.1,10100838,10112665,10100855,10112665,111125543,XM_022469469.1,uncharacterized LOC111125543,11810
NC_035782.1,10100838,10112665,10100850,10112665,111125543,XM_022469470.1,uncharacterized LOC111125543,11815
NC_035782.1,10100838,10112665,10100838,10112665,111125543,XM_022469471.1,uncharacterized LOC111125543,11827
NC_035782.1,10096885,10099018,10096885,10099018,111125545,XM_022469475.1,uncharacterized LOC111125545,2133
NC_035782.1,32523895,32526103,32523895,32526103,111125549,XM_022469478.1,uncharacterized LOC111125549,2208
NC_035782.1,75056451,75057947,75056451,75057947,111125552,XM_022469482.1,uncharacterized LOC111125552,1496
NC_035782.1,4784790,4806308,4784790,4806308,111125558,XM_022469491.1,uncharacterized LOC111125558,21518
NC_035782.1,4806490,4812052,4806490,4812052,111125559,XM_022469495.1,uncharacterized LOC111125559,5562
NC_035782.1,55098356,55119846,55098356,55119846,111125560,XM_022469497.1,uncharacterized LOC111125560,21490
NC_035782.1,11907902,11909637,11907902,11909637,111125563,XM_022469502.1,uncharacterized LOC111125563,1735
NC_035782.1,11919825,11921723,11919825,11921723,111125564,XM_022469503.1,uncharacterized LOC111125564,1898
NC_035782.1,11912055,11914920,11912055,11914920,111125565,XM_022469506.1,uncharacterized LOC111125565,2865
NC_035782.1,11923668,11926534,11923668,11926534,111125566,XM_022469507.1,uncharacterized LOC111125566,2866
NC_035782.1,44020858,44031528,44020858,44031528,111125568,XM_022469517.1,uncharacterized LOC111125568,10670
NC_035782.1,8295344,8314151,8295344,8314151,111125579,XM_022469543.1,uncharacterized LOC111125579,18807
NC_035782.1,42422529,42424055,42422529,42424055,111125582,XM_022469547.1,uncharacterized LOC111125582,1526
NC_035782.1,42434842,42437749,42434842,42437749,111125583,XM_022469548.1,uncharacterized LOC111125583,2907
NC_035782.1,42424757,42428282,42424757,42428282,111125584,XM_022469549.1,uncharacterized LOC111125584,3525
NC_035782.1,67309745,67315443,67309745,67315443,111125588,XM_022469551.1,uncharacterized LOC111125588,5698
NC_035782.1,8977679,8986044,8977929,8986044,111125590,XM_022469554.1,uncharacterized LOC111125590,8115
NC_035782.1,8977679,8986044,8977679,8986044,111125590,XM_022469557.1,uncharacterized LOC111125590,8365
NC_035782.1,5544360,5550048,5544360,5550048,111125593,XM_022469561.1,uncharacterized LOC111125593,5688
NC_035782.1,5637785,5659916,5646354,5659916,111125594,XM_022469571.1,uncharacterized LOC111125594,13562
NC_035782.1,5637785,5659916,5637785,5657791,111125594,XM_022469569.1,uncharacterized LOC111125594,20006
NC_035782.1,5637785,5659916,5637785,5657852,111125594,XM_022469570.1,uncharacterized LOC111125594,20067
NC_035782.1,5637785,5659916,5637785,5659916,111125594,XM_022469568.1,uncharacterized LOC111125594,22131
NC_035782.1,5570583,5576497,5570583,5576497,111125601,XM_022469579.1,uncharacterized LOC111125601,5914
NC_035782.1,5625099,5627718,5625099,5627718,111125603,XM_022469581.1,uncharacterized LOC111125603,2619
NC_035782.1,5756494,5758743,5756494,5758743,111125605,XM_022469583.1,uncharacterized LOC111125605,2249
NC_035782.1,5943116,5972407,5943116,5972407,111125606,XM_022469585.1,uncharacterized LOC111125606,29291
NC_035780.1,56040741,56055191,56040741,56055191,111125607,XM_022469597.1,uncharacterized LOC111125607,14450
NC_035780.1,56040741,56055191,56040741,56049857,111125607,XM_022469589.1,uncharacterized LOC111125607,9116
NC_035782.1,5767010,5772934,5767010,5772934,111125617,XM_022469595.1,uncharacterized LOC111125617,5924
NC_035782.1,5527123,5532930,5527123,5532930,111125618,XM_022469596.1,uncharacterized LOC111125618,5807
NC_035782.1,5829384,5848233,5829384,5848233,111125619,XM_022469598.1,uncharacterized LOC111125619,18849
NC_035782.1,27969177,27983564,27969177,27983564,111125624,XM_022469602.1,uncharacterized LOC111125624,14387
NC_035782.1,27940043,27984764,27940043,27984764,111125625,XM_022469604.1,uncharacterized LOC111125625,44721
NC_035782.1,11163019,11188012,11163019,11188012,111125626,XM_022469605.1,uncharacterized LOC111125626,24993
NC_035782.1,24638533,24649388,24638533,24649388,111125637,XM_022469633.1,uncharacterized LOC111125637,10855
NC_035782.1,24656608,24668123,24656608,24668123,111125639,XM_022469636.1,uncharacterized LOC111125639,11515
NC_035782.1,24656608,24668123,24659920,24668123,111125639,XM_022469639.1,uncharacterized LOC111125639,8203
NC_035782.1,24692953,24701716,24692953,24701716,111125640,XM_022469640.1,uncharacterized LOC111125640,8763
NC_035782.1,24710081,24759895,24747375,24759895,111125641,XM_022469642.1,uncharacterized LOC111125641,12520
NC_035782.1,24710081,24759895,24710081,24759895,111125641,XM_022469643.1,uncharacterized LOC111125641,49814
NC_035782.1,24672271,24688200,24672271,24682272,111125642,XM_022469645.1,uncharacterized LOC111125642,10001
NC_035782.1,24672271,24688200,24672271,24688200,111125642,XM_022469647.1,uncharacterized LOC111125642,15929
NC_035782.1,26749382,26814963,26767774,26814963,111125661,XM_022469684.1,uncharacterized LOC111125661,47189
NC_035782.1,26749382,26814963,26761245,26814963,111125661,XM_022469683.1,uncharacterized LOC111125661,53718
NC_035782.1,26749382,26814963,26749382,26814963,111125661,XM_022469682.1,uncharacterized LOC111125661,65581
NC_035782.1,13531633,13535026,13531633,13535026,111125683,XM_022469739.1,uncharacterized LOC111125683,3393
NC_035780.1,55909203,55911816,55909203,55911816,111125689,XM_022469748.1,uncharacterized LOC111125689,2613
NC_035782.1,12945080,12946230,12945080,12946230,111125692,XM_022469750.1,uncharacterized LOC111125692,1150
NC_035782.1,12904523,12907090,12904523,12907090,111125694,XM_022469752.1,uncharacterized LOC111125694,2567
NC_035782.1,13050500,13061322,13050500,13061303,111125695,XM_022469755.1,uncharacterized LOC111125695,10803
NC_035782.1,13050500,13061322,13050500,13061322,111125695,XM_022469754.1,uncharacterized LOC111125695,10822
NC_035782.1,13041218,13047295,13041218,13047295,111125696,XM_022469756.1,uncharacterized LOC111125696,6077
NC_035780.1,55907131,55909209,55907131,55909209,111125697,XM_022469761.1,uncharacterized LOC111125697,2078
NC_035782.1,13196230,13202829,13196230,13202800,111125698,XM_022469758.1,uncharacterized LOC111125698,6570
NC_035782.1,13196230,13202829,13196230,13202829,111125698,XM_022469757.1,uncharacterized LOC111125698,6599
NC_035782.1,75103919,75108182,75103919,75108182,111125713,XM_022469770.1,uncharacterized LOC111125713,4263
NC_035780.1,55922164,55923343,55922164,55923343,111125722,XM_022469791.1,uncharacterized LOC111125722,1179
NC_035780.1,55879968,55903599,55879968,55903599,111125729,XM_022469803.1,uncharacterized LOC111125729,23631
NC_035782.1,45836266,45841204,45839053,45841204,111125734,XM_022469806.1,uncharacterized LOC111125734,2151
NC_035782.1,45836266,45841204,45836266,45841204,111125734,XM_022469807.1,uncharacterized LOC111125734,4938
NC_035780.1,55914253,55915416,55914253,55915416,111125736,XM_022469817.1,uncharacterized LOC111125736,1163
NC_035782.1,2640248,2644795,2640248,2644795,111125741,XM_022469825.1,uncharacterized LOC111125741,4547
NC_035780.1,42541943,42554888,42541943,42554888,111125742,XM_022469828.1,uncharacterized LOC111125742,12945
NC_035782.1,2665004,2668653,2665004,2668653,111125743,XM_022469826.1,uncharacterized LOC111125743,3649
NC_035782.1,69746179,69747326,69746179,69747326,111125747,XM_022469830.1,uncharacterized LOC111125747,1147
NC_035782.1,18346292,18348422,18346292,18348422,111125751,XM_022469834.1,uncharacterized LOC111125751,2130
NC_035782.1,46261083,46270608,46261083,46269657,111125752,XM_022469835.1,uncharacterized LOC111125752,8574
NC_035782.1,46261083,46270608,46261083,46269662,111125752,XM_022469836.1,uncharacterized LOC111125752,8579
NC_035782.1,46261083,46270608,46261083,46270608,111125752,XM_022469837.1,uncharacterized LOC111125752,9525
NC_035782.1,6716051,6721453,6716051,6721453,111125763,XM_022469854.1,uncharacterized LOC111125763,5402
NC_035782.1,59346915,59356209,59346915,59356209,111125765,XM_022469876.1,uncharacterized LOC111125765,9294
NC_035782.1,59356745,59359073,59356745,59359073,111125766,XM_022469877.1,uncharacterized LOC111125766,2328
NC_035782.1,44603927,44627697,44603927,44627697,111125768,XM_022469882.1,uncharacterized LOC111125768,23770
NC_035782.1,63597054,63602542,63597054,63602542,111125770,XM_022469886.1,uncharacterized LOC111125770,5488
NC_035782.1,63589070,63597084,63589070,63596394,111125771,XM_022469890.1,uncharacterized LOC111125771,7324
NC_035782.1,63589070,63597084,63589075,63597084,111125771,XM_022469888.1,uncharacterized LOC111125771,8009
NC_035782.1,63589070,63597084,63589074,63597084,111125771,XM_022469887.1,uncharacterized LOC111125771,8010
NC_035782.1,23494908,23501066,23494908,23501032,111125774,XM_022469893.1,uncharacterized LOC111125774,6124
NC_035782.1,23494908,23501066,23494908,23501061,111125774,XM_022469894.1,uncharacterized LOC111125774,6153
NC_035782.1,23494908,23501066,23494908,23501066,111125774,XM_022469892.1,uncharacterized LOC111125774,6158
NC_035782.1,23445041,23465160,23445041,23465160,111125775,XM_022469895.1,uncharacterized LOC111125775,20119
NC_035782.1,43458323,43481481,43458323,43481481,111125780,XM_022469899.1,uncharacterized LOC111125780,23158
NC_035782.1,47591328,47689198,47591328,47689198,111125783,XM_022469903.1,uncharacterized LOC111125783,97870
NC_035782.1,7869518,7877583,7869518,7876851,111125786,XM_022469907.1,uncharacterized LOC111125786,7333
NC_035782.1,72015108,72026499,72015108,72026499,111125794,XM_022469918.1,uncharacterized LOC111125794,11391
NC_035782.1,36117187,36141743,36117188,36129199,111125802,XM_022469944.1,uncharacterized LOC111125802,12011
NC_035782.1,36117187,36141743,36117188,36130316,111125802,XM_022469947.1,uncharacterized LOC111125802,13128
NC_035782.1,36117187,36141743,36117188,36134364,111125802,XM_022469943.1,uncharacterized LOC111125802,17176
NC_035782.1,36117187,36141743,36117188,36135528,111125802,XM_022469945.1,uncharacterized LOC111125802,18340
NC_035782.1,36117187,36141743,36117188,36136594,111125802,XM_022469946.1,uncharacterized LOC111125802,19406
NC_035782.1,36117187,36141743,36117187,36141743,111125802,XM_022469938.1,uncharacterized LOC111125802,24556
NC_035782.1,36117187,36141743,36117187,36125577,111125802,XM_022469939.1,uncharacterized LOC111125802,8390
NC_035782.1,36117187,36141743,36117188,36125677,111125802,XM_022469942.1,uncharacterized LOC111125802,8489
NC_035782.1,36117187,36141743,36117188,36125964,111125802,XM_022469941.1,uncharacterized LOC111125802,8776
NC_035782.1,59197867,59201426,59197867,59201426,111125805,XM_022469954.1,uncharacterized LOC111125805,3559
NC_035782.1,18088338,18091204,18089789,18091036,111125810,XM_022469961.1,uncharacterized LOC111125810,1247
NC_035782.1,18088338,18091204,18089457,18091204,111125810,XM_022469963.1,uncharacterized LOC111125810,1747
NC_035782.1,18088338,18091204,18088338,18091204,111125810,XM_022469962.1,uncharacterized LOC111125810,2866
NC_035782.1,64329793,64347171,64336124,64347171,111125816,XM_022469973.1,uncharacterized LOC111125816,11047
NC_035782.1,64329793,64347171,64329793,64347171,111125816,XM_022469972.1,uncharacterized LOC111125816,17378
NC_035782.1,69926005,69929646,69926005,69929646,111125831,XM_022469994.1,uncharacterized LOC111125831,3641
NC_035782.1,67318050,67359549,67341437,67359548,111125833,XM_022470007.1,uncharacterized LOC111125833,18111
NC_035782.1,67318050,67359549,67341436,67359549,111125833,XM_022470001.1,uncharacterized LOC111125833,18113
NC_035782.1,67318050,67359549,67341032,67359549,111125833,XM_022470006.1,uncharacterized LOC111125833,18517
NC_035782.1,67318050,67359549,67320888,67359514,111125833,XM_022470000.1,uncharacterized LOC111125833,38626
NC_035782.1,56450410,56459977,56450644,56459977,111125837,XM_022470011.1,uncharacterized LOC111125837,9333
NC_035782.1,56450410,56459977,56450410,56459977,111125837,XM_022470010.1,uncharacterized LOC111125837,9567
NC_035782.1,19360434,19364903,19361602,19364903,111125847,XM_022470028.1,uncharacterized LOC111125847,3301
NC_035782.1,74580545,74588831,74580545,74588831,111125848,XM_022470029.1,uncharacterized LOC111125848,8286
NC_035782.1,58340381,58341807,58340381,58341807,111125866,XM_022470068.1,uncharacterized LOC111125866,1426
NC_035782.1,27927237,27937367,27927237,27937367,111125878,XM_022470086.1,uncharacterized LOC111125878,10130
NC_035780.1,42918277,42922536,42918277,42922536,111125879,XM_022470129.1,uncharacterized LOC111125879,4259
NC_035782.1,57853376,57865236,57853376,57865236,111125892,XM_022470116.1,uncharacterized LOC111125892,11860
NC_035782.1,57838232,57840692,57838232,57840692,111125893,XM_022470117.1,uncharacterized LOC111125893,2460
NC_035782.1,57840687,57841414,57840687,57841414,111125894,XM_022470118.1,uncharacterized LOC111125894,727
NC_035782.1,57887646,57888763,57887646,57888763,111125895,XM_022470119.1,uncharacterized LOC111125895,1117
NC_035782.1,27788978,27793941,27788978,27793323,111125898,XM_022470124.1,uncharacterized LOC111125898,4345
NC_035782.1,27788978,27793941,27788978,27793941,111125898,XM_022470123.1,uncharacterized LOC111125898,4963
NC_035782.1,27794064,27796855,27794064,27796855,111125899,XM_022470125.1,uncharacterized LOC111125899,2791
NC_035782.1,27784245,27785659,27784245,27785659,111125900,XM_022470126.1,uncharacterized LOC111125900,1414
NC_035782.1,27777939,27780308,27777939,27780308,111125901,XM_022470127.1,uncharacterized LOC111125901,2369
NC_035782.1,14228520,14274240,14228520,14274240,111125916,XM_022470156.1,uncharacterized LOC111125916,45720
NC_035782.1,3659742,3666634,3665031,3666634,111125923,XM_022470172.1,uncharacterized LOC111125923,1603
NC_035782.1,3659742,3666634,3659742,3662000,111125923,XM_022470170.1,uncharacterized LOC111125923,2258
NC_035782.1,3659742,3666634,3659742,3666634,111125923,XM_022470171.1,uncharacterized LOC111125923,6892
NC_035782.1,3675075,3676733,3675075,3676733,111125926,XM_022470176.1,uncharacterized LOC111125926,1658
NC_035782.1,3690514,3692333,3690514,3692093,111125927,XM_022470177.1,uncharacterized LOC111125927,1579
NC_035782.1,3690514,3692333,3690514,3692333,111125927,XM_022470178.1,uncharacterized LOC111125927,1819
NC_035782.1,3686862,3689408,3686862,3689408,111125928,XM_022470179.1,uncharacterized LOC111125928,2546
NC_035782.1,3655506,3657075,3655506,3657075,111125929,XM_022470180.1,uncharacterized LOC111125929,1569
NC_035782.1,8400735,8424972,8421001,8424972,111125933,XM_022470191.1,uncharacterized LOC111125933,3971
NC_035782.1,8394218,8398428,8394218,8398428,111125934,XM_022470194.1,uncharacterized LOC111125934,4210
NC_035782.1,8401123,8415824,8401123,8415823,111125935,XM_022470195.1,uncharacterized LOC111125935,14700
NC_035782.1,8401123,8415824,8401123,8415824,111125935,XM_022470196.1,uncharacterized LOC111125935,14701
NC_035780.1,17109886,17115028,17110508,17115028,111125943,XM_022470259.1,uncharacterized LOC111125943,4520
NC_035780.1,17109886,17115028,17109886,17115028,111125943,XM_022470347.1,uncharacterized LOC111125943,5142
NC_035780.1,33212633,33216132,33212633,33216132,111125944,XM_022470221.1,uncharacterized LOC111125944,3499
NC_035782.1,52808893,52821714,52808893,52820467,111125949,XM_022470237.1,uncharacterized LOC111125949,11574
NC_035782.1,52808893,52821714,52808893,52821714,111125949,XM_022470236.1,uncharacterized LOC111125949,12821
NC_035782.1,52568063,52580860,52568270,52580860,111125950,XM_022470239.1,uncharacterized LOC111125950,12590
NC_035782.1,52568063,52580860,52568063,52580860,111125950,XM_022470238.1,uncharacterized LOC111125950,12797
NC_035782.1,52775886,52792314,52775886,52792314,111125955,XM_022470249.1,uncharacterized LOC111125955,16428
NC_035780.1,33207146,33307448,33207146,33307448,111125959,XM_022470268.1,uncharacterized LOC111125959,100302
NC_035780.1,33338568,33412379,33338568,33412379,111125964,XM_022470281.1,uncharacterized LOC111125964,73811
NC_035782.1,52673561,52678777,52673561,52678777,111125968,XM_022470285.1,uncharacterized LOC111125968,5216
NC_035782.1,52669730,52672613,52669730,52672613,111125969,XM_022470286.1,uncharacterized LOC111125969,2883
NC_035782.1,52659260,52664103,52659260,52664103,111125970,XM_022470287.1,uncharacterized LOC111125970,4843
NC_035782.1,52627115,52646551,52634179,52646551,111125971,XM_022470289.1,uncharacterized LOC111125971,12372
NC_035782.1,52627115,52646551,52627115,52646551,111125971,XM_022470288.1,uncharacterized LOC111125971,19436
NC_035782.1,52599999,52601386,52599999,52601386,111125984,XM_022470308.1,uncharacterized LOC111125984,1387
NC_035782.1,27753625,27763685,27753625,27763653,111125994,XM_022470329.1,uncharacterized LOC111125994,10028
NC_035782.1,27753625,27763685,27753625,27763683,111125994,XM_022470333.1,uncharacterized LOC111125994,10058
NC_035782.1,27753625,27763685,27753625,27763684,111125994,XM_022470334.1,uncharacterized LOC111125994,10059
NC_035782.1,27753625,27763685,27753625,27763685,111125994,XM_022470332.1,uncharacterized LOC111125994,10060
NC_035782.1,27753625,27763685,27753625,27761428,111125994,XM_022470331.1,uncharacterized LOC111125994,7803
NC_035782.1,27753625,27763685,27753625,27763613,111125994,XM_022470330.1,uncharacterized LOC111125994,9988
NC_035782.1,74390960,74409758,74390960,74409757,111125997,XM_022470339.1,uncharacterized LOC111125997,18797
NC_035782.1,74390960,74409758,74390960,74409758,111125997,XM_022470337.1,uncharacterized LOC111125997,18798
NC_035782.1,7427017,7578623,7427017,7578623,111126011,XM_022470366.1,uncharacterized LOC111126011,151606
NC_035782.1,7427017,7578623,7427017,7473452,111126011,XM_022470365.1,uncharacterized LOC111126011,46435
NC_035782.1,4127032,4130480,4127032,4130480,111126015,XM_022470370.1,uncharacterized LOC111126015,3448
NC_035782.1,4064007,4073792,4064007,4068099,111126016,XM_022470371.1,uncharacterized LOC111126016,4092
NC_035782.1,4064007,4073792,4064007,4073792,111126016,XM_022470373.1,uncharacterized LOC111126016,9785
NC_035782.1,4088182,4133133,4088182,4133133,111126017,XM_022470374.1,uncharacterized LOC111126017,44951
NC_035782.1,4088182,4133133,4088184,4092868,111126017,XM_022470375.1,uncharacterized LOC111126017,4684
NC_035782.1,4082823,4086050,4082823,4086050,111126018,XM_022470376.1,uncharacterized LOC111126018,3227
NC_035782.1,4052303,4081324,4052303,4062945,111126019,XM_022470377.1,uncharacterized LOC111126019,10642
NC_035782.1,4052303,4081324,4052303,4081129,111126019,XM_022470379.1,uncharacterized LOC111126019,28826
NC_035782.1,4052303,4081324,4052303,4081324,111126019,XM_022470378.1,uncharacterized LOC111126019,29021
NC_035782.1,4052303,4081324,4052303,4061053,111126019,XM_022470380.1,uncharacterized LOC111126019,8750
NC_035782.1,56018435,56023925,56018435,56023925,111126020,XM_022470382.1,uncharacterized LOC111126020,5490
NC_035782.1,51193277,51199306,51195250,51199306,111126032,XM_022470405.1,uncharacterized LOC111126032,4056
NC_035782.1,51193277,51199306,51193277,51199306,111126032,XM_022470404.1,uncharacterized LOC111126032,6029
NC_035782.1,15067514,15118391,15067514,15118391,111126034,XM_022470408.1,uncharacterized LOC111126034,50877
NC_035782.1,27399020,27402405,27399020,27402405,111126036,XM_022470411.1,uncharacterized LOC111126036,3385
NC_035782.1,53162375,53163770,53162375,53163770,111126037,XM_022470412.1,uncharacterized LOC111126037,1395
NC_035782.1,3875510,3883486,3875510,3883486,111126045,XM_022470430.1,uncharacterized LOC111126045,7976
NC_035782.1,18341215,18343860,18341215,18343248,111126047,XM_022470432.1,uncharacterized LOC111126047,2033
NC_035782.1,18341215,18343860,18341216,18343860,111126047,XM_022470434.1,uncharacterized LOC111126047,2644
NC_035782.1,18341215,18343860,18341215,18343860,111126047,XM_022470431.1,uncharacterized LOC111126047,2645
NC_035780.1,48113738,48118665,48113738,48118665,111126048,XM_022470473.1,uncharacterized LOC111126048,4927
NC_035782.1,60158417,60165757,60158417,60165757,111126050,XM_022470435.1,uncharacterized LOC111126050,7340
NC_035782.1,31856649,31859647,31856649,31859647,111126057,XM_022470447.1,uncharacterized LOC111126057,2998
NC_035782.1,68714829,68716671,68714829,68716671,111126061,XM_022470453.1,uncharacterized LOC111126061,1842
NC_035782.1,50600921,50615814,50600921,50615814,111126068,XM_022470460.1,uncharacterized LOC111126068,14893
NC_035782.1,76790478,77013671,76790478,77013671,111126069,XM_022470462.1,uncharacterized LOC111126069,223193
NC_035782.1,39167668,39175997,39167668,39175997,111126070,XM_022470463.1,uncharacterized LOC111126070,8329
NC_035782.1,20675879,20678421,20675879,20678421,111126071,XM_022470464.1,uncharacterized LOC111126071,2542
NC_035782.1,40636048,40641063,40636187,40641063,111126075,XM_022470469.1,uncharacterized LOC111126075,4876
NC_035782.1,40636048,40641063,40636149,40641063,111126075,XM_022470468.1,uncharacterized LOC111126075,4914
NC_035782.1,40636048,40641063,40636048,40641063,111126075,XM_022470470.1,uncharacterized LOC111126075,5015
NC_035782.1,72244132,72248243,72244132,72248243,111126085,XM_022470487.1,uncharacterized LOC111126085,4111
NC_035782.1,71981870,71986666,71981870,71986666,111126099,XM_022470501.1,uncharacterized LOC111126099,4796
NC_035782.1,60288745,60295531,60288745,60295531,111126100,XM_022470502.1,uncharacterized LOC111126100,6786
NC_035782.1,50132159,50135741,50132209,50135741,111126101,XM_022470504.1,uncharacterized LOC111126101,3532
NC_035782.1,50132159,50135741,50132173,50135741,111126101,XM_022470503.1,uncharacterized LOC111126101,3568
NC_035782.1,50132159,50135741,50132159,50135741,111126101,XM_022470505.1,uncharacterized LOC111126101,3582
NC_035782.1,56425937,56434892,56425937,56434892,111126104,XM_022470509.1,uncharacterized LOC111126104,8955
NC_035782.1,72239174,72242926,72239174,72242926,111126110,XM_022470517.1,uncharacterized LOC111126110,3752
NC_035782.1,72205997,72216921,72205997,72216510,111126111,XM_022470519.1,uncharacterized LOC111126111,10513
NC_035782.1,72205997,72216921,72205997,72216921,111126111,XM_022470518.1,uncharacterized LOC111126111,10924
NC_035782.1,61161362,61168549,61161362,61168549,111126117,XM_022470527.1,uncharacterized LOC111126117,7187
NC_035782.1,73337196,73349561,73337196,73349561,111126119,XM_022470530.1,uncharacterized LOC111126119,12365
NC_035782.1,37318284,37321406,37318284,37321406,111126120,XM_022470531.1,uncharacterized LOC111126120,3122
NC_035782.1,29652845,29655437,29652845,29655437,111126122,XM_022470532.1,uncharacterized LOC111126122,2592
NC_035782.1,9046815,9051362,9046815,9051362,111126138,XM_022470556.1,uncharacterized LOC111126138,4547
NC_035782.1,23860198,23864087,23860198,23864087,111126142,XM_022470559.1,uncharacterized LOC111126142,3889
NC_035782.1,37975973,37985055,37975973,37985055,111126143,XM_022470561.1,uncharacterized LOC111126143,9082
NC_035782.1,57815238,57819841,57815238,57819841,111126164,XM_022470604.1,uncharacterized LOC111126164,4603
NC_035780.1,42342787,42385308,42342803,42385308,111126165,XM_022470609.1,uncharacterized LOC111126165,42505
NC_035780.1,42342787,42385308,42342787,42385308,111126165,XM_022470627.1,uncharacterized LOC111126165,42521
NC_035782.1,8963033,8968460,8963033,8968460,111126167,XM_022470608.1,uncharacterized LOC111126167,5427
NC_035782.1,41744529,41757805,41744529,41757805,111126172,XM_022470621.1,uncharacterized LOC111126172,13276
NC_035782.1,41744529,41757805,41751062,41754761,111126172,XM_022470618.1,uncharacterized LOC111126172,3699
NC_035782.1,41744529,41757805,41751044,41754761,111126172,XM_022470624.1,uncharacterized LOC111126172,3717
NC_035782.1,41744529,41757805,41751023,41757805,111126172,XM_022470620.1,uncharacterized LOC111126172,6782
NC_035782.1,41744529,41757805,41751017,41757805,111126172,XM_022470623.1,uncharacterized LOC111126172,6788
NC_035782.1,41744529,41757805,41747192,41754761,111126172,XM_022470619.1,uncharacterized LOC111126172,7569
NC_035782.1,41744529,41757805,41748547,41757805,111126172,XM_022470622.1,uncharacterized LOC111126172,9258
NC_035782.1,46744529,46747402,46744657,46747402,111126174,XM_022470626.1,uncharacterized LOC111126174,2745
NC_035782.1,74194734,74196561,74194734,74196561,111126183,XM_022470635.1,uncharacterized LOC111126183,1827
NC_035782.1,51362606,51365068,51362606,51365068,111126187,XM_022470642.1,uncharacterized LOC111126187,2462
NC_035782.1,27817344,27822695,27817344,27822695,111126189,XM_022470648.1,uncharacterized LOC111126189,5351
NC_035782.1,52138397,52164538,52145452,52164538,111126204,XM_022470676.1,uncharacterized LOC111126204,19086
NC_035782.1,52138397,52164538,52138397,52164538,111126204,XM_022470674.1,uncharacterized LOC111126204,26141
NC_035782.1,52138397,52164538,52159976,52164538,111126204,XM_022470675.1,uncharacterized LOC111126204,4562
NC_035780.1,42239619,42267593,42239619,42267593,111126207,XM_022470692.1,uncharacterized LOC111126207,27974
NC_035782.1,31115178,31118700,31115178,31118700,111126212,XM_022470687.1,uncharacterized LOC111126212,3522
NC_035782.1,20405997,20433004,20405997,20431045,111126215,XM_022470691.1,uncharacterized LOC111126215,25048
NC_035782.1,20405997,20433004,20405997,20433004,111126215,XM_022470693.1,uncharacterized LOC111126215,27007
NC_035782.1,20398523,20402067,20398523,20402067,111126216,XM_022470694.1,uncharacterized LOC111126216,3544
NC_035782.1,53633387,53636578,53633387,53636578,111126217,XM_022470695.1,uncharacterized LOC111126217,3191
NC_035782.1,56200152,56205011,56200155,56204992,111126223,XM_022470704.1,uncharacterized LOC111126223,4837
NC_035782.1,56200152,56205011,56200155,56204996,111126223,XM_022470703.1,uncharacterized LOC111126223,4841
NC_035782.1,56200152,56205011,56200153,56205004,111126223,XM_022470707.1,uncharacterized LOC111126223,4851
NC_035782.1,56200152,56205011,56200152,56205011,111126223,XM_022470706.1,uncharacterized LOC111126223,4859
NC_035782.1,56207231,56211225,56207231,56211225,111126224,XM_022470708.1,uncharacterized LOC111126224,3994
NC_035782.1,12529085,12533108,12529085,12533108,111126229,XM_022470715.1,uncharacterized LOC111126229,4023
NC_035782.1,73627684,73636836,73627684,73635596,111126230,XM_022470718.1,uncharacterized LOC111126230,7912
NC_035782.1,73627684,73636836,73627684,73636655,111126230,XM_022470717.1,uncharacterized LOC111126230,8971
NC_035782.1,73627684,73636836,73627684,73636836,111126230,XM_022470716.1,uncharacterized LOC111126230,9152
NC_035782.1,9858863,9861605,9858863,9861600,111126232,XM_022470721.1,uncharacterized LOC111126232,2737
NC_035782.1,9858863,9861605,9858863,9861605,111126232,XM_022470720.1,uncharacterized LOC111126232,2742
NC_035782.1,49441511,49450405,49441511,49450405,111126235,XM_022470723.1,uncharacterized LOC111126235,8894
NC_035782.1,49445824,49450405,49445824,49450405,111126236,XM_022470724.1,uncharacterized LOC111126236,4581
NC_035780.1,42155469,42158348,42155469,42158348,111126254,XM_022470765.1,uncharacterized LOC111126254,2879
NC_035782.1,22233010,22243252,22233010,22243252,111126265,XM_022470775.1,uncharacterized LOC111126265,10242
NC_035782.1,22233010,22243252,22233010,22236693,111126265,XM_022470778.1,uncharacterized LOC111126265,3683
NC_035782.1,22233010,22243252,22233010,22239342,111126265,XM_022470776.1,uncharacterized LOC111126265,6332
NC_035782.1,21943749,21953180,21943749,21947439,111126266,XM_022470781.1,uncharacterized LOC111126266,3690
NC_035782.1,21943749,21953180,21943749,21950067,111126266,XM_022470780.1,uncharacterized LOC111126266,6318
NC_035782.1,21943749,21953180,21943749,21953180,111126266,XM_022470779.1,uncharacterized LOC111126266,9431
NC_035782.1,22182978,22186160,22182978,22186160,111126269,XM_022470784.1,uncharacterized LOC111126269,3182
NC_035782.1,21894631,21898035,21894631,21898035,111126270,XM_022470785.1,uncharacterized LOC111126270,3404
NC_035780.1,42322067,42325289,42322067,42325289,111126271,XM_022470789.1,uncharacterized LOC111126271,3222
NC_035782.1,68790650,68793475,68790650,68793475,111126273,XM_022470790.1,uncharacterized LOC111126273,2825
NC_035782.1,52945805,52953674,52945805,52953674,111126276,XM_022470794.1,uncharacterized LOC111126276,7869
NC_035782.1,18454838,18457213,18454838,18457213,111126285,XM_022470803.1,uncharacterized LOC111126285,2375
NC_035782.1,7987988,7991805,7987988,7991805,111126286,XM_022470804.1,uncharacterized LOC111126286,3817
NC_035782.1,73721549,73730790,73721549,73730790,111126290,XM_022470808.1,uncharacterized LOC111126290,9241
NC_035782.1,45962442,45969571,45962442,45969571,111126294,XM_022470815.1,uncharacterized LOC111126294,7129
NC_035782.1,51104239,51108008,51104239,51108008,111126298,XM_022470820.1,uncharacterized LOC111126298,3769
NC_035782.1,28239866,28244615,28241944,28244615,111126299,XM_022470823.1,uncharacterized LOC111126299,2671
NC_035782.1,28239866,28244615,28239866,28244615,111126299,XM_022470821.1,uncharacterized LOC111126299,4749
NC_035782.1,68033611,68039432,68036972,68039432,111126302,XM_022470833.1,uncharacterized LOC111126302,2460
NC_035782.1,68033611,68039432,68034798,68039432,111126302,XM_022470834.1,uncharacterized LOC111126302,4634
NC_035782.1,68033611,68039432,68033611,68039432,111126302,XM_022470835.1,uncharacterized LOC111126302,5821
NC_035782.1,74362997,74383414,74362998,74383414,111126303,XM_022470837.1,uncharacterized LOC111126303,20416
NC_035782.1,74362997,74383414,74362997,74383414,111126303,XM_022470838.1,uncharacterized LOC111126303,20417
NC_035782.1,25951462,25956203,25953539,25956203,111126304,XM_022470840.1,uncharacterized LOC111126304,2664
NC_035782.1,25951462,25956203,25951462,25956203,111126304,XM_022470839.1,uncharacterized LOC111126304,4741
NC_035782.1,71925975,71935122,71925975,71935122,111126309,XM_022470846.1,uncharacterized LOC111126309,9147
NC_035782.1,36674207,36677056,36674207,36677056,111126310,XM_022470848.1,uncharacterized LOC111126310,2849
NC_035780.1,19106779,19113833,19106779,19113833,111126311,XM_022470850.1,uncharacterized LOC111126311,7054
NC_035782.1,65858484,65860726,65858484,65860726,111126315,XM_022470852.1,uncharacterized LOC111126315,2242
NC_035782.1,6396713,6401844,6396713,6401844,111126319,XM_022470856.1,uncharacterized LOC111126319,5131
NC_035782.1,37919731,37921695,37920055,37921695,111126323,XM_022470863.1,uncharacterized LOC111126323,1640
NC_035782.1,37919731,37921695,37919942,37921695,111126323,XM_022470861.1,uncharacterized LOC111126323,1753
NC_035782.1,37919731,37921695,37919731,37921695,111126323,XM_022470860.1,uncharacterized LOC111126323,1964
NC_035782.1,26535032,26541240,26535032,26541240,111126326,XM_022470866.1,uncharacterized LOC111126326,6208
NC_035780.1,14438094,14439817,14438094,14439817,111126328,XM_022470874.1,uncharacterized LOC111126328,1723
NC_035782.1,51203138,51205605,51203138,51205605,111126329,XM_022470870.1,uncharacterized LOC111126329,2467
NC_035782.1,61703021,61710578,61703021,61710537,111126330,XM_022470872.1,uncharacterized LOC111126330,7516
NC_035782.1,61703021,61710578,61703021,61710578,111126330,XM_022470871.1,uncharacterized LOC111126330,7557
NC_035782.1,50262661,50275592,50262663,50275592,111126331,XM_022470875.1,uncharacterized LOC111126331,12929
NC_035782.1,50262661,50275592,50262661,50275592,111126331,XM_022470873.1,uncharacterized LOC111126331,12931
NC_035782.1,57003630,57007740,57003630,57007740,111126332,XM_022470876.1,uncharacterized LOC111126332,4110
NC_035782.1,15516635,15532638,15517532,15532638,111126334,XM_022470879.1,uncharacterized LOC111126334,15106
NC_035782.1,15516635,15532638,15516635,15532374,111126334,XM_022470878.1,uncharacterized LOC111126334,15739
NC_035780.1,22652117,22654401,22652117,22654401,111126337,XM_022470924.1,uncharacterized LOC111126337,2284
NC_035782.1,8547465,8551730,8547465,8551730,111126340,XM_022470882.1,uncharacterized LOC111126340,4265
NC_035782.1,22920117,22924776,22921655,22924776,111126346,XM_022470892.1,uncharacterized LOC111126346,3121
NC_035782.1,22920117,22924776,22920117,22924776,111126346,XM_022470891.1,uncharacterized LOC111126346,4659
NC_035782.1,11882091,11887535,11882091,11887043,111126350,XM_022470897.1,uncharacterized LOC111126350,4952
NC_035782.1,11882091,11887535,11882091,11887535,111126350,XM_022470896.1,uncharacterized LOC111126350,5444
NC_035780.1,11982602,12007742,11982602,12007742,111126353,XM_022470916.1,uncharacterized LOC111126353,25140
NC_035782.1,56639877,56652237,56639878,56652237,111126363,XM_022470927.1,uncharacterized LOC111126363,12359
NC_035782.1,56639877,56652237,56639877,56652237,111126363,XM_022470928.1,uncharacterized LOC111126363,12360
NC_035782.1,72639406,72648630,72639406,72648630,111126365,XM_022470931.1,uncharacterized LOC111126365,9224
NC_035782.1,57956769,57959101,57956769,57959101,111126372,XM_022470942.1,uncharacterized LOC111126372,2332
NC_035782.1,57944182,57947432,57944182,57947432,111126373,XM_022470943.1,uncharacterized LOC111126373,3250
NC_035782.1,67461310,67475058,67461310,67475058,111126378,XM_022470967.1,uncharacterized LOC111126378,13748
NC_035782.1,67461310,67475058,67461310,67464882,111126378,XM_022470968.1,uncharacterized LOC111126378,3572
NC_035782.1,67461310,67475058,67461310,67470280,111126378,XM_022470966.1,uncharacterized LOC111126378,8970
NC_035782.1,25538337,25544121,25538337,25544121,111126380,XM_022470971.1,uncharacterized LOC111126380,5784
NC_035782.1,20492136,20504798,20492136,20504798,111126387,XM_022470983.1,uncharacterized LOC111126387,12662
NC_035782.1,423655,427790,423655,427790,111126394,XM_022470992.1,uncharacterized LOC111126394,4135
NC_035782.1,488361,494382,488361,494382,111126396,XM_022470993.1,uncharacterized LOC111126396,6021
NC_035782.1,61906678,61909924,61906678,61909924,111126398,XM_022470994.1,uncharacterized LOC111126398,3246
NC_035782.1,75838828,75900080,75888294,75900080,111126399,XM_022470999.1,uncharacterized LOC111126399,11786
NC_035782.1,75838828,75900080,75887610,75900080,111126399,XM_022470995.1,uncharacterized LOC111126399,12470
NC_035782.1,75838828,75900080,75885273,75900080,111126399,XM_022470998.1,uncharacterized LOC111126399,14807
NC_035782.1,75838828,75900080,75838828,75900080,111126399,XM_022470997.1,uncharacterized LOC111126399,61252
NC_035782.1,75857706,75881383,75857706,75881383,111126400,XM_022471000.1,uncharacterized LOC111126400,23677
NC_035782.1,57717898,57719850,57717898,57719850,111126403,XM_022471010.1,uncharacterized LOC111126403,1952
NC_035782.1,74614272,74622166,74617199,74622166,111126410,XM_022471036.1,uncharacterized LOC111126410,4967
NC_035782.1,74614272,74622166,74614453,74622166,111126410,XM_022471034.1,uncharacterized LOC111126410,7713
NC_035782.1,74614272,74622166,74614272,74622166,111126410,XM_022471033.1,uncharacterized LOC111126410,7894
NC_035782.1,61797983,61801996,61797983,61801996,111126422,XM_022471064.1,uncharacterized LOC111126422,4013
NC_035782.1,36341262,36346218,36341286,36346218,111126425,XM_022471069.1,uncharacterized LOC111126425,4932
NC_035782.1,36341262,36346218,36341262,36346218,111126425,XM_022471068.1,uncharacterized LOC111126425,4956
NC_035782.1,25248146,25252212,25248146,25252212,111126427,XM_022471072.1,uncharacterized LOC111126427,4066
NC_035782.1,75420084,75423671,75420084,75423671,111126430,XM_022471077.1,uncharacterized LOC111126430,3587
NC_035782.1,53887907,53909733,53887907,53909733,111126432,XM_022471080.1,uncharacterized LOC111126432,21826
NC_035782.1,19020217,19028884,19020217,19028870,111126434,XM_022471084.1,uncharacterized LOC111126434,8653
NC_035782.1,19020217,19028884,19020217,19028884,111126434,XM_022471085.1,uncharacterized LOC111126434,8667
NC_035782.1,30881928,30908266,30895782,30908266,111126438,XM_022471094.1,uncharacterized LOC111126438,12484
NC_035782.1,30881928,30908266,30889515,30908266,111126438,XM_022471093.1,uncharacterized LOC111126438,18751
NC_035782.1,30881928,30908266,30881930,30908264,111126438,XM_022471092.1,uncharacterized LOC111126438,26334
NC_035782.1,30881928,30908266,30881928,30908264,111126438,XM_022471091.1,uncharacterized LOC111126438,26336
NC_035782.1,41432289,41437592,41432289,41437592,111126444,XM_022471103.1,uncharacterized LOC111126444,5303
NC_035782.1,41437560,41440973,41437608,41440973,111126445,XM_022471105.1,uncharacterized LOC111126445,3365
NC_035782.1,41437560,41440973,41437560,41440973,111126445,XM_022471104.1,uncharacterized LOC111126445,3413
NC_035782.1,68800940,68804373,68800940,68804373,111126446,XM_022471106.1,uncharacterized LOC111126446,3433
NC_035782.1,51332102,51339138,51332102,51339138,111126447,XM_022471107.1,uncharacterized LOC111126447,7036
NC_035782.1,2305119,2308855,2305119,2308855,111126449,XM_022471109.1,uncharacterized LOC111126449,3736
NC_035782.1,8942725,8946036,8942725,8946036,111126453,XM_022471113.1,uncharacterized LOC111126453,3311
NC_035782.1,67907045,67914796,67907045,67911694,111126454,XM_022471115.1,uncharacterized LOC111126454,4649
NC_035782.1,67907045,67914796,67907045,67914796,111126454,XM_022471114.1,uncharacterized LOC111126454,7751
NC_035782.1,51518133,51520437,51518133,51520026,111126459,XM_022471140.1,uncharacterized LOC111126459,1893
NC_035780.1,56948443,56958290,56948443,56958290,111126463,XM_022471180.1,uncharacterized LOC111126463,9847
NC_035782.1,20109852,20114036,20109852,20114036,111126464,XM_022471144.1,uncharacterized LOC111126464,4184
NC_035782.1,68527438,68529228,68527438,68529228,111126470,XM_022471151.1,uncharacterized LOC111126470,1790
NC_035782.1,39085421,39089256,39085421,39089256,111126475,XM_022471157.1,uncharacterized LOC111126475,3835
NC_035782.1,25504417,25506779,25504417,25506779,111126480,XM_022471166.1,uncharacterized LOC111126480,2362
NC_035782.1,31109127,31113407,31109127,31113407,111126483,XM_022471168.1,uncharacterized LOC111126483,4280
NC_035782.1,38561488,38569942,38561488,38569942,111126484,XM_022471169.1,uncharacterized LOC111126484,8454
NC_035782.1,56940002,56946358,56940002,56946358,111126491,XM_022471176.1,uncharacterized LOC111126491,6356
NC_035782.1,56706490,56718595,56706490,56718595,111126494,XM_022471181.1,uncharacterized LOC111126494,12105
NC_035782.1,29207715,29211370,29207715,29211370,111126497,XM_022471184.1,uncharacterized LOC111126497,3655
NC_035782.1,11354393,11356391,11354393,11356391,111126500,XM_022471187.1,uncharacterized LOC111126500,1998
NC_035782.1,36389276,36392381,36389276,36392381,111126503,XM_022471192.1,uncharacterized LOC111126503,3105
NC_035782.1,40676077,40678859,40676077,40678859,111126504,XM_022471193.1,uncharacterized LOC111126504,2782
NC_035782.1,57307724,57316869,57307724,57316857,111126506,XM_022471195.1,uncharacterized LOC111126506,9133
NC_035782.1,57307724,57316869,57307724,57316869,111126506,XM_022471196.1,uncharacterized LOC111126506,9145
NC_035782.1,54350372,54353110,54350372,54353110,111126513,XM_022471205.1,uncharacterized LOC111126513,2738
NC_035782.1,73864962,73881439,73865079,73881439,111126514,XM_022471207.1,uncharacterized LOC111126514,16360
NC_035782.1,73864962,73881439,73864962,73881430,111126514,XM_022471206.1,uncharacterized LOC111126514,16468
NC_035782.1,73864962,73881439,73864962,73881431,111126514,XM_022471208.1,uncharacterized LOC111126514,16469
NC_035782.1,31102254,31104476,31102254,31104476,111126521,XM_022471223.1,uncharacterized LOC111126521,2222
NC_035782.1,40666166,40668435,40666166,40668435,111126523,XM_022471224.1,uncharacterized LOC111126523,2269
NC_035782.1,30248629,30251762,30248629,30251762,111126524,XM_022471225.1,uncharacterized LOC111126524,3133
NC_035782.1,32848123,32849816,32848123,32849816,111126528,XM_022471235.1,uncharacterized LOC111126528,1693
NC_035782.1,57340953,57350244,57340953,57350198,111126531,XM_022471239.1,uncharacterized LOC111126531,9245
NC_035782.1,57340953,57350244,57340953,57350244,111126531,XM_022471238.1,uncharacterized LOC111126531,9291
NC_035782.1,55059837,55066522,55059837,55066522,111126534,XM_022471242.1,uncharacterized LOC111126534,6685
NC_035782.1,8540990,8545951,8540990,8545936,111126535,XM_022471243.1,uncharacterized LOC111126535,4946
NC_035782.1,8540990,8545951,8540990,8545951,111126535,XM_022471244.1,uncharacterized LOC111126535,4961
NC_035782.1,50791900,50801618,50791900,50801618,111126537,XM_022471245.1,uncharacterized LOC111126537,9718
NC_035782.1,51791422,51793427,51791422,51793427,111126538,XM_022471247.1,uncharacterized LOC111126538,2005
NC_035782.1,26061952,26064508,26061952,26064508,111126539,XM_022471248.1,uncharacterized LOC111126539,2556
NC_035782.1,8425779,8430851,8425780,8430851,111126541,XM_022471250.1,uncharacterized LOC111126541,5071
NC_035782.1,8425779,8430851,8425779,8430851,111126541,XM_022471249.1,uncharacterized LOC111126541,5072
NC_035782.1,9422040,9445733,9422040,9445299,111126542,XM_022471252.1,uncharacterized LOC111126542,23259
NC_035782.1,9422040,9445733,9422040,9445733,111126542,XM_022471251.1,uncharacterized LOC111126542,23693
NC_035782.1,37864730,37876855,37864730,37874948,111126544,XM_022471257.1,uncharacterized LOC111126544,10218
NC_035782.1,37864730,37876855,37872248,37876855,111126544,XM_022471259.1,uncharacterized LOC111126544,4607
NC_035782.1,37864730,37876855,37868342,37874948,111126544,XM_022471258.1,uncharacterized LOC111126544,6606
NC_035780.1,56934090,56942373,56934090,56942373,111126545,XM_022471303.1,uncharacterized LOC111126545,8283
NC_035782.1,69000553,69008612,69000553,69008612,111126551,XM_022471271.1,uncharacterized LOC111126551,8059
NC_035782.1,68288477,68294753,68288477,68294753,111126552,XM_022471272.1,uncharacterized LOC111126552,6276
NC_035782.1,49494054,49496569,49494054,49496569,111126554,XM_022471277.1,uncharacterized LOC111126554,2515
NC_035782.1,51130585,51132155,51130585,51132155,111126557,XM_022471281.1,uncharacterized LOC111126557,1570
NC_035780.1,22044153,22051217,22044153,22051217,111126561,XM_022471295.1,uncharacterized LOC111126561,7064
NC_035782.1,15490629,15494462,15490629,15494462,111126565,XM_022471298.1,uncharacterized LOC111126565,3833
NC_035782.1,40670580,40673152,40670580,40673152,111126567,XM_022471301.1,uncharacterized LOC111126567,2572
NC_035780.1,22244113,22246342,22244113,22246342,111126569,XM_022471308.1,uncharacterized LOC111126569,2229
NC_035782.1,28747675,28749654,28747675,28749654,111126570,XM_022471306.1,uncharacterized LOC111126570,1979
NC_035782.1,44921875,44929281,44921875,44923334,111126571,XM_022471310.1,uncharacterized LOC111126571,1459
NC_035782.1,44921875,44929281,44927375,44929281,111126571,XM_022471309.1,uncharacterized LOC111126571,1906
NC_035782.1,44921875,44929281,44921900,44929281,111126571,XM_022471307.1,uncharacterized LOC111126571,7381
NC_035782.1,7617191,7619812,7617191,7619812,111126573,XM_022471312.1,uncharacterized LOC111126573,2621
NC_035782.1,46766920,46818900,46766920,46788486,111126576,XM_022471318.1,uncharacterized LOC111126576,21566
NC_035782.1,46766920,46818900,46766920,46796503,111126576,XM_022471317.1,uncharacterized LOC111126576,29583
NC_035782.1,46766920,46818900,46766920,46818900,111126576,XM_022471316.1,uncharacterized LOC111126576,51980
NC_035780.1,22105814,22119412,22105814,22119412,111126577,XM_022471320.1,uncharacterized LOC111126577,13598
NC_035780.1,22206655,22208880,22206655,22208880,111126584,XM_022471331.1,uncharacterized LOC111126584,2225
NC_035780.1,22179030,22181396,22179030,22181396,111126590,XM_022471337.1,uncharacterized LOC111126590,2366
NC_035782.1,18526225,18529307,18526225,18529307,111126595,XM_022471341.1,uncharacterized LOC111126595,3082
NC_035782.1,70797277,70802543,70797277,70802543,111126600,XM_022471353.1,uncharacterized LOC111126600,5266
NC_035782.1,37678582,37686978,37678582,37686978,111126603,XM_022471356.1,uncharacterized LOC111126603,8396
NC_035782.1,37274981,37279906,37274981,37279906,111126604,XM_022471357.1,uncharacterized LOC111126604,4925
NC_035780.1,22144200,22228175,22183787,22195974,111126605,XM_022471379.1,uncharacterized LOC111126605,12187
NC_035780.1,22144200,22228175,22210805,22228175,111126605,XM_022471388.1,uncharacterized LOC111126605,17370
NC_035780.1,22144200,22228175,22207238,22228175,111126605,XM_022471397.1,uncharacterized LOC111126605,20937
NC_035780.1,22144200,22228175,22144258,22195974,111126605,XM_022471362.1,uncharacterized LOC111126605,51716
NC_035780.1,22144200,22228175,22144200,22151499,111126605,XM_022471406.1,uncharacterized LOC111126605,7299
NC_035780.1,22144200,22228175,22144228,22218222,111126605,XM_022471370.1,uncharacterized LOC111126605,73994
NC_035782.1,71300189,71306336,71300189,71301573,111126606,XM_022471360.1,uncharacterized LOC111126606,1384
NC_035782.1,71300189,71306336,71300189,71302517,111126606,XM_022471358.1,uncharacterized LOC111126606,2328
NC_035782.1,71300189,71306336,71300189,71302914,111126606,XM_022471359.1,uncharacterized LOC111126606,2725
NC_035782.1,71300189,71306336,71300189,71306336,111126606,XM_022471361.1,uncharacterized LOC111126606,6147
NC_035782.1,41420416,41423075,41420416,41423075,111126607,XM_022471363.1,uncharacterized LOC111126607,2659
NC_035782.1,71325791,71327838,71325791,71327838,111126611,XM_022471368.1,uncharacterized LOC111126611,2047
NC_035782.1,61646404,61649551,61646404,61649551,111126612,XM_022471369.1,uncharacterized LOC111126612,3147
NC_035782.1,68796484,68798097,68796484,68798097,111126615,XM_022471373.1,uncharacterized LOC111126615,1613
NC_035782.1,32083958,32093012,32083958,32093012,111126617,XM_022471380.1,uncharacterized LOC111126617,9054
NC_035780.1,14342212,14352814,14342212,14352814,111126618,XM_022471421.1,uncharacterized LOC111126618,10602
NC_035782.1,62542417,62546100,62542417,62546099,111126625,XM_022471396.1,uncharacterized LOC111126625,3682
NC_035782.1,62542417,62546100,62542417,62546100,111126625,XM_022471395.1,uncharacterized LOC111126625,3683
NC_035782.1,32736018,32739102,32736018,32739100,111126627,XM_022471401.1,uncharacterized LOC111126627,3082
NC_035782.1,32736018,32739102,32736018,32739102,111126627,XM_022471400.1,uncharacterized LOC111126627,3084
NC_035782.1,44821172,44824643,44821172,44824643,111126628,XM_022471402.1,uncharacterized LOC111126628,3471
NC_035782.1,37985261,37991586,37985267,37991586,111126633,XM_022471409.1,uncharacterized LOC111126633,6319
NC_035782.1,37985261,37991586,37985261,37991586,111126633,XM_022471408.1,uncharacterized LOC111126633,6325
NC_035782.1,15902034,15908985,15902034,15908985,111126634,XM_022471410.1,uncharacterized LOC111126634,6951
NC_035782.1,64027945,64030160,64027945,64029349,111126635,XM_022471412.1,uncharacterized LOC111126635,1404
NC_035782.1,64027945,64030160,64027945,64030160,111126635,XM_022471411.1,uncharacterized LOC111126635,2215
NC_035782.1,44222658,44229165,44226531,44229165,111126637,XM_022471414.1,uncharacterized LOC111126637,2634
NC_035782.1,44222658,44229165,44222658,44229165,111126637,XM_022471413.1,uncharacterized LOC111126637,6507
NC_035782.1,44218216,44236922,44218216,44236922,111126638,XM_022471415.1,uncharacterized LOC111126638,18706
NC_035782.1,62451945,62453540,62451945,62453540,111126642,XM_022471420.1,uncharacterized LOC111126642,1595
NC_035782.1,62448130,62449537,62448130,62449537,111126643,XM_022471422.1,uncharacterized LOC111126643,1407
NC_035782.1,9156071,9175377,9156071,9175375,111126645,XM_022471428.1,uncharacterized LOC111126645,19304
NC_035782.1,9156071,9175377,9156071,9175377,111126645,XM_022471426.1,uncharacterized LOC111126645,19306
NC_035782.1,42675022,42677512,42675473,42677512,111126649,XM_022471435.1,uncharacterized LOC111126649,2039
NC_035782.1,42675022,42677512,42675022,42677512,111126649,XM_022471434.1,uncharacterized LOC111126649,2490
NC_035782.1,47797010,47805798,47797010,47800590,111126654,XM_022471438.1,uncharacterized LOC111126654,3580
NC_035782.1,47797010,47805798,47797017,47805798,111126654,XM_022471439.1,uncharacterized LOC111126654,8781
NC_035782.1,47811366,47813245,47811366,47813245,111126655,XM_022471441.1,uncharacterized LOC111126655,1879
NC_035782.1,7061079,7062973,7061079,7062973,111126657,XM_022471443.1,uncharacterized LOC111126657,1894
NC_035782.1,30144590,30169806,30144590,30169582,111126659,XM_022471446.1,uncharacterized LOC111126659,24992
NC_035782.1,30144590,30169806,30144590,30169806,111126659,XM_022471447.1,uncharacterized LOC111126659,25216
NC_035780.1,22071505,22257650,22071505,22257650,111126660,XM_022471452.1,uncharacterized LOC111126660,186145
NC_035780.1,22071505,22257650,22248003,22257647,111126660,XM_022471459.1,uncharacterized LOC111126660,9644
NC_035782.1,11344943,11346021,11344943,11346021,111126664,XM_022471453.1,uncharacterized LOC111126664,1078
NC_035782.1,20315001,20322550,20315001,20322550,111126665,XM_022471454.1,uncharacterized LOC111126665,7549
NC_035782.1,50802811,50820217,50802811,50820203,111126669,XM_022471460.1,uncharacterized LOC111126669,17392
NC_035782.1,50802811,50820217,50802811,50820217,111126669,XM_022471457.1,uncharacterized LOC111126669,17406
NC_035782.1,4426958,4440382,4426958,4440382,111126672,XM_022471466.1,uncharacterized LOC111126672,13424
NC_035782.1,51282584,51288115,51282584,51288115,111126677,XM_022471482.1,uncharacterized LOC111126677,5531
NC_035780.1,22114113,22117459,22114113,22117459,111126678,XM_022471487.1,uncharacterized LOC111126678,3346
NC_035782.1,72906156,72911395,72909888,72911395,111126680,XM_022471485.1,uncharacterized LOC111126680,1507
NC_035782.1,72906156,72911395,72908932,72911395,111126680,XM_022471484.1,uncharacterized LOC111126680,2463
NC_035782.1,72906156,72911395,72908558,72911395,111126680,XM_022471488.1,uncharacterized LOC111126680,2837
NC_035782.1,72906156,72911395,72906156,72911395,111126680,XM_022471486.1,uncharacterized LOC111126680,5239
NC_035782.1,32460521,32477032,32460521,32472288,111126682,XM_022471490.1,uncharacterized LOC111126682,11767
NC_035782.1,32460521,32477032,32460521,32473092,111126682,XM_022471491.1,uncharacterized LOC111126682,12571
NC_035782.1,32460521,32477032,32460521,32473373,111126682,XM_022471492.1,uncharacterized LOC111126682,12852
NC_035782.1,32460521,32477032,32460521,32477032,111126682,XM_022471493.1,uncharacterized LOC111126682,16511
NC_035782.1,27801197,27816019,27802001,27816019,111126686,XM_022471498.1,uncharacterized LOC111126686,14018
NC_035782.1,27801197,27816019,27801198,27816012,111126686,XM_022471497.1,uncharacterized LOC111126686,14814
NC_035782.1,27801197,27816019,27801197,27816015,111126686,XM_022471496.1,uncharacterized LOC111126686,14818
NC_035782.1,9663889,9669247,9663890,9667460,111126690,XM_022471504.1,uncharacterized LOC111126690,3570
NC_035782.1,9663889,9669247,9663889,9667460,111126690,XM_022471506.1,uncharacterized LOC111126690,3571
NC_035782.1,9663889,9669247,9663891,9669247,111126690,XM_022471505.1,uncharacterized LOC111126690,5356
NC_035782.1,42779336,42798375,42784227,42798375,111126693,XM_022471511.1,uncharacterized LOC111126693,14148
NC_035782.1,42779336,42798375,42784226,42798375,111126693,XM_022471508.1,uncharacterized LOC111126693,14149
NC_035782.1,42779336,42798375,42779336,42798375,111126693,XM_022471514.1,uncharacterized LOC111126693,19039
NC_035780.1,22110289,22113711,22110289,22113085,111126694,XM_022471513.1,uncharacterized LOC111126694,2796
NC_035780.1,22110289,22113711,22110289,22113707,111126694,XM_022471529.1,uncharacterized LOC111126694,3418
NC_035780.1,22110289,22113711,22110289,22113711,111126694,XM_022471521.1,uncharacterized LOC111126694,3422
NC_035782.1,40763944,40767802,40763944,40767802,111126702,XM_022471525.1,uncharacterized LOC111126702,3858
NC_035782.1,30254259,30256780,30254259,30256780,111126704,XM_022471527.1,uncharacterized LOC111126704,2521
NC_035782.1,39656286,39661888,39656286,39661888,111126707,XM_022471530.1,uncharacterized LOC111126707,5602
NC_035780.1,22140445,22141561,22140445,22141561,111126712,XM_022471542.1,uncharacterized LOC111126712,1116
NC_035782.1,72272753,72290185,72274021,72290185,111126714,XM_022471543.1,uncharacterized LOC111126714,16164
NC_035782.1,72272753,72290185,72274020,72290185,111126714,XM_022471545.1,uncharacterized LOC111126714,16165
NC_035782.1,72272753,72290185,72272753,72290185,111126714,XM_022471544.1,uncharacterized LOC111126714,17432
NC_035782.1,64036245,64038047,64036245,64037449,111126715,XM_022471550.1,uncharacterized LOC111126715,1204
NC_035782.1,64036245,64038047,64036245,64037904,111126715,XM_022471548.1,uncharacterized LOC111126715,1659
NC_035782.1,64036245,64038047,64036245,64038031,111126715,XM_022471546.1,uncharacterized LOC111126715,1786
NC_035782.1,64036245,64038047,64036245,64038047,111126715,XM_022471549.1,uncharacterized LOC111126715,1802
NC_035782.1,1863264,1866450,1863264,1866450,111126716,XM_022471551.1,uncharacterized LOC111126716,3186
NC_035780.1,22076859,22078477,22076859,22078477,111126717,XM_022471555.1,uncharacterized LOC111126717,1618
NC_035782.1,73115956,73132543,73115956,73131631,111126719,XM_022471553.1,uncharacterized LOC111126719,15675
NC_035782.1,73115956,73132543,73115956,73132543,111126719,XM_022471552.1,uncharacterized LOC111126719,16587
NC_035782.1,11237975,11241128,11237975,11241128,111126720,XM_022471554.1,uncharacterized LOC111126720,3153
NC_035782.1,58849620,58870015,58849620,58860225,111126721,XM_022471558.1,uncharacterized LOC111126721,10605
NC_035782.1,58849620,58870015,58849620,58865346,111126721,XM_022471557.1,uncharacterized LOC111126721,15726
NC_035782.1,58849620,58870015,58849627,58870015,111126721,XM_022471556.1,uncharacterized LOC111126721,20388
NC_035782.1,42610311,42613337,42610311,42613337,111126723,XM_022471560.1,uncharacterized LOC111126723,3026
NC_035782.1,21307722,21314665,21307722,21314665,111126730,XM_022471564.1,uncharacterized LOC111126730,6943
NC_035782.1,50850368,50857196,50850368,50855521,111126737,XM_022471573.1,uncharacterized LOC111126737,5153
NC_035782.1,62557693,62563448,62557693,62563448,111126741,XM_022471577.1,uncharacterized LOC111126741,5755
NC_035782.1,48701784,48709130,48701784,48709130,111126754,XM_022471593.1,uncharacterized LOC111126754,7346
NC_035782.1,24451134,24453240,24451134,24453240,111126758,XM_022471597.1,uncharacterized LOC111126758,2106
NC_035780.1,40149244,40263919,40149244,40262969,111126761,XM_022471616.1,uncharacterized LOC111126761,113725
NC_035780.1,40149244,40263919,40149244,40263919,111126761,XM_022471625.1,uncharacterized LOC111126761,114675
NC_035780.1,40149244,40263919,40149244,40205276,111126761,XM_022471641.1,uncharacterized LOC111126761,56032
NC_035780.1,40149244,40263919,40149244,40205285,111126761,XM_022471649.1,uncharacterized LOC111126761,56041
NC_035782.1,31366496,31370518,31366496,31370518,111126762,XM_022471612.1,uncharacterized LOC111126762,4022
NC_035782.1,16193590,16196744,16193590,16196744,111126763,XM_022471613.1,uncharacterized LOC111126763,3154
NC_035782.1,14833028,14834745,14833028,14834745,111126764,XM_022471614.1,uncharacterized LOC111126764,1717
NC_035782.1,27698339,27705445,27698374,27705445,111126766,XM_022471618.1,uncharacterized LOC111126766,7071
NC_035782.1,27698339,27705445,27698339,27705445,111126766,XM_022471617.1,uncharacterized LOC111126766,7106
NC_035782.1,74422414,74423227,74422414,74423227,111126769,XM_022471621.1,uncharacterized LOC111126769,813
NC_035782.1,15458289,15459901,15458289,15459901,111126770,XM_022471622.1,uncharacterized LOC111126770,1612
NC_035782.1,77049880,77061117,77049880,77060733,111126773,XM_022471630.1,uncharacterized LOC111126773,10853
NC_035782.1,40659026,40663156,40659026,40663156,111126777,XM_022471635.1,uncharacterized LOC111126777,4130
NC_035782.1,9894830,9898169,9894830,9898169,111126779,XM_022471637.1,uncharacterized LOC111126779,3339
NC_035782.1,42618752,42621207,42618752,42621207,111126781,XM_022471640.1,uncharacterized LOC111126781,2455
NC_035782.1,21283061,21297862,21283061,21297862,111126786,XM_022471646.1,uncharacterized LOC111126786,14801
NC_035782.1,38412519,38415174,38412519,38415174,111126787,XM_022471647.1,uncharacterized LOC111126787,2655
NC_035782.1,48655388,48690131,48665980,48690122,111126788,XM_022471652.1,uncharacterized LOC111126788,24142
NC_035782.1,48655388,48690131,48661269,48690122,111126788,XM_022471651.1,uncharacterized LOC111126788,28853
NC_035782.1,48655388,48690131,48655388,48690130,111126788,XM_022471650.1,uncharacterized LOC111126788,34742
NC_035782.1,48655388,48690131,48655388,48690131,111126788,XM_022471648.1,uncharacterized LOC111126788,34743
NC_035782.1,31122985,31124855,31122985,31124855,111126796,XM_022471667.1,uncharacterized LOC111126796,1870
NC_035780.1,40300406,40313604,40300406,40310403,111126806,XM_022471699.1,uncharacterized LOC111126806,9997
NC_035782.1,28997569,28998991,28997569,28998991,111126807,XM_022471698.1,uncharacterized LOC111126807,1422
NC_035780.1,40222255,40225742,40222255,40225742,111126812,XM_022471718.1,uncharacterized LOC111126812,3487
NC_035782.1,20437340,20441568,20437340,20441568,111126814,XM_022471720.1,uncharacterized LOC111126814,4228
NC_035782.1,19410817,19414976,19410817,19414976,111126817,XM_022471722.1,uncharacterized LOC111126817,4159
NC_035782.1,1147126,1157055,1147126,1157055,111126823,XM_022471729.1,uncharacterized LOC111126823,9929
NC_035782.1,29648641,29651587,29648641,29651587,111126831,XM_022471733.1,uncharacterized LOC111126831,2946
NC_035782.1,45109634,45113798,45109634,45113798,111126834,XM_022471735.1,uncharacterized LOC111126834,4164
NC_035782.1,37521133,37533269,37521133,37533269,111126838,XM_022471739.1,uncharacterized LOC111126838,12136
NC_035782.1,40690130,40699241,40690130,40699241,111126841,XM_022471742.1,uncharacterized LOC111126841,9111
NC_035782.1,32746550,32753749,32750590,32753374,111126842,XM_022471743.1,uncharacterized LOC111126842,2784
NC_035782.1,32746550,32753749,32750590,32753749,111126842,XM_022471744.1,uncharacterized LOC111126842,3159
NC_035782.1,32746550,32753749,32746550,32753394,111126842,XM_022471745.1,uncharacterized LOC111126842,6844
NC_035782.1,57586223,57588613,57586223,57588613,111126846,XM_022471749.1,uncharacterized LOC111126846,2390
NC_035782.1,1668568,1671236,1668568,1671236,111126848,XM_022471751.1,uncharacterized LOC111126848,2668
NC_035782.1,1258075,1289523,1258075,1289523,111126849,XM_022471752.1,uncharacterized LOC111126849,31448
NC_035782.1,1325208,1349917,1325208,1349917,111126850,XM_022471754.1,uncharacterized LOC111126850,24709
NC_035782.1,1396711,1457715,1422682,1457715,111126852,XM_022471758.1,uncharacterized LOC111126852,35033
NC_035782.1,1396711,1457715,1396711,1457715,111126852,XM_022471760.1,uncharacterized LOC111126852,61004
NC_035782.1,72296329,72306853,72296329,72306853,111126856,XM_022471764.1,uncharacterized LOC111126856,10524
NC_035782.1,20446430,20451863,20446430,20451863,111126859,XM_022471765.1,uncharacterized LOC111126859,5433
NC_035782.1,48418115,48441987,48418115,48441987,111126860,XM_022471767.1,uncharacterized LOC111126860,23872
NC_035782.1,24929315,24932606,24929315,24932606,111126861,XM_022471768.1,uncharacterized LOC111126861,3291
NC_035782.1,7639300,7668391,7639300,7668391,111126867,XM_022471775.1,uncharacterized LOC111126867,29091
NC_035782.1,37645442,37649388,37645442,37649388,111126869,XM_022471777.1,uncharacterized LOC111126869,3946
NC_035780.1,8919790,8924585,8919790,8924585,111126874,XM_022471821.1,uncharacterized LOC111126874,4795
NC_035782.1,18097154,18098555,18097154,18098555,111126876,XM_022471786.1,uncharacterized LOC111126876,1401
NC_035782.1,74423402,74424214,74423402,74424214,111126879,XM_022471790.1,uncharacterized LOC111126879,812
NC_035782.1,50969286,50978666,50975085,50978665,111126882,XM_022471797.1,uncharacterized LOC111126882,3580
NC_035782.1,50969286,50978666,50970907,50978665,111126882,XM_022471796.1,uncharacterized LOC111126882,7758
NC_035782.1,50969286,50978666,50969286,50978666,111126882,XM_022471795.1,uncharacterized LOC111126882,9380
NC_035782.1,71095342,71100404,71095342,71100404,111126884,XM_022471800.1,uncharacterized LOC111126884,5062
NC_035782.1,51023865,51031656,51023865,51031656,111126895,XM_022471818.1,uncharacterized LOC111126895,7791
NC_035782.1,74664869,74670341,74664869,74670341,111126899,XM_022471823.1,uncharacterized LOC111126899,5472
NC_035782.1,71014484,71033529,71016418,71033529,111126901,XM_022471829.1,uncharacterized LOC111126901,17111
NC_035782.1,71014484,71033529,71016141,71033529,111126901,XM_022471828.1,uncharacterized LOC111126901,17388
NC_035782.1,71014484,71033529,71014505,71033529,111126901,XM_022471826.1,uncharacterized LOC111126901,19024
NC_035782.1,71014484,71033529,71014484,71033529,111126901,XM_022471827.1,uncharacterized LOC111126901,19045
NC_035782.1,39620044,39632543,39620044,39632543,111126902,XM_022471830.1,uncharacterized LOC111126902,12499
NC_035782.1,24784047,24791118,24784047,24789790,111126904,XM_022471835.1,uncharacterized LOC111126904,5743
NC_035782.1,24784047,24791118,24784047,24791118,111126904,XM_022471836.1,uncharacterized LOC111126904,7071
NC_035782.1,49934204,49938893,49934204,49938893,111126906,XM_022471839.1,uncharacterized LOC111126906,4689
NC_035782.1,2055224,2057847,2055224,2057847,111126909,XM_022471842.1,uncharacterized LOC111126909,2623
NC_035782.1,3715876,3718881,3715876,3718881,111126910,XM_022471843.1,uncharacterized LOC111126910,3005
NC_035782.1,2602892,2604018,2602892,2604018,111126916,XM_022471854.1,uncharacterized LOC111126916,1126
NC_035782.1,58532124,58533711,58532336,58533711,111126919,XM_022471863.1,uncharacterized LOC111126919,1375
NC_035782.1,58532124,58533711,58532124,58533711,111126919,XM_022471862.1,uncharacterized LOC111126919,1587
NC_035782.1,42604343,42606204,42604343,42606204,111126920,XM_022471864.1,uncharacterized LOC111126920,1861
NC_035782.1,27997006,28050787,27998605,28050537,111126923,XM_022471866.1,uncharacterized LOC111126923,51932
NC_035782.1,27997006,28050787,27998605,28050787,111126923,XM_022471867.1,uncharacterized LOC111126923,52182
NC_035782.1,27997006,28050787,27997006,28050539,111126923,XM_022471868.1,uncharacterized LOC111126923,53533
NC_035782.1,16294611,16297915,16294616,16297915,111126927,XM_022471874.1,uncharacterized LOC111126927,3299
NC_035782.1,16294611,16297915,16294611,16297915,111126927,XM_022471873.1,uncharacterized LOC111126927,3304
NC_035782.1,15445509,15455385,15446027,15455385,111126935,XM_022471885.1,uncharacterized LOC111126935,9358
NC_035782.1,15445509,15455385,15445509,15455385,111126935,XM_022471884.1,uncharacterized LOC111126935,9876
NC_035782.1,32761445,32766062,32761445,32766062,111126937,XM_022471888.1,uncharacterized LOC111126937,4617
NC_035782.1,18356762,18360336,18356762,18360336,111126939,XM_022471890.1,uncharacterized LOC111126939,3574
NC_035782.1,59189763,59194584,59189763,59194584,111126943,XM_022471895.1,uncharacterized LOC111126943,4821
NC_035782.1,27232366,27234714,27232366,27234714,111126944,XM_022471896.1,uncharacterized LOC111126944,2348
NC_035782.1,25525728,25536889,25526451,25536886,111126948,XM_022471901.1,uncharacterized LOC111126948,10435
NC_035782.1,25525728,25536889,25525730,25536885,111126948,XM_022471900.1,uncharacterized LOC111126948,11155
NC_035782.1,25525728,25536889,25525728,25536889,111126948,XM_022471899.1,uncharacterized LOC111126948,11161
NC_035782.1,20483679,20489390,20483679,20489390,111126951,XM_022471904.1,uncharacterized LOC111126951,5711
NC_035782.1,47885112,47886366,47885112,47886366,111126952,XM_022471905.1,uncharacterized LOC111126952,1254
NC_035782.1,32480464,32483418,32480464,32483418,111126954,XM_022471908.1,uncharacterized LOC111126954,2954
NC_035782.1,74860997,74869569,74860997,74869569,111126955,XM_022471909.1,uncharacterized LOC111126955,8572
NC_035782.1,254155,255342,254155,255342,111126956,XM_022471911.1,uncharacterized LOC111126956,1187
NC_035782.1,22368209,22373561,22368209,22373561,111126960,XM_022471916.1,uncharacterized LOC111126960,5352
NC_035782.1,287908,290114,287908,290114,111126962,XM_022471922.1,uncharacterized LOC111126962,2206
NC_035782.1,7720044,7728684,7723263,7728684,111126964,XM_022471925.1,uncharacterized LOC111126964,5421
NC_035782.1,7720044,7728684,7720044,7728684,111126964,XM_022471924.1,uncharacterized LOC111126964,8640
NC_035782.1,25241797,25246135,25241797,25246135,111126965,XM_022471926.1,uncharacterized LOC111126965,4338
NC_035782.1,68278492,68281510,68278492,68281510,111126971,XM_022471933.1,uncharacterized LOC111126971,3018
NC_035782.1,371931,372494,371931,372494,111126978,XM_022471939.1,uncharacterized LOC111126978,563
NC_035782.1,70551308,70554264,70551308,70554264,111126982,XM_022471945.1,uncharacterized LOC111126982,2956
NC_035782.1,378275,379159,378275,379159,111126984,XM_022471947.1,uncharacterized LOC111126984,884
NC_035782.1,3709855,3712210,3709855,3712210,111126985,XM_022471948.1,uncharacterized LOC111126985,2355
NC_035782.1,470498,471868,470498,471868,111126990,XM_022471956.1,uncharacterized LOC111126990,1370
NC_035782.1,52203328,52215098,52203328,52215098,111126995,XM_022471960.1,uncharacterized LOC111126995,11770
NC_035782.1,66524987,66526900,66524987,66526900,111126998,XM_022471965.1,uncharacterized LOC111126998,1913
NC_035782.1,66413163,66566530,66413163,66566530,111126999,XM_022471966.1,uncharacterized LOC111126999,153367
NC_035782.1,42896091,42899939,42896091,42899939,111127006,XM_022471978.1,uncharacterized LOC111127006,3848
NC_035782.1,71601457,71627685,71602616,71627685,111127010,XM_022471988.1,uncharacterized LOC111127010,25069
NC_035782.1,71601457,71627685,71602608,71627685,111127010,XM_022471985.1,uncharacterized LOC111127010,25077
NC_035782.1,71601457,71627685,71601460,71627685,111127010,XM_022471987.1,uncharacterized LOC111127010,26225
NC_035782.1,71601457,71627685,71601458,71627685,111127010,XM_022471984.1,uncharacterized LOC111127010,26227
NC_035782.1,71601457,71627685,71620580,71627685,111127010,XM_022471986.1,uncharacterized LOC111127010,7105
NC_035782.1,514930,516396,514930,516396,111127015,XM_022471995.1,uncharacterized LOC111127015,1466
NC_035782.1,18516636,18519636,18516636,18519636,111127018,XM_022471998.1,uncharacterized LOC111127018,3000
NC_035782.1,40981461,40987177,40981461,40987177,111127020,XM_022472001.1,uncharacterized LOC111127020,5716
NC_035782.1,60489765,60539585,60489765,60539585,111127021,XM_022472002.1,uncharacterized LOC111127021,49820
NC_035782.1,60544460,60580732,60544460,60580732,111127022,XM_022472004.1,uncharacterized LOC111127022,36272
NC_035782.1,531180,532687,531180,532687,111127023,XM_022472005.1,uncharacterized LOC111127023,1507
NC_035780.1,22877109,22883412,22877109,22881749,111127024,XM_022472017.1,uncharacterized LOC111127024,4640
NC_035780.1,22877109,22883412,22877109,22883412,111127024,XM_022472008.1,uncharacterized LOC111127024,6303
NC_035782.1,41955568,41964666,41955568,41964666,111127030,XM_022472010.1,uncharacterized LOC111127030,9098
NC_035782.1,557259,557942,557259,557942,111127035,XM_022472018.1,uncharacterized LOC111127035,683
NC_035782.1,18105012,18107632,18105012,18107632,111127036,XM_022472019.1,uncharacterized LOC111127036,2620
NC_035782.1,38874429,38876677,38874429,38876677,111127039,XM_022472022.1,uncharacterized LOC111127039,2248
NC_035782.1,576218,593294,576218,593294,111127040,XM_022472023.1,uncharacterized LOC111127040,17076
NC_035780.1,22910575,22919597,22910575,22919597,111127042,XM_022472029.1,uncharacterized LOC111127042,9022
NC_035780.1,22886784,22909815,22886784,22909815,111127048,XM_022472050.1,uncharacterized LOC111127048,23031
NC_035780.1,22886784,22909815,22886784,22895024,111127048,XM_022472075.1,uncharacterized LOC111127048,8240
NC_035780.1,22886784,22909815,22886784,22895028,111127048,XM_022472058.1,uncharacterized LOC111127048,8244
NC_035780.1,22886784,22909815,22886784,22895029,111127048,XM_022472083.1,uncharacterized LOC111127048,8245
NC_035780.1,22886784,22909815,22886784,22895090,111127048,XM_022472068.1,uncharacterized LOC111127048,8306
NC_035780.1,22886784,22909815,22886784,22895119,111127048,XM_022472092.1,uncharacterized LOC111127048,8335
NC_035780.1,22886784,22909815,22886784,22895350,111127048,XM_022472041.1,uncharacterized LOC111127048,8566
NC_035782.1,39527175,39535394,39527175,39535394,111127049,XM_022472040.1,uncharacterized LOC111127049,8219
NC_035782.1,24924013,24927863,24924013,24927863,111127050,XM_022472042.1,uncharacterized LOC111127050,3850
NC_035782.1,48391025,48398284,48391025,48397623,111127051,XM_022472047.1,uncharacterized LOC111127051,6598
NC_035782.1,48391025,48398284,48391025,48398275,111127051,XM_022472044.1,uncharacterized LOC111127051,7250
NC_035782.1,48391025,48398284,48391025,48398276,111127051,XM_022472045.1,uncharacterized LOC111127051,7251
NC_035782.1,48391025,48398284,48391025,48398284,111127051,XM_022472046.1,uncharacterized LOC111127051,7259
NC_035782.1,72087345,72090245,72087345,72090245,111127054,XM_022472052.1,uncharacterized LOC111127054,2900
NC_035782.1,55078573,55081799,55078573,55081799,111127055,XM_022472053.1,uncharacterized LOC111127055,3226
NC_035782.1,606586,607437,606586,607437,111127056,XM_022472054.1,uncharacterized LOC111127056,851
NC_035780.1,58543166,58561299,58543167,58561299,111127057,XM_022473202.1,uncharacterized LOC111127057,18132
NC_035780.1,58543166,58561299,58543166,58561299,111127057,XM_022472454.1,uncharacterized LOC111127057,18133
NC_035782.1,14820463,14830121,14820463,14830121,111127061,XM_022472060.1,uncharacterized LOC111127061,9658
NC_035782.1,68820790,68823044,68820790,68823044,111127062,XM_022472061.1,uncharacterized LOC111127062,2254
NC_035782.1,14867169,14871036,14867169,14871036,111127063,XM_022472062.1,uncharacterized LOC111127063,3867
NC_035782.1,22344369,22349073,22344369,22349073,111127065,XM_022472069.1,uncharacterized LOC111127065,4704
NC_035782.1,642169,695086,642169,695086,111127066,XM_022472070.1,uncharacterized LOC111127066,52917
NC_035782.1,71706085,71711032,71706086,71708411,111127073,XM_022472078.1,uncharacterized LOC111127073,2325
NC_035782.1,9139306,9148988,9139306,9148988,111127074,XM_022472079.1,uncharacterized LOC111127074,9682
NC_035782.1,711156,725723,711156,725723,111127076,XM_022472082.1,uncharacterized LOC111127076,14567
NC_035782.1,72624276,72637025,72624276,72635926,111127079,XM_022472089.1,uncharacterized LOC111127079,11650
NC_035782.1,72624276,72637025,72624276,72637003,111127079,XM_022472088.1,uncharacterized LOC111127079,12727
NC_035782.1,72624276,72637025,72624276,72637021,111127079,XM_022472087.1,uncharacterized LOC111127079,12745
NC_035782.1,72624276,72637025,72624276,72637025,111127079,XM_022472090.1,uncharacterized LOC111127079,12749
NC_035782.1,1174983,1178861,1174983,1178861,111127080,XM_022472091.1,uncharacterized LOC111127080,3878
NC_035782.1,25689295,25700567,25689295,25700567,111127081,XM_022472093.1,uncharacterized LOC111127081,11272
NC_035782.1,7157118,7183056,7157118,7183056,111127083,XM_022472096.1,uncharacterized LOC111127083,25938
NC_035782.1,49180185,49187900,49180185,49187900,111127084,XM_022472097.1,uncharacterized LOC111127084,7715
NC_035782.1,55628549,55630369,55628549,55630369,111127088,XM_022472101.1,uncharacterized LOC111127088,1820
NC_035782.1,58419438,58427050,58420900,58427049,111127089,XM_022472102.1,uncharacterized LOC111127089,6149
NC_035782.1,58419438,58427050,58420372,58427049,111127089,XM_022472106.1,uncharacterized LOC111127089,6677
NC_035782.1,58419438,58427050,58419444,58427050,111127089,XM_022472105.1,uncharacterized LOC111127089,7606
NC_035782.1,58419438,58427050,58419438,58427050,111127089,XM_022472103.1,uncharacterized LOC111127089,7612
NC_035782.1,63631054,63642732,63631060,63642732,111127097,XM_022472115.1,uncharacterized LOC111127097,11672
NC_035782.1,63631054,63642732,63631054,63642732,111127097,XM_022472117.1,uncharacterized LOC111127097,11678
NC_035782.1,63631054,63642732,63633390,63642732,111127097,XM_022472118.1,uncharacterized LOC111127097,9342
NC_035782.1,36940033,36954028,36940033,36954028,111127098,XM_022472119.1,uncharacterized LOC111127098,13995
NC_035782.1,885671,890973,885671,890973,111127101,XM_022472122.1,uncharacterized LOC111127101,5302
NC_035782.1,11140269,11162842,11140269,11162842,111127102,XM_022472123.1,uncharacterized LOC111127102,22573
NC_035780.1,19321676,19324583,19321676,19324583,111127109,XM_022472178.1,uncharacterized LOC111127109,2907
NC_035782.1,73071941,73075061,73071941,73075061,111127112,XM_022472140.1,uncharacterized LOC111127112,3120
NC_035782.1,11283221,11304005,11286595,11304005,111127117,XM_022472150.1,uncharacterized LOC111127117,17410
NC_035782.1,11283221,11304005,11283228,11304005,111127117,XM_022472146.1,uncharacterized LOC111127117,20777
NC_035782.1,11283221,11304005,11283221,11304005,111127117,XM_022472147.1,uncharacterized LOC111127117,20784
NC_035782.1,46115155,46119318,46115155,46119318,111127120,XM_022472152.1,uncharacterized LOC111127120,4163
NC_035782.1,1088193,1098240,1088193,1098240,111127121,XM_022472154.1,uncharacterized LOC111127121,10047
NC_035782.1,20324476,20327165,20324476,20327165,111127123,XM_022472156.1,uncharacterized LOC111127123,2689
NC_035782.1,51915873,51926066,51915874,51926058,111127124,XM_022472158.1,uncharacterized LOC111127124,10184
NC_035782.1,51915873,51926066,51915873,51926066,111127124,XM_022472157.1,uncharacterized LOC111127124,10193
NC_035782.1,51915873,51926066,51915875,51921742,111127124,XM_022472161.1,uncharacterized LOC111127124,5867
NC_035782.1,51915873,51926066,51915874,51922630,111127124,XM_022472160.1,uncharacterized LOC111127124,6756
NC_035782.1,51915873,51926066,51915874,51923193,111127124,XM_022472159.1,uncharacterized LOC111127124,7319
NC_035782.1,22316462,22322170,22316462,22322170,111127125,XM_022472163.1,uncharacterized LOC111127125,5708
NC_035782.1,42764651,42767016,42764651,42767016,111127128,XM_022472166.1,uncharacterized LOC111127128,2365
NC_035782.1,42552231,42554863,42552231,42554863,111127129,XM_022472167.1,uncharacterized LOC111127129,2632
NC_035782.1,1199454,1202249,1199454,1202249,111127132,XM_022472172.1,uncharacterized LOC111127132,2795
NC_035782.1,1235643,1240658,1235643,1240658,111127141,XM_022472187.1,uncharacterized LOC111127141,5015
NC_035782.1,56411867,56421553,56412000,56421553,111127142,XM_022472190.1,uncharacterized LOC111127142,9553
NC_035782.1,56411867,56421553,56411949,56421553,111127142,XM_022472189.1,uncharacterized LOC111127142,9604
NC_035782.1,56411867,56421553,56411867,56421553,111127142,XM_022472188.1,uncharacterized LOC111127142,9686
NC_035782.1,1296285,1297134,1296285,1297134,111127148,XM_022472208.1,uncharacterized LOC111127148,849
NC_035782.1,1371626,1384156,1371626,1384156,111127154,XM_022472213.1,uncharacterized LOC111127154,12530
NC_035782.1,39312730,39313884,39312730,39313884,111127156,XM_022472215.1,uncharacterized LOC111127156,1154
NC_035782.1,57740530,57746148,57740584,57746148,111127158,XM_022472217.1,uncharacterized LOC111127158,5564
NC_035782.1,57740530,57746148,57740541,57746148,111127158,XM_022472216.1,uncharacterized LOC111127158,5607
NC_035782.1,57740530,57746148,57740530,57746148,111127158,XM_022472218.1,uncharacterized LOC111127158,5618
NC_035782.1,1393291,1393695,1393291,1393695,111127163,XM_022472222.1,uncharacterized LOC111127163,404
NC_035782.1,1622808,1624001,1622808,1624001,111127167,XM_022472231.1,uncharacterized LOC111127167,1193
NC_035782.1,30657617,30665955,30659136,30665955,111127169,XM_022472234.1,uncharacterized LOC111127169,6819
NC_035782.1,30657617,30665955,30657617,30665955,111127169,XM_022472235.1,uncharacterized LOC111127169,8338
NC_035782.1,1652180,1653367,1652180,1653367,111127172,XM_022472238.1,uncharacterized LOC111127172,1187
NC_035782.1,1658587,1659471,1658587,1659471,111127176,XM_022472245.1,uncharacterized LOC111127176,884
NC_035782.1,38269879,38272069,38269879,38272069,111127184,XM_022472257.1,uncharacterized LOC111127184,2190
NC_035780.1,51410357,51415318,51410357,51415318,111127186,XM_022472262.1,uncharacterized LOC111127186,4961
NC_035782.1,42573645,42578044,42573645,42577992,111127188,XM_022472261.1,uncharacterized LOC111127188,4347
NC_035782.1,42573645,42578044,42573645,42578044,111127188,XM_022472260.1,uncharacterized LOC111127188,4399
NC_035782.1,1848177,1860005,1848177,1860005,111127190,XM_022472263.1,uncharacterized LOC111127190,11828
NC_035782.1,15006916,15008101,15006916,15008101,111127191,XM_022472264.1,uncharacterized LOC111127191,1185
NC_035782.1,69302497,69303276,69302497,69303276,111127192,XM_022472265.1,uncharacterized LOC111127192,779
NC_035782.1,20095110,20103615,20096410,20103615,111127193,XM_022472266.1,uncharacterized LOC111127193,7205
NC_035782.1,20095110,20103615,20096145,20103615,111127193,XM_022472269.1,uncharacterized LOC111127193,7470
NC_035782.1,20095110,20103615,20096139,20103615,111127193,XM_022472268.1,uncharacterized LOC111127193,7476
NC_035782.1,20095110,20103615,20095128,20103615,111127193,XM_022472267.1,uncharacterized LOC111127193,8487
NC_035782.1,20095110,20103615,20095110,20103615,111127193,XM_022472270.1,uncharacterized LOC111127193,8505
NC_035780.1,51352028,51359993,51352028,51358548,111127194,XM_022472274.1,uncharacterized LOC111127194,6520
NC_035780.1,51352028,51359993,51352028,51359993,111127194,XM_022472281.1,uncharacterized LOC111127194,7965
NC_035782.1,57352553,57359805,57353010,57359805,111127196,XM_022472273.1,uncharacterized LOC111127196,6795
NC_035782.1,57352553,57359805,57352553,57359805,111127196,XM_022472272.1,uncharacterized LOC111127196,7252
NC_035782.1,55151151,55152187,55151151,55152187,111127199,XM_022472276.1,uncharacterized LOC111127199,1036
NC_035782.1,874154,885172,874154,885172,111127205,XM_022472284.1,uncharacterized LOC111127205,11018
NC_035782.1,920004,936320,920004,936320,111127206,XM_022472285.1,uncharacterized LOC111127206,16316
NC_035782.1,767449,773264,767449,773264,111127208,XM_022472287.1,uncharacterized LOC111127208,5815
NC_035782.1,777156,781451,777156,781451,111127210,XM_022472288.1,uncharacterized LOC111127210,4295
NC_035782.1,1905320,1907843,1905320,1907843,111127213,XM_022472292.1,uncharacterized LOC111127213,2523
NC_035780.1,51426862,51428296,51426862,51428296,111127218,XM_022472303.1,uncharacterized LOC111127218,1434
NC_035782.1,64224530,64238285,64224530,64238285,111127222,XM_022472307.1,uncharacterized LOC111127222,13755
NC_035782.1,65638464,65641042,65638464,65641042,111127235,XM_022472324.1,uncharacterized LOC111127235,2578
NC_035782.1,65631924,65636955,65631924,65636955,111127236,XM_022472325.1,uncharacterized LOC111127236,5031
NC_035782.1,65681524,65683870,65681524,65683870,111127237,XM_022472330.1,uncharacterized LOC111127237,2346
NC_035782.1,60271986,60280361,60271986,60280361,111127245,XM_022472339.1,uncharacterized LOC111127245,8375
NC_035782.1,2004648,2011511,2004648,2011511,111127246,XM_022472340.1,uncharacterized LOC111127246,6863
NC_035782.1,59459223,59469168,59459223,59469168,111127247,XM_022472341.1,uncharacterized LOC111127247,9945
NC_035782.1,4576499,4590980,4576499,4590980,111127248,XM_022472342.1,uncharacterized LOC111127248,14481
NC_035782.1,26542176,26544941,26542176,26544941,111127250,XM_022472344.1,uncharacterized LOC111127250,2765
NC_035782.1,25253322,25255859,25253322,25255859,111127251,XM_022472345.1,uncharacterized LOC111127251,2537
NC_035782.1,9878393,9883341,9878393,9883341,111127252,XM_022472347.1,uncharacterized LOC111127252,4948
NC_035782.1,70580921,70598242,70580921,70598242,111127255,XM_022472352.1,uncharacterized LOC111127255,17321
NC_035782.1,2034626,2036005,2034626,2036005,111127256,XM_022472353.1,uncharacterized LOC111127256,1379
NC_035782.1,75643728,75663249,75643728,75663249,111127262,XM_022472362.1,uncharacterized LOC111127262,19521
NC_035782.1,3723021,3724902,3723021,3724902,111127265,XM_022472371.1,uncharacterized LOC111127265,1881
NC_035782.1,36619226,36621420,36619226,36621420,111127267,XM_022472373.1,uncharacterized LOC111127267,2194
NC_035782.1,2067512,2068243,2067512,2068243,111127269,XM_022472374.1,uncharacterized LOC111127269,731
NC_035780.1,4219525,4243840,4219527,4243840,111127270,XM_022472409.1,uncharacterized LOC111127270,24313
NC_035780.1,4219525,4243840,4219525,4243840,111127270,XM_022472494.1,uncharacterized LOC111127270,24315
NC_035780.1,27929844,27959805,27929844,27959805,111127271,XM_022472379.1,uncharacterized LOC111127271,29961
NC_035782.1,74457775,74461658,74457775,74461658,111127272,XM_022472375.1,uncharacterized LOC111127272,3883
NC_035782.1,15465974,15472619,15465974,15472619,111127273,XM_022472376.1,uncharacterized LOC111127273,6645
NC_035782.1,73469808,73472445,73469808,73472445,111127275,XM_022472380.1,uncharacterized LOC111127275,2637
NC_035782.1,9239132,9240921,9239132,9240921,111127279,XM_022472384.1,uncharacterized LOC111127279,1789
NC_035782.1,14840811,14847347,14840811,14847347,111127283,XM_022472386.1,uncharacterized LOC111127283,6536
NC_035782.1,68473919,68476184,68473919,68476184,111127284,XM_022472387.1,uncharacterized LOC111127284,2265
NC_035782.1,2206224,2207762,2206224,2207762,111127287,XM_022472389.1,uncharacterized LOC111127287,1538
NC_035782.1,13999534,14011834,13999534,14011834,111127294,XM_022472395.1,uncharacterized LOC111127294,12300
NC_035782.1,25702177,25709338,25702177,25709338,111127296,XM_022472398.1,uncharacterized LOC111127296,7161
NC_035782.1,7694342,7699270,7694342,7699270,111127298,XM_022472400.1,uncharacterized LOC111127298,4928
NC_035782.1,2270593,2278361,2270593,2278361,111127300,XM_022472401.1,uncharacterized LOC111127300,7768
NC_035782.1,30668946,30670484,30668946,30670484,111127301,XM_022472402.1,uncharacterized LOC111127301,1538
NC_035782.1,2296087,2297370,2296087,2297370,111127305,XM_022472408.1,uncharacterized LOC111127305,1283
NC_035782.1,35900243,35902657,35900697,35902657,111127306,XM_022472412.1,uncharacterized LOC111127306,1960
NC_035782.1,35900243,35902657,35900258,35902657,111127306,XM_022472411.1,uncharacterized LOC111127306,2399
NC_035782.1,35900243,35902657,35900243,35902657,111127306,XM_022472410.1,uncharacterized LOC111127306,2414
NC_035782.1,71068252,71084660,71068252,71084660,111127307,XM_022472413.1,uncharacterized LOC111127307,16408
NC_035780.1,35773727,35775329,35773727,35775329,111127308,XM_022472418.1,uncharacterized LOC111127308,1602
NC_035782.1,66830501,66847392,66835360,66846447,111127310,XM_022472424.1,uncharacterized LOC111127310,11087
NC_035782.1,66830501,66847392,66835359,66846447,111127310,XM_022472423.1,uncharacterized LOC111127310,11088
NC_035782.1,66830501,66847392,66834689,66846447,111127310,XM_022472422.1,uncharacterized LOC111127310,11758
NC_035782.1,66830501,66847392,66830501,66846447,111127310,XM_022472419.1,uncharacterized LOC111127310,15946
NC_035782.1,66830501,66847392,66830501,66847392,111127310,XM_022472417.1,uncharacterized LOC111127310,16891
NC_035782.1,66655531,66672504,66660015,66671776,111127311,XM_022472427.1,uncharacterized LOC111127311,11761
NC_035782.1,66655531,66672504,66655531,66671776,111127311,XM_022472426.1,uncharacterized LOC111127311,16245
NC_035782.1,66655531,66672504,66655531,66672504,111127311,XM_022472425.1,uncharacterized LOC111127311,16973
NC_035780.1,7295075,7306858,7295075,7306858,111127317,XM_022472440.1,uncharacterized LOC111127317,11783
NC_035782.1,66650734,66652651,66650734,66652651,111127327,XM_022472457.1,uncharacterized LOC111127327,1917
NC_035782.1,66824826,66827206,66824826,66827206,111127328,XM_022472458.1,uncharacterized LOC111127328,2380
NC_035780.1,63464079,63465867,63464079,63465867,111127333,XM_022472466.1,uncharacterized LOC111127333,1788
NC_035782.1,51007169,51011671,51007169,51011671,111127338,XM_022472468.1,uncharacterized LOC111127338,4502
NC_035782.1,12153716,12156115,12153716,12156115,111127345,XM_022472475.1,uncharacterized LOC111127345,2399
NC_035782.1,12210884,12214579,12210884,12213110,111127350,XM_022472481.1,uncharacterized LOC111127350,2226
NC_035782.1,12210884,12214579,12210884,12214579,111127350,XM_022472480.1,uncharacterized LOC111127350,3695
NC_035782.1,10299919,10305925,10299919,10304130,111127356,XM_022472498.1,uncharacterized LOC111127356,4211
NC_035782.1,10299919,10305925,10299919,10305824,111127356,XM_022472497.1,uncharacterized LOC111127356,5905
NC_035782.1,10299919,10305925,10299919,10305925,111127356,XM_022472499.1,uncharacterized LOC111127356,6006
NC_035782.1,30134610,30138231,30134610,30138027,111127357,XM_022472501.1,uncharacterized LOC111127357,3417
NC_035782.1,30134610,30138231,30134610,30138231,111127357,XM_022472500.1,uncharacterized LOC111127357,3621
NC_035782.1,23761000,23763738,23761000,23763738,111127360,XM_022472505.1,uncharacterized LOC111127360,2738
NC_035782.1,59078880,59080722,59078880,59080722,111127364,XM_022472509.1,uncharacterized LOC111127364,1842
NC_035782.1,70642890,70655326,70642890,70655326,111127365,XM_022472510.1,uncharacterized LOC111127365,12436
NC_035782.1,11039353,11045333,11039353,11043522,111127366,XM_022472513.1,uncharacterized LOC111127366,4169
NC_035782.1,11039353,11045333,11039353,11045233,111127366,XM_022472511.1,uncharacterized LOC111127366,5880
NC_035782.1,11039353,11045333,11039353,11045333,111127366,XM_022472514.1,uncharacterized LOC111127366,5980
NC_035782.1,8566102,8569992,8566102,8569992,111127367,XM_022472515.1,uncharacterized LOC111127367,3890
NC_035782.1,8554391,8564307,8554391,8564307,111127368,XM_022472517.1,uncharacterized LOC111127368,9916
NC_035782.1,18080694,18082542,18080694,18082542,111127373,XM_022472527.1,uncharacterized LOC111127373,1848
NC_035782.1,57011340,57019001,57011340,57019001,111127374,XM_022472528.1,uncharacterized LOC111127374,7661
NC_035782.1,16316768,16324338,16316768,16324338,111127377,XM_022472532.1,uncharacterized LOC111127377,7570
NC_035782.1,75415774,75416911,75415774,75416911,111127381,XM_022472540.1,uncharacterized LOC111127381,1137
NC_035782.1,3089650,3094508,3089650,3094508,111127382,XM_022472541.1,uncharacterized LOC111127382,4858
NC_035782.1,8526982,8532476,8526982,8532476,111127383,XM_022472542.1,uncharacterized LOC111127383,5494
NC_035782.1,3235957,3237638,3235957,3237638,111127384,XM_022472543.1,uncharacterized LOC111127384,1681
NC_035782.1,44826457,44832547,44826457,44832547,111127388,XM_022472546.1,uncharacterized LOC111127388,6090
NC_035782.1,73783986,73788040,73783986,73788040,111127393,XM_022472552.1,uncharacterized LOC111127393,4054
NC_035782.1,4658231,4671985,4658231,4671985,111127395,XM_022472554.1,uncharacterized LOC111127395,13754
NC_035782.1,3257448,3258701,3257448,3258701,111127396,XM_022472555.1,uncharacterized LOC111127396,1253
NC_035782.1,61217985,61229040,61217985,61229040,111127399,XM_022472557.1,uncharacterized LOC111127399,11055
NC_035782.1,3263007,3277992,3263007,3277992,111127401,XM_022472560.1,uncharacterized LOC111127401,14985
NC_035782.1,45100807,45106020,45100807,45106020,111127403,XM_022472562.1,uncharacterized LOC111127403,5213
NC_035782.1,3279100,3290055,3279100,3290055,111127406,XM_022472565.1,uncharacterized LOC111127406,10955
NC_035782.1,32742187,32745267,32742187,32744923,111127408,XM_022472568.1,uncharacterized LOC111127408,2736
NC_035782.1,32742187,32745267,32742187,32745267,111127408,XM_022472569.1,uncharacterized LOC111127408,3080
NC_035782.1,60436763,60444456,60436770,60444456,111127415,XM_022472586.1,uncharacterized LOC111127415,7686
NC_035782.1,60436763,60444456,60436763,60444456,111127415,XM_022472585.1,uncharacterized LOC111127415,7693
NC_035782.1,75527856,75540785,75527856,75540785,111127423,XM_022472596.1,uncharacterized LOC111127423,12929
NC_035782.1,74849876,74858428,74849876,74858428,111127425,XM_022472597.1,uncharacterized LOC111127425,8552
NC_035782.1,16299461,16316271,16299461,16316271,111127426,XM_022472598.1,uncharacterized LOC111127426,16810
NC_035782.1,41489270,41492457,41489270,41492457,111127428,XM_022472602.1,uncharacterized LOC111127428,3187
NC_035782.1,3452378,3454583,3452378,3454583,111127430,XM_022472604.1,uncharacterized LOC111127430,2205
NC_035782.1,4464002,4468327,4464002,4468327,111127438,XM_022472614.1,uncharacterized LOC111127438,4325
NC_035782.1,29537812,29541280,29537812,29541280,111127445,XM_022472623.1,uncharacterized LOC111127445,3468
NC_035782.1,3751405,3756268,3751405,3756268,111127448,XM_022472625.1,uncharacterized LOC111127448,4863
NC_035782.1,42666794,42668362,42666794,42668362,111127449,XM_022472626.1,uncharacterized LOC111127449,1568
NC_035782.1,42661852,42663420,42661852,42663420,111127451,XM_022472630.1,uncharacterized LOC111127451,1568
NC_035782.1,49600685,49611861,49600685,49611861,111127452,XM_022472631.1,uncharacterized LOC111127452,11176
NC_035782.1,542563,544913,542563,544913,111127453,XM_022472632.1,uncharacterized LOC111127453,2350
NC_035782.1,74110214,74111408,74110214,74111408,111127455,XM_022472634.1,uncharacterized LOC111127455,1194
NC_035782.1,20367493,20373127,20367493,20373127,111127460,XM_022472640.1,uncharacterized LOC111127460,5634
NC_035782.1,35502434,35510114,35502434,35510092,111127473,XM_022472660.1,uncharacterized LOC111127473,7658
NC_035782.1,35502434,35510114,35502434,35510114,111127473,XM_022472659.1,uncharacterized LOC111127473,7680
NC_035782.1,57525029,57572684,57525029,57572248,111127479,XM_022472671.1,uncharacterized LOC111127479,47219
NC_035782.1,57525029,57572684,57525029,57572684,111127479,XM_022472670.1,uncharacterized LOC111127479,47655
NC_035782.1,25999159,26015599,25999159,26015599,111127485,XM_022472676.1,uncharacterized LOC111127485,16440
NC_035782.1,36604733,36616076,36604733,36616067,111127487,XM_022472683.1,uncharacterized LOC111127487,11334
NC_035782.1,36604733,36616076,36604733,36616076,111127487,XM_022472681.1,uncharacterized LOC111127487,11343
NC_035782.1,36604733,36616076,36604733,36607355,111127487,XM_022472680.1,uncharacterized LOC111127487,2622
NC_035782.1,36604733,36616076,36604733,36608601,111127487,XM_022472679.1,uncharacterized LOC111127487,3868
NC_035782.1,36604733,36616076,36604733,36608602,111127487,XM_022472685.1,uncharacterized LOC111127487,3869
NC_035782.1,36604733,36616076,36604733,36608743,111127487,XM_022472684.1,uncharacterized LOC111127487,4010
NC_035782.1,36604733,36616076,36604733,36608931,111127487,XM_022472682.1,uncharacterized LOC111127487,4198
NC_035782.1,57598438,57612541,57598438,57612541,111127493,XM_022472693.1,uncharacterized LOC111127493,14103
NC_035782.1,54185349,54187121,54185349,54187121,111127495,XM_022472696.1,uncharacterized LOC111127495,1772
NC_035780.1,16804301,16805412,16804301,16805412,111127496,XM_022472736.1,uncharacterized LOC111127496,1111
NC_035782.1,4402174,4404325,4402174,4404325,111127497,XM_022472699.1,uncharacterized LOC111127497,2151
NC_035782.1,17380532,17385108,17380532,17385108,111127501,XM_022472705.1,uncharacterized LOC111127501,4576
NC_035782.1,4614639,4620375,4614639,4620375,111127504,XM_022472707.1,uncharacterized LOC111127504,5736
NC_035782.1,42641952,42643850,42641952,42643850,111127506,XM_022472709.1,uncharacterized LOC111127506,1898
NC_035782.1,38449007,38452352,38449007,38452310,111127508,XM_022472711.1,uncharacterized LOC111127508,3303
NC_035782.1,38449007,38452352,38449007,38452352,111127508,XM_022472712.1,uncharacterized LOC111127508,3345
NC_035782.1,2588129,2591160,2588129,2591160,111127512,XM_022472721.1,uncharacterized LOC111127512,3031
NC_035782.1,4774499,4776055,4774499,4776055,111127516,XM_022472727.1,uncharacterized LOC111127516,1556
NC_035782.1,51288664,51298706,51288664,51298706,111127518,XM_022472730.1,uncharacterized LOC111127518,10042
NC_035782.1,7115763,7127719,7115763,7116773,111127519,XM_022472731.1,uncharacterized LOC111127519,1010
NC_035782.1,7115763,7127719,7115763,7127719,111127519,XM_022472732.1,uncharacterized LOC111127519,11956
NC_035782.1,44337090,44358490,44337090,44358490,111127521,XM_022472734.1,uncharacterized LOC111127521,21400
NC_035782.1,35285832,35295171,35285832,35295171,111127523,XM_022472737.1,uncharacterized LOC111127523,9339
NC_035782.1,4920626,4921389,4920626,4921389,111127526,XM_022472740.1,uncharacterized LOC111127526,763
NC_035782.1,42524477,42526786,42524477,42526786,111127530,XM_022472742.1,uncharacterized LOC111127530,2309
NC_035782.1,29356392,29358871,29356837,29358871,111127533,XM_022472746.1,uncharacterized LOC111127533,2034
NC_035782.1,29356392,29358871,29356392,29358871,111127533,XM_022472747.1,uncharacterized LOC111127533,2479
NC_035782.1,64030926,64032192,64030926,64032192,111127537,XM_022472749.1,uncharacterized LOC111127537,1266
NC_035780.1,56429838,56436673,56429838,56436673,111127538,XM_022472754.1,uncharacterized LOC111127538,6835
NC_035782.1,69355401,69361214,69355401,69361214,111127540,XM_022472753.1,uncharacterized LOC111127540,5813
NC_035782.1,74846740,74849462,74846740,74849462,111127541,XM_022472755.1,uncharacterized LOC111127541,2722
NC_035782.1,5249393,5250277,5249393,5250277,111127543,XM_022472758.1,uncharacterized LOC111127543,884
NC_035782.1,5117359,5118624,5117359,5118624,111127544,XM_022472759.1,uncharacterized LOC111127544,1265
NC_035782.1,5131870,5133134,5131870,5133134,111127545,XM_022472760.1,uncharacterized LOC111127545,1264
NC_035782.1,5092414,5095221,5092414,5095221,111127546,XM_022472761.1,uncharacterized LOC111127546,2807
NC_035780.1,56423299,56426155,56423299,56426155,111127547,XM_022472766.1,uncharacterized LOC111127547,2856
NC_035780.1,56408575,56414782,56408575,56414782,111127554,XM_022472778.1,uncharacterized LOC111127554,6207
NC_035782.1,5288414,5324274,5288414,5324274,111127556,XM_022472776.1,uncharacterized LOC111127556,35860
NC_035782.1,57126308,57139651,57126308,57139651,111127559,XM_022472779.1,uncharacterized LOC111127559,13343
NC_035782.1,29987080,29988812,29987080,29988812,111127560,XM_022472780.1,uncharacterized LOC111127560,1732
NC_035782.1,5444013,5445230,5444013,5445230,111127564,XM_022472784.1,uncharacterized LOC111127564,1217
NC_035782.1,37955025,37962982,37955025,37962982,111127565,XM_022472785.1,uncharacterized LOC111127565,7957
NC_035782.1,17789934,17794589,17789934,17794589,111127568,XM_022472787.1,uncharacterized LOC111127568,4655
NC_035782.1,17487211,17496018,17487211,17496018,111127572,XM_022472795.1,uncharacterized LOC111127572,8807
NC_035782.1,17859837,17868671,17859837,17868671,111127573,XM_022472796.1,uncharacterized LOC111127573,8834
NC_035782.1,18053131,18057350,18053131,18057350,111127577,XM_022472802.1,uncharacterized LOC111127577,4219
NC_035782.1,18058203,18063153,18058203,18063153,111127578,XM_022472803.1,uncharacterized LOC111127578,4950
NC_035782.1,18046389,18051601,18046389,18051601,111127579,XM_022472804.1,uncharacterized LOC111127579,5212
NC_035782.1,17681534,17686353,17681534,17686353,111127580,XM_022472805.1,uncharacterized LOC111127580,4819
NC_035782.1,17696488,17707100,17696488,17707100,111127591,XM_022472830.1,uncharacterized LOC111127591,10612
NC_035782.1,17696488,17707100,17701358,17707100,111127591,XM_022472829.1,uncharacterized LOC111127591,5742
NC_035782.1,18060394,18073272,18060394,18073272,111127592,XM_022472833.1,uncharacterized LOC111127592,12878
NC_035782.1,18060394,18073272,18065266,18073272,111127592,XM_022472831.1,uncharacterized LOC111127592,8006
NC_035782.1,17819968,17822487,17819968,17822485,111127594,XM_022472836.1,uncharacterized LOC111127594,2517
NC_035782.1,17819968,17822487,17819968,17822487,111127594,XM_022472837.1,uncharacterized LOC111127594,2519
NC_035782.1,17445915,17449624,17445915,17449623,111127595,XM_022472838.1,uncharacterized LOC111127595,3708
NC_035782.1,17445915,17449624,17445915,17449624,111127595,XM_022472839.1,uncharacterized LOC111127595,3709
NC_035782.1,17387646,17393551,17387647,17393551,111127598,XM_022472843.1,uncharacterized LOC111127598,5904
NC_035782.1,17387646,17393551,17387646,17393551,111127598,XM_022472844.1,uncharacterized LOC111127598,5905
NC_035782.1,17759569,17767322,17759569,17767322,111127599,XM_022472845.1,uncharacterized LOC111127599,7753
NC_035782.1,17750698,17759355,17750698,17759355,111127600,XM_022472846.1,uncharacterized LOC111127600,8657
NC_035780.1,56367732,56371708,56370107,56371708,111127602,XM_022472870.1,uncharacterized LOC111127602,1601
NC_035780.1,56367732,56371708,56368407,56371708,111127602,XM_022472854.1,uncharacterized LOC111127602,3301
NC_035780.1,56367732,56371708,56367732,56371708,111127602,XM_022472864.1,uncharacterized LOC111127602,3976
NC_035782.1,17613541,17616416,17613541,17616416,111127616,XM_022472873.1,uncharacterized LOC111127616,2875
NC_035780.1,56371724,56377562,56371724,56377562,111127620,XM_022472883.1,uncharacterized LOC111127620,5838
NC_035782.1,17729263,17731023,17729263,17731023,111127621,XM_022472879.1,uncharacterized LOC111127621,1760
NC_035782.1,17720251,17723400,17720251,17723400,111127623,XM_022472884.1,uncharacterized LOC111127623,3149
NC_035782.1,71091598,71094893,71091598,71094893,111127624,XM_022472886.1,uncharacterized LOC111127624,3295
NC_035782.1,17726806,17728066,17726806,17728066,111127625,XM_022472887.1,uncharacterized LOC111127625,1260
NC_035782.1,17619627,17639227,17619627,17639227,111127626,XM_022472888.1,uncharacterized LOC111127626,19600
NC_035780.1,56403331,56407992,56403331,56407992,111127628,XM_022472890.1,uncharacterized LOC111127628,4661
NC_035782.1,73654093,73661516,73654093,73661268,111127633,XM_022472893.1,uncharacterized LOC111127633,7175
NC_035782.1,73654093,73661516,73654093,73661516,111127633,XM_022472892.1,uncharacterized LOC111127633,7423
NC_035782.1,19688982,19691487,19688982,19691487,111127637,XM_022472897.1,uncharacterized LOC111127637,2505
NC_035782.1,73312618,73320507,73312618,73320507,111127641,XM_022472900.1,uncharacterized LOC111127641,7889
NC_035782.1,29240742,29248934,29240747,29248934,111127643,XM_022472907.1,uncharacterized LOC111127643,8187
NC_035782.1,29240742,29248934,29240742,29248934,111127643,XM_022472908.1,uncharacterized LOC111127643,8192
NC_035782.1,5477428,5478075,5477428,5478075,111127648,XM_022472916.1,uncharacterized LOC111127648,647
NC_035782.1,38358684,38360826,38358684,38360485,111127649,XM_022472918.1,uncharacterized LOC111127649,1801
NC_035782.1,38358684,38360826,38358684,38360826,111127649,XM_022472917.1,uncharacterized LOC111127649,2142
NC_035780.1,56382385,56384587,56382385,56384587,111127651,XM_022472928.1,uncharacterized LOC111127651,2202
NC_035782.1,5489420,5503947,5489420,5503947,111127653,XM_022472932.1,uncharacterized LOC111127653,14527
NC_035782.1,32796005,32799587,32796005,32799587,111127654,XM_022472933.1,uncharacterized LOC111127654,3582
NC_035782.1,28289795,28307139,28290017,28307139,111127656,XM_022472937.1,uncharacterized LOC111127656,17122
NC_035782.1,28289795,28307139,28289796,28307139,111127656,XM_022472935.1,uncharacterized LOC111127656,17343
NC_035782.1,28289795,28307139,28289795,28307139,111127656,XM_022472936.1,uncharacterized LOC111127656,17344
NC_035780.1,17215145,17234187,17215145,17234187,111127657,XM_022472951.1,uncharacterized LOC111127657,19042
NC_035782.1,5512959,5514597,5512959,5514597,111127660,XM_022472940.1,uncharacterized LOC111127660,1638
NC_035782.1,12496408,12502401,12496408,12502401,111127665,XM_022472945.1,uncharacterized LOC111127665,5993
NC_035782.1,5522657,5523667,5522657,5523667,111127666,XM_022472946.1,uncharacterized LOC111127666,1010
NC_035782.1,59421782,59422919,59421782,59422919,111127667,XM_022472947.1,uncharacterized LOC111127667,1137
NC_035782.1,5715532,5729038,5715532,5729038,111127670,XM_022472950.1,uncharacterized LOC111127670,13506
NC_035783.1,55912274,55918040,55912274,55918040,111127721,XM_022472953.1,uncharacterized LOC111127721,5766
NC_035783.1,21202192,21203978,21202192,21203978,111127722,XM_022472954.1,uncharacterized LOC111127722,1786
NC_035783.1,21786606,21791208,21786606,21791207,111127726,XM_022472958.1,uncharacterized LOC111127726,4601
NC_035783.1,21786606,21791208,21786606,21791208,111127726,XM_022472957.1,uncharacterized LOC111127726,4602
NC_035780.1,40673621,40687137,40673648,40687137,111127733,XM_022472968.1,uncharacterized LOC111127733,13489
NC_035780.1,40673621,40687137,40673621,40687137,111127733,XM_022472975.1,uncharacterized LOC111127733,13516
NC_035783.1,46346595,46350703,46346595,46350703,111127736,XM_022472967.1,uncharacterized LOC111127736,4108
NC_035783.1,31236264,31249410,31236264,31249410,111127738,XM_022472970.1,uncharacterized LOC111127738,13146
NC_035783.1,6785126,6790809,6785126,6790809,111127739,XM_022472971.1,uncharacterized LOC111127739,5683
NC_035783.1,37711733,37721053,37711733,37721053,111127741,XM_022472972.1,uncharacterized LOC111127741,9320
NC_035783.1,19896522,19913491,19902622,19913491,111127744,XM_022472982.1,uncharacterized LOC111127744,10869
NC_035783.1,19896522,19913491,19902548,19913491,111127744,XM_022472981.1,uncharacterized LOC111127744,10943
NC_035783.1,19896522,19913491,19896522,19909381,111127744,XM_022472984.1,uncharacterized LOC111127744,12859
NC_035783.1,19896522,19913491,19896522,19913491,111127744,XM_022472980.1,uncharacterized LOC111127744,16969
NC_035783.1,25640375,25687889,25640375,25682880,111127746,XM_022472985.1,uncharacterized LOC111127746,42505
NC_035783.1,25640375,25687889,25640375,25687889,111127746,XM_022472986.1,uncharacterized LOC111127746,47514
NC_035783.1,6941824,6951815,6941824,6951815,111127748,XM_022472987.1,uncharacterized LOC111127748,9991
NC_035783.1,6914232,6923191,6914232,6921965,111127749,XM_022472990.1,uncharacterized LOC111127749,7733
NC_035783.1,6914232,6923191,6914232,6923137,111127749,XM_022472989.1,uncharacterized LOC111127749,8905
NC_035783.1,6924603,6930486,6924603,6930486,111127750,XM_022472991.1,uncharacterized LOC111127750,5883
NC_035783.1,6930442,6934507,6930442,6934507,111127751,XM_022472992.1,uncharacterized LOC111127751,4065
NC_035783.1,24368986,24370779,24368986,24370779,111127775,XM_022473018.1,uncharacterized LOC111127775,1793
NC_035780.1,57213392,57225890,57213392,57225890,111127784,XM_022473034.1,uncharacterized LOC111127784,12498
NC_035783.1,8764174,8775647,8764174,8775647,111127789,XM_022473038.1,uncharacterized LOC111127789,11473
NC_035783.1,20472927,20478228,20472927,20478228,111127804,XM_022473054.1,uncharacterized LOC111127804,5301
NC_035783.1,20478654,20480483,20478664,20480483,111127805,XM_022473055.1,uncharacterized LOC111127805,1819
NC_035783.1,20478654,20480483,20478654,20480480,111127805,XM_022473056.1,uncharacterized LOC111127805,1826
NC_035783.1,1939659,1943415,1939660,1943415,111127806,XM_022473057.1,uncharacterized LOC111127806,3755
NC_035783.1,1939659,1943415,1939659,1943415,111127806,XM_022473059.1,uncharacterized LOC111127806,3756
NC_035783.1,53666884,53697114,53666885,53696910,111127810,XM_022473067.1,uncharacterized LOC111127810,30025
NC_035783.1,53666884,53697114,53666884,53696910,111127810,XM_022473069.1,uncharacterized LOC111127810,30026
NC_035783.1,53666884,53697114,53666885,53697114,111127810,XM_022473068.1,uncharacterized LOC111127810,30229
NC_035783.1,56452638,56531690,56452638,56531690,111127820,XM_022473077.1,uncharacterized LOC111127820,79052
NC_035783.1,39974503,39981151,39974503,39978272,111127821,XM_022473079.1,uncharacterized LOC111127821,3769
NC_035783.1,39974503,39981151,39974503,39981137,111127821,XM_022473080.1,uncharacterized LOC111127821,6634
NC_035783.1,39974503,39981151,39974503,39981151,111127821,XM_022473078.1,uncharacterized LOC111127821,6648
NC_035783.1,39967259,39971119,39967259,39971119,111127823,XM_022473082.1,uncharacterized LOC111127823,3860
NC_035783.1,1282263,1293051,1282263,1293051,111127824,XM_022473083.1,uncharacterized LOC111127824,10788
NC_035783.1,1282263,1293051,1283783,1293051,111127824,XM_022473084.1,uncharacterized LOC111127824,9268
NC_035783.1,52590123,52597305,52590123,52597305,111127829,XM_022473098.1,uncharacterized LOC111127829,7182
NC_035783.1,33948040,33959095,33948040,33959095,111127840,XM_022473112.1,uncharacterized LOC111127840,11055
NC_035783.1,42341439,42345734,42341439,42345734,111127842,XM_022473114.1,uncharacterized LOC111127842,4295
NC_035783.1,39461652,39468143,39461656,39468138,111127846,XM_022473119.1,uncharacterized LOC111127846,6482
NC_035783.1,39461652,39468143,39461656,39468140,111127846,XM_022473118.1,uncharacterized LOC111127846,6484
NC_035783.1,39461652,39468143,39461652,39468139,111127846,XM_022473120.1,uncharacterized LOC111127846,6487
NC_035783.1,50321710,50323828,50321710,50323828,111127847,XM_022473121.1,uncharacterized LOC111127847,2118
NC_035783.1,39791981,39794277,39791981,39794277,111127853,XM_022473136.1,uncharacterized LOC111127853,2296
NC_035783.1,59301718,59306978,59301718,59306978,111127854,XM_022473137.1,uncharacterized LOC111127854,5260
NC_035783.1,23004128,23020374,23004128,23020374,111127858,XM_022473144.1,uncharacterized LOC111127858,16246
NC_035783.1,8413997,8420842,8418274,8420842,111127860,XM_022473147.1,uncharacterized LOC111127860,2568
NC_035783.1,8413997,8420842,8413997,8420842,111127860,XM_022473148.1,uncharacterized LOC111127860,6845
NC_035783.1,35492749,35498188,35492749,35498188,111127861,XM_022473149.1,uncharacterized LOC111127861,5439
NC_035783.1,2813283,2815311,2813283,2815311,111127868,XM_022473159.1,uncharacterized LOC111127868,2028
NC_035783.1,13655003,13680178,13655003,13677990,111127870,XM_022473161.1,uncharacterized LOC111127870,22987
NC_035783.1,13655003,13680178,13655003,13680178,111127870,XM_022473160.1,uncharacterized LOC111127870,25175
NC_035780.1,54272143,54281366,54272143,54281366,111127875,XM_022473168.1,uncharacterized LOC111127875,9223
NC_035783.1,4348954,4355335,4348954,4354055,111127881,XM_022473180.1,uncharacterized LOC111127881,5101
NC_035783.1,4348954,4355335,4348954,4355335,111127881,XM_022473179.1,uncharacterized LOC111127881,6381
NC_035783.1,18215764,18217425,18215764,18217425,111127884,XM_022473184.1,uncharacterized LOC111127884,1661
NC_035783.1,32947186,32952183,32947186,32952183,111127887,XM_022473187.1,uncharacterized LOC111127887,4997
NC_035783.1,46316763,46320501,46317566,46320501,111127895,XM_022473194.1,uncharacterized LOC111127895,2935
NC_035783.1,46316763,46320501,46316763,46320498,111127895,XM_022473195.1,uncharacterized LOC111127895,3735
NC_035783.1,12934841,12937464,12934841,12937464,111127897,XM_022473197.1,uncharacterized LOC111127897,2623
NC_035780.1,54437497,54463301,54437497,54463300,111127899,XM_022473212.1,uncharacterized LOC111127899,25803
NC_035780.1,54437497,54463301,54453686,54463301,111127899,XM_022473203.1,uncharacterized LOC111127899,9615
NC_035783.1,45921322,45928061,45921322,45928061,111127900,XM_022473199.1,uncharacterized LOC111127900,6739
NC_035780.1,8336198,8339336,8336198,8339336,111127903,XM_022473248.1,uncharacterized LOC111127903,3138
NC_035783.1,43891749,43899014,43894236,43899014,111127908,XM_022473221.1,uncharacterized LOC111127908,4778
NC_035783.1,43891749,43899014,43894016,43899014,111127908,XM_022473219.1,uncharacterized LOC111127908,4998
NC_035783.1,43891749,43899014,43891749,43899014,111127908,XM_022473220.1,uncharacterized LOC111127908,7265
NC_035780.1,54350811,54393991,54382987,54393991,111127909,XM_022473236.1,uncharacterized LOC111127909,11004
NC_035780.1,54350811,54393991,54350811,54393991,111127909,XM_022473226.1,uncharacterized LOC111127909,43180
NC_035783.1,11912899,11920228,11912899,11920228,111127920,XM_022473250.1,uncharacterized LOC111127920,7329
NC_035780.1,54411377,54435360,54411377,54435360,111127925,XM_022473259.1,uncharacterized LOC111127925,23983
NC_035783.1,38737524,38739034,38737524,38739034,111127927,XM_022473257.1,uncharacterized LOC111127927,1510
NC_035783.1,10931872,10935843,10931872,10935843,111127943,XM_022473272.1,uncharacterized LOC111127943,3971
NC_035783.1,13165252,13166963,13165252,13166963,111127950,XM_022473279.1,uncharacterized LOC111127950,1711
NC_035783.1,15533362,15540996,15533362,15540994,111127951,XM_022473282.1,uncharacterized LOC111127951,7632
NC_035783.1,15533362,15540996,15533362,15540996,111127951,XM_022473281.1,uncharacterized LOC111127951,7634
NC_035783.1,31472076,31473427,31472076,31473427,111127957,XM_022473287.1,uncharacterized LOC111127957,1351
NC_035783.1,42181860,42186657,42181860,42186657,111127961,XM_022473290.1,uncharacterized LOC111127961,4797
NC_035783.1,21949469,21961178,21949469,21961178,111127968,XM_022473295.1,uncharacterized LOC111127968,11709
NC_035783.1,49711463,49713962,49711463,49713962,111127972,XM_022473300.1,uncharacterized LOC111127972,2499
NC_035783.1,8281703,8287886,8281703,8287886,111127984,XM_022473330.1,uncharacterized LOC111127984,6183
NC_035783.1,8105036,8113489,8105036,8113489,111127985,XM_022473331.1,uncharacterized LOC111127985,8453
NC_035783.1,8289734,8292329,8289734,8292115,111127988,XM_022473334.1,uncharacterized LOC111127988,2381
NC_035783.1,8289734,8292329,8289734,8292329,111127988,XM_022473335.1,uncharacterized LOC111127988,2595
NC_035783.1,8227332,8234207,8231627,8234207,111127991,XM_022473343.1,uncharacterized LOC111127991,2580
NC_035783.1,8227332,8234207,8231624,8234207,111127991,XM_022473341.1,uncharacterized LOC111127991,2583
NC_035783.1,8227332,8234207,8227332,8234207,111127991,XM_022473342.1,uncharacterized LOC111127991,6875
NC_035783.1,8196213,8200465,8196214,8200327,111127993,XM_022473348.1,uncharacterized LOC111127993,4113
NC_035783.1,8196213,8200465,8196214,8200425,111127993,XM_022473349.1,uncharacterized LOC111127993,4211
NC_035783.1,8196213,8200465,8196213,8200465,111127993,XM_022473350.1,uncharacterized LOC111127993,4252
NC_035783.1,8214794,8216861,8214794,8216861,111127996,XM_022473360.1,uncharacterized LOC111127996,2067
NC_035780.1,42577609,42631991,42577609,42631991,111128006,XM_022473376.1,uncharacterized LOC111128006,54382
NC_035783.1,8203969,8205052,8203969,8205052,111128011,XM_022473378.1,uncharacterized LOC111128011,1083
NC_035783.1,54068980,54073222,54068980,54073222,111128018,XM_022473384.1,uncharacterized LOC111128018,4242
NC_035780.1,19927722,19947091,19937028,19947091,111128027,XM_022473417.1,uncharacterized LOC111128027,10063
NC_035780.1,19927722,19947091,19936583,19947091,111128027,XM_022473408.1,uncharacterized LOC111128027,10508
NC_035780.1,19927722,19947091,19927722,19947091,111128027,XM_022473397.1,uncharacterized LOC111128027,19369
NC_035783.1,39522660,39525009,39522660,39525009,111128038,XM_022473429.1,uncharacterized LOC111128038,2349
NC_035783.1,38120387,38123231,38120387,38123231,111128039,XM_022473430.1,uncharacterized LOC111128039,2844
NC_035783.1,5537298,5546968,5537298,5546710,111128040,XM_022473432.1,uncharacterized LOC111128040,9412
NC_035783.1,5537298,5546968,5537303,5546801,111128040,XM_022473435.1,uncharacterized LOC111128040,9498
NC_035783.1,5537298,5546968,5537298,5546801,111128040,XM_022473433.1,uncharacterized LOC111128040,9503
NC_035783.1,5537298,5546968,5537304,5546968,111128040,XM_022473434.1,uncharacterized LOC111128040,9664
NC_035783.1,5537298,5546968,5537299,5546968,111128040,XM_022473431.1,uncharacterized LOC111128040,9669
NC_035783.1,57775665,57777893,57775665,57777893,111128049,XM_022473444.1,uncharacterized LOC111128049,2228
NC_035783.1,19963028,19965081,19963028,19965081,111128053,XM_022473450.1,uncharacterized LOC111128053,2053
NC_035783.1,4672081,4683300,4672081,4682482,111128056,XM_022473455.1,uncharacterized LOC111128056,10401
NC_035783.1,4672081,4683300,4672081,4683300,111128056,XM_022473453.1,uncharacterized LOC111128056,11219
NC_035783.1,11169373,11178297,11169373,11178297,111128066,XM_022473471.1,uncharacterized LOC111128066,8924
NC_035783.1,54219676,54223786,54219676,54223786,111128072,XM_022473484.1,uncharacterized LOC111128072,4110
NC_035783.1,13302178,13307722,13302179,13305410,111128074,XM_022473490.1,uncharacterized LOC111128074,3231
NC_035783.1,13302178,13307722,13302180,13306816,111128074,XM_022473488.1,uncharacterized LOC111128074,4636
NC_035783.1,13302178,13307722,13302180,13307555,111128074,XM_022473489.1,uncharacterized LOC111128074,5375
NC_035783.1,13302178,13307722,13302178,13307722,111128074,XM_022473487.1,uncharacterized LOC111128074,5544
NC_035783.1,33123293,33139357,33123293,33136066,111128079,XM_022473495.1,uncharacterized LOC111128079,12773
NC_035783.1,33123293,33139357,33123293,33139357,111128079,XM_022473493.1,uncharacterized LOC111128079,16064
NC_035783.1,905486,911054,905486,911054,111128081,XM_022473498.1,uncharacterized LOC111128081,5568
NC_035783.1,46328607,46332086,46328607,46332086,111128083,XM_022473509.1,uncharacterized LOC111128083,3479
NC_035783.1,45221011,45224364,45221011,45224364,111128086,XM_022473526.1,uncharacterized LOC111128086,3353
NC_035783.1,5463778,5465874,5463778,5465874,111128089,XM_022473529.1,uncharacterized LOC111128089,2096
NC_035783.1,4373861,4376851,4373861,4376851,111128104,XM_022473558.1,uncharacterized LOC111128104,2990
NC_035783.1,2145813,2166308,2145813,2166308,111128106,XM_022473560.1,uncharacterized LOC111128106,20495
NC_035783.1,38479207,38486344,38483544,38486344,111128112,XM_022473568.1,uncharacterized LOC111128112,2800
NC_035783.1,38479207,38486344,38479207,38486344,111128112,XM_022473569.1,uncharacterized LOC111128112,7137
NC_035783.1,4176108,4177876,4176108,4177876,111128126,XM_022473588.1,uncharacterized LOC111128126,1768
NC_035783.1,9631537,9636339,9631994,9636339,111128129,XM_022473591.1,uncharacterized LOC111128129,4345
NC_035783.1,22581326,22593842,22581326,22593842,111128135,XM_022473600.1,uncharacterized LOC111128135,12516
NC_035783.1,30460542,30463283,30460542,30463283,111128137,XM_022473602.1,uncharacterized LOC111128137,2741
NC_035783.1,6910038,6911806,6910038,6911806,111128138,XM_022473603.1,uncharacterized LOC111128138,1768
NC_035783.1,58121336,58124690,58121336,58124690,111128144,XM_022473609.1,uncharacterized LOC111128144,3354
NC_035780.1,33535369,33542335,33535387,33542335,111128149,XM_022473621.1,uncharacterized LOC111128149,6948
NC_035780.1,33535369,33542335,33535369,33542335,111128149,XM_022473629.1,uncharacterized LOC111128149,6966
NC_035783.1,13998886,14012728,13998886,14012728,111128160,XM_022473634.1,uncharacterized LOC111128160,13842
NC_035783.1,17289597,17292480,17289597,17292480,111128161,XM_022473637.1,uncharacterized LOC111128161,2883
NC_035783.1,19110478,19112331,19110478,19112331,111128170,XM_022473646.1,uncharacterized LOC111128170,1853
NC_035783.1,27336597,27346935,27336597,27346935,111128173,XM_022473647.1,uncharacterized LOC111128173,10338
NC_035783.1,36835,43827,36835,43827,111128174,XM_022473648.1,uncharacterized LOC111128174,6992
NC_035783.1,14752335,14754846,14752606,14754846,111128177,XM_022473652.1,uncharacterized LOC111128177,2240
NC_035783.1,14752335,14754846,14752335,14754846,111128177,XM_022473653.1,uncharacterized LOC111128177,2511
NC_035783.1,8802322,8806385,8802322,8805924,111128179,XM_022473655.1,uncharacterized LOC111128179,3602
NC_035783.1,8802322,8806385,8802322,8806385,111128179,XM_022473656.1,uncharacterized LOC111128179,4063
NC_035783.1,61894,81508,61894,81508,111128180,XM_022473658.1,uncharacterized LOC111128180,19614
NC_035783.1,57203974,57214333,57203974,57214040,111128182,XM_022473663.1,uncharacterized LOC111128182,10066
NC_035783.1,57203974,57214333,57203974,57214333,111128182,XM_022473665.1,uncharacterized LOC111128182,10359
NC_035783.1,57203974,57214333,57203974,57210453,111128182,XM_022473662.1,uncharacterized LOC111128182,6479
NC_035783.1,57203974,57214333,57203974,57210914,111128182,XM_022473660.1,uncharacterized LOC111128182,6940
NC_035783.1,57203974,57214333,57203974,57211148,111128182,XM_022473661.1,uncharacterized LOC111128182,7174
NC_035783.1,57194914,57199397,57194914,57197337,111128183,XM_022473667.1,uncharacterized LOC111128183,2423
NC_035783.1,57194914,57199397,57194914,57199239,111128183,XM_022473666.1,uncharacterized LOC111128183,4325
NC_035783.1,57194914,57199397,57194914,57199397,111128183,XM_022473668.1,uncharacterized LOC111128183,4483
NC_035783.1,86770,97562,86770,97562,111128187,XM_022473672.1,uncharacterized LOC111128187,10792
NC_035783.1,6072631,6075619,6072631,6075619,111128190,XM_022473674.1,uncharacterized LOC111128190,2988
NC_035783.1,98293,100443,98293,100443,111128191,XM_022473675.1,uncharacterized LOC111128191,2150
NC_035783.1,33994169,33998319,33994169,33998319,111128197,XM_022473687.1,uncharacterized LOC111128197,4150
NC_035783.1,55319072,55332325,55319072,55332325,111128198,XM_022473688.1,uncharacterized LOC111128198,13253
NC_035783.1,36428431,36436583,36428431,36436583,111128199,XM_022473689.1,uncharacterized LOC111128199,8152
NC_035783.1,6711045,6713809,6711045,6713809,111128200,XM_022473690.1,uncharacterized LOC111128200,2764
NC_035783.1,155477,156949,155477,156949,111128201,XM_022473691.1,uncharacterized LOC111128201,1472
NC_035783.1,157002,159134,157002,159134,111128204,XM_022473695.1,uncharacterized LOC111128204,2132
NC_035783.1,21080691,21095117,21080691,21095117,111128213,XM_022473714.1,uncharacterized LOC111128213,14426
NC_035783.1,325830,347397,325830,347397,111128217,XM_022473720.1,uncharacterized LOC111128217,21567
NC_035783.1,52841609,52843463,52841609,52843463,111128218,XM_022473721.1,uncharacterized LOC111128218,1854
NC_035783.1,37109543,37113921,37109543,37111437,111128219,XM_022473722.1,uncharacterized LOC111128219,1894
NC_035783.1,37109543,37113921,37109543,37113921,111128219,XM_022473723.1,uncharacterized LOC111128219,4378
NC_035783.1,39570513,39573523,39570513,39571779,111128224,XM_022473727.1,uncharacterized LOC111128224,1266
NC_035783.1,39570513,39573523,39570513,39573523,111128224,XM_022473728.1,uncharacterized LOC111128224,3010
NC_035783.1,39573242,39575320,39573242,39575320,111128225,XM_022473729.1,uncharacterized LOC111128225,2078
NC_035783.1,568240,572107,568240,572107,111128230,XM_022473737.1,uncharacterized LOC111128230,3867
NC_035783.1,36092715,36099310,36092715,36099310,111128237,XM_022473744.1,uncharacterized LOC111128237,6595
NC_035783.1,9611752,9615761,9611753,9615761,111128241,XM_022473747.1,uncharacterized LOC111128241,4008
NC_035783.1,9611752,9615761,9611752,9615761,111128241,XM_022473748.1,uncharacterized LOC111128241,4009
NC_035780.1,6479778,6493047,6479778,6493047,111128242,XM_022473772.1,uncharacterized LOC111128242,13269
NC_035780.1,6479778,6493047,6485306,6488617,111128242,XM_022473763.1,uncharacterized LOC111128242,3311
NC_035780.1,6479778,6493047,6479778,6488498,111128242,XM_022473752.1,uncharacterized LOC111128242,8720
NC_035783.1,977427,985552,977427,985552,111128243,XM_022473749.1,uncharacterized LOC111128243,8125
NC_035783.1,16639999,16643231,16639999,16643231,111128246,XM_022473774.1,uncharacterized LOC111128246,3232
NC_035783.1,27930679,27933417,27930679,27933417,111128247,XM_022473775.1,uncharacterized LOC111128247,2738
NC_035783.1,1064714,1077042,1064714,1077042,111128249,XM_022473777.1,uncharacterized LOC111128249,12328
NC_035780.1,6516411,6520870,6516411,6520870,111128251,XM_022473783.1,uncharacterized LOC111128251,4459
NC_035783.1,1082615,1093178,1082615,1093178,111128257,XM_022473791.1,uncharacterized LOC111128257,10563
NC_035783.1,1122144,1128972,1122144,1128972,111128264,XM_022473800.1,uncharacterized LOC111128264,6828
NC_035780.1,6566125,6570345,6566143,6570345,111128267,XM_022473817.1,uncharacterized LOC111128267,4202
NC_035780.1,6566125,6570345,6566125,6570345,111128267,XM_022473809.1,uncharacterized LOC111128267,4220
NC_035783.1,1147511,1150942,1147511,1150942,111128271,XM_022473814.1,uncharacterized LOC111128271,3431
NC_035783.1,1158787,1173850,1158787,1173850,111128272,XM_022473815.1,uncharacterized LOC111128272,15063
NC_035783.1,1213576,1221679,1213576,1221679,111128275,XM_022473818.1,uncharacterized LOC111128275,8103
NC_035783.1,1614737,1630979,1614737,1630979,111128281,XM_022473829.1,uncharacterized LOC111128281,16242
NC_035780.1,6600411,6604956,6600412,6604956,111128293,XM_022473848.1,uncharacterized LOC111128293,4544
NC_035780.1,6600411,6604956,6600411,6604956,111128293,XM_022473855.1,uncharacterized LOC111128293,4545
NC_035783.1,1541824,1552597,1541824,1552597,111128294,XM_022473850.1,uncharacterized LOC111128294,10773
NC_035783.1,43692006,43696010,43692006,43696010,111128295,XM_022473851.1,uncharacterized LOC111128295,4004
NC_035783.1,25377033,25378733,25377033,25378733,111128298,XM_022473853.1,uncharacterized LOC111128298,1700
NC_035783.1,25403416,25404914,25403416,25404914,111128299,XM_022473854.1,uncharacterized LOC111128299,1498
NC_035783.1,40535508,40539653,40535508,40539653,111128301,XM_022473856.1,uncharacterized LOC111128301,4145
NC_035780.1,6593639,6595665,6593639,6595665,111128306,XM_022473867.1,uncharacterized LOC111128306,2026
NC_035783.1,1710224,1715172,1710224,1715172,111128307,XM_022473864.1,uncharacterized LOC111128307,4948
NC_035780.1,6581579,6583787,6581579,6583787,111128314,XM_022473881.1,uncharacterized LOC111128314,2208
NC_035780.1,6536379,6539633,6536434,6539633,111128319,XM_022473902.1,uncharacterized LOC111128319,3199
NC_035780.1,6536379,6539633,6536379,6539633,111128319,XM_022473893.1,uncharacterized LOC111128319,3254
NC_035783.1,12861184,12865582,12861184,12865582,111128322,XM_022473894.1,uncharacterized LOC111128322,4398
NC_035783.1,6009306,6018452,6009306,6018452,111128325,XM_022473898.1,uncharacterized LOC111128325,9146
NC_035783.1,38730235,38733092,38730732,38733092,111128326,XM_022473900.1,uncharacterized LOC111128326,2360
NC_035783.1,38730235,38733092,38730235,38733092,111128326,XM_022473899.1,uncharacterized LOC111128326,2857
NC_035783.1,11068901,11077155,11068901,11077155,111128330,XM_022473905.1,uncharacterized LOC111128330,8254
NC_035783.1,2449017,2450634,2449017,2450634,111128331,XM_022473906.1,uncharacterized LOC111128331,1617
NC_035783.1,2504412,2507039,2504412,2507039,111128333,XM_022473908.1,uncharacterized LOC111128333,2627
NC_035783.1,2377128,2380376,2377128,2380376,111128341,XM_022473914.1,uncharacterized LOC111128341,3248
NC_035783.1,2371525,2377258,2371525,2377258,111128342,XM_022473915.1,uncharacterized LOC111128342,5733
NC_035783.1,2808521,2810318,2808521,2810318,111128343,XM_022473917.1,uncharacterized LOC111128343,1797
NC_035783.1,20392466,20396676,20392466,20396676,111128348,XM_022473921.1,uncharacterized LOC111128348,4210
NC_035783.1,17652688,17667348,17652689,17667348,111128350,XM_022473932.1,uncharacterized LOC111128350,14659
NC_035783.1,17652688,17667348,17652688,17667348,111128350,XM_022473929.1,uncharacterized LOC111128350,14660
NC_035783.1,2946084,2950073,2946084,2950073,111128353,XM_022473933.1,uncharacterized LOC111128353,3989
NC_035783.1,1552590,1585780,1552590,1585780,111128354,XM_022473934.1,uncharacterized LOC111128354,33190
NC_035783.1,21486393,21492914,21486393,21492914,111128355,XM_022473936.1,uncharacterized LOC111128355,6521
NC_035783.1,3070191,3072187,3070191,3072187,111128357,XM_022473937.1,uncharacterized LOC111128357,1996
NC_035783.1,3215640,3216684,3215640,3216684,111128362,XM_022473946.1,uncharacterized LOC111128362,1044
NC_035783.1,56952742,56954090,56952742,56954090,111128363,XM_022473947.1,uncharacterized LOC111128363,1348
NC_035783.1,4166532,4173671,4166532,4173671,111128367,XM_022473951.1,uncharacterized LOC111128367,7139
NC_035783.1,4151930,4163294,4151930,4163181,111128368,XM_022473953.1,uncharacterized LOC111128368,11251
NC_035783.1,4151930,4163294,4151930,4163294,111128368,XM_022473952.1,uncharacterized LOC111128368,11364
NC_035783.1,53864926,53868278,53864926,53868278,111128375,XM_022473963.1,uncharacterized LOC111128375,3352
NC_035783.1,4668049,4670991,4668049,4670991,111128389,XM_022473977.1,uncharacterized LOC111128389,2942
NC_035783.1,4091106,4094000,4091106,4094000,111128392,XM_022473980.1,uncharacterized LOC111128392,2894
NC_035783.1,46778331,46780144,46778331,46780144,111128394,XM_022473982.1,uncharacterized LOC111128394,1813
NC_035783.1,18603210,18670887,18603210,18670887,111128400,XM_022473994.1,uncharacterized LOC111128400,67677
NC_035783.1,42408161,42411398,42408161,42411398,111128406,XM_022474003.1,uncharacterized LOC111128406,3237
NC_035783.1,33374421,33394738,33374421,33394738,111128416,XM_022474012.1,uncharacterized LOC111128416,20317
NC_035783.1,16619645,16623070,16619645,16623070,111128417,XM_022474013.1,uncharacterized LOC111128417,3425
NC_035783.1,30099894,30101704,30099894,30101704,111128426,XM_022474027.1,uncharacterized LOC111128426,1810
NC_035780.1,15510186,15520004,15510186,15520004,111128427,XM_022474031.1,uncharacterized LOC111128427,9818
NC_035783.1,14745306,14748710,14745306,14748710,111128428,XM_022474028.1,uncharacterized LOC111128428,3404
NC_035783.1,47885850,47906939,47885850,47906939,111128433,XM_022474037.1,uncharacterized LOC111128433,21089
NC_035783.1,5402507,5419719,5402507,5419719,111128435,XM_022474038.1,uncharacterized LOC111128435,17212
NC_035780.1,32508503,32663844,32508503,32663844,111128436,XM_022474048.1,uncharacterized LOC111128436,155341
NC_035780.1,32508503,32663844,32637399,32663844,111128436,XM_022474055.1,uncharacterized LOC111128436,26445
NC_035783.1,58531490,58534331,58531490,58534331,111128438,XM_022474042.1,uncharacterized LOC111128438,2841
NC_035783.1,51193244,51269232,51198305,51269232,111128440,XM_022474046.1,uncharacterized LOC111128440,70927
NC_035783.1,51193244,51269232,51193244,51269232,111128440,XM_022474045.1,uncharacterized LOC111128440,75988
NC_035783.1,5092158,5097229,5092158,5097229,111128445,XM_022474050.1,uncharacterized LOC111128445,5071
NC_035783.1,11242684,11250550,11242684,11245596,111128447,XM_022474052.1,uncharacterized LOC111128447,2912
NC_035783.1,11242684,11250550,11242684,11250550,111128447,XM_022474053.1,uncharacterized LOC111128447,7866
NC_035783.1,6990667,6995341,6990667,6995341,111128452,XM_022474064.1,uncharacterized LOC111128452,4674
NC_035783.1,7092651,7099332,7092651,7099332,111128456,XM_022474068.1,uncharacterized LOC111128456,6681
NC_035780.1,32621771,32624941,32621771,32624941,111128457,XM_022474072.1,uncharacterized LOC111128457,3170
NC_035783.1,7569089,7572886,7569089,7572886,111128466,XM_022474078.1,uncharacterized LOC111128466,3797
NC_035783.1,57140661,57147352,57140661,57147352,111128468,XM_022474079.1,uncharacterized LOC111128468,6691
NC_035783.1,36454167,36459076,36454167,36459073,111128472,XM_022474082.1,uncharacterized LOC111128472,4906
NC_035783.1,36454167,36459076,36454167,36459076,111128472,XM_022474084.1,uncharacterized LOC111128472,4909
NC_035783.1,2183499,2216703,2183499,2216703,111128477,XM_022474086.1,uncharacterized LOC111128477,33204
NC_035783.1,2219749,2239514,2221366,2239514,111128478,XM_022474087.1,uncharacterized LOC111128478,18148
NC_035783.1,2219749,2239514,2219749,2239514,111128478,XM_022474088.1,uncharacterized LOC111128478,19765
NC_035780.1,32489580,32492671,32489580,32492671,111128479,XM_022474091.1,uncharacterized LOC111128479,3091
NC_035783.1,14885544,14903060,14889237,14903060,111128497,XM_022474112.1,uncharacterized LOC111128497,13823
NC_035783.1,14885544,14903060,14885544,14891567,111128497,XM_022474111.1,uncharacterized LOC111128497,6023
NC_035783.1,14899077,14913423,14903098,14913423,111128498,XM_022474117.1,uncharacterized LOC111128498,10325
NC_035783.1,14899077,14913423,14899517,14913423,111128498,XM_022474118.1,uncharacterized LOC111128498,13906
NC_035783.1,14899077,14913423,14899513,14913423,111128498,XM_022474114.1,uncharacterized LOC111128498,13910
NC_035783.1,14899077,14913423,14899077,14913423,111128498,XM_022474116.1,uncharacterized LOC111128498,14346
NC_035783.1,14899077,14913423,14906470,14913423,111128498,XM_022474115.1,uncharacterized LOC111128498,6953
NC_035783.1,40131183,40135370,40131183,40135365,111128504,XM_022474128.1,uncharacterized LOC111128504,4182
NC_035783.1,40131183,40135370,40131183,40135370,111128504,XM_022474127.1,uncharacterized LOC111128504,4187
NC_035783.1,56870675,56874033,56870736,56874033,111128513,XM_022474141.1,uncharacterized LOC111128513,3297
NC_035783.1,48576140,48579868,48576140,48579868,111128525,XM_022474159.1,uncharacterized LOC111128525,3728
NC_035783.1,39248752,39252164,39248752,39252141,111128528,XM_022474164.1,uncharacterized LOC111128528,3389
NC_035783.1,39248752,39252164,39248752,39252164,111128528,XM_022474163.1,uncharacterized LOC111128528,3412
NC_035780.1,32640627,32646784,32640627,32646784,111128532,XM_022474173.1,uncharacterized LOC111128532,6157
NC_035783.1,32284743,32305940,32284743,32305940,111128535,XM_022474186.1,uncharacterized LOC111128535,21197
NC_035783.1,31969849,31990681,31969849,31990681,111128536,XM_022474190.1,uncharacterized LOC111128536,20832
NC_035783.1,31879658,31896741,31879658,31896741,111128537,XM_022474191.1,uncharacterized LOC111128537,17083
NC_035783.1,31879658,31896741,31879658,31887303,111128537,XM_022474193.1,uncharacterized LOC111128537,7645
NC_035783.1,31879658,31896741,31879658,31887304,111128537,XM_022474192.1,uncharacterized LOC111128537,7646
NC_035780.1,32632782,32633612,32632782,32633612,111128547,XM_022474214.1,uncharacterized LOC111128547,830
NC_035783.1,4095322,4107799,4095322,4107799,111128566,XM_022474245.1,uncharacterized LOC111128566,12477
NC_035783.1,4129816,4143311,4129816,4143311,111128567,XM_022474246.1,uncharacterized LOC111128567,13495
NC_035783.1,46774825,46776620,46774825,46776620,111128577,XM_022474255.1,uncharacterized LOC111128577,1795
NC_035780.1,32306897,32310879,32306897,32310879,111128583,XM_022474285.1,uncharacterized LOC111128583,3982
NC_035783.1,4884737,4901103,4884810,4901103,111128586,XM_022474290.1,uncharacterized LOC111128586,16293
NC_035783.1,4884737,4901103,4884739,4901103,111128586,XM_022474289.1,uncharacterized LOC111128586,16364
NC_035783.1,4884737,4901103,4884737,4901103,111128586,XM_022474288.1,uncharacterized LOC111128586,16366
NC_035783.1,9834983,9837382,9834983,9837382,111128587,XM_022474291.1,uncharacterized LOC111128587,2399
NC_035783.1,51908201,51911577,51908201,51911577,111128595,XM_022474310.1,uncharacterized LOC111128595,3376
NC_035783.1,10200889,10204829,10200889,10204829,111128597,XM_022474313.1,uncharacterized LOC111128597,3940
NC_035783.1,10334953,10336965,10334953,10336965,111128601,XM_022474324.1,uncharacterized LOC111128601,2012
NC_035783.1,14058067,14061484,14058067,14061355,111128603,XM_022474328.1,uncharacterized LOC111128603,3288
NC_035783.1,14058067,14061484,14058067,14061484,111128603,XM_022474327.1,uncharacterized LOC111128603,3417
NC_035783.1,4995952,4998452,4995952,4998452,111128604,XM_022474329.1,uncharacterized LOC111128604,2500
NC_035780.1,25151126,25165178,25151126,25162414,111128605,XM_022474351.1,uncharacterized LOC111128605,11288
NC_035780.1,25151126,25165178,25151126,25163231,111128605,XM_022474360.1,uncharacterized LOC111128605,12105
NC_035780.1,25151126,25165178,25151126,25165178,111128605,XM_022474335.1,uncharacterized LOC111128605,14052
NC_035783.1,21730353,21733137,21730353,21733137,111128606,XM_022474331.1,uncharacterized LOC111128606,2784
NC_035783.1,13684644,13724539,13684644,13724539,111128608,XM_022474337.1,uncharacterized LOC111128608,39895
NC_035783.1,11802970,11805051,11802970,11805051,111128609,XM_022474338.1,uncharacterized LOC111128609,2081
NC_035783.1,50519820,50530595,50519820,50530595,111128610,XM_022474339.1,uncharacterized LOC111128610,10775
NC_035783.1,10430918,10432860,10430918,10432860,111128612,XM_022474342.1,uncharacterized LOC111128612,1942
NC_035783.1,58913171,58917553,58913171,58917553,111128614,XM_022474345.1,uncharacterized LOC111128614,4382
NC_035783.1,58986501,58990336,58986501,58990336,111128615,XM_022474346.1,uncharacterized LOC111128615,3835
NC_035783.1,58715364,58737539,58715364,58737539,111128616,XM_022474347.1,uncharacterized LOC111128616,22175
NC_035783.1,58665216,58670173,58665528,58670173,111128623,XM_022474359.1,uncharacterized LOC111128623,4645
NC_035783.1,58665216,58670173,58665216,58670173,111128623,XM_022474357.1,uncharacterized LOC111128623,4957
NC_035783.1,59043058,59053247,59043058,59053220,111128624,XM_022474362.1,uncharacterized LOC111128624,10162
NC_035783.1,59043058,59053247,59043062,59053247,111128624,XM_022474361.1,uncharacterized LOC111128624,10185
NC_035783.1,58743732,58753674,58743732,58753674,111128634,XM_022474373.1,uncharacterized LOC111128634,9942
NC_035783.1,45282140,45297750,45282140,45297750,111128639,XM_022474376.1,uncharacterized LOC111128639,15610
NC_035783.1,58240373,58248043,58240373,58243700,111128643,XM_022474384.1,uncharacterized LOC111128643,3327
NC_035783.1,58240373,58248043,58240373,58248043,111128643,XM_022474383.1,uncharacterized LOC111128643,7670
NC_035783.1,4587646,4601739,4587650,4601737,111128644,XM_022474386.1,uncharacterized LOC111128644,14087
NC_035783.1,4587646,4601739,4587646,4601739,111128644,XM_022474387.1,uncharacterized LOC111128644,14093
NC_035783.1,39001904,39041924,39001904,39041727,111128648,XM_022474393.1,uncharacterized LOC111128648,39823
NC_035783.1,39001904,39041924,39001905,39041924,111128648,XM_022474394.1,uncharacterized LOC111128648,40019
NC_035783.1,39001904,39041924,39001904,39041924,111128648,XM_022474392.1,uncharacterized LOC111128648,40020
NC_035783.1,10440711,10441256,10440711,10441256,111128655,XM_022474401.1,uncharacterized LOC111128655,545
NC_035783.1,8387338,8391177,8387338,8391051,111128656,XM_022474402.1,uncharacterized LOC111128656,3713
NC_035783.1,8387338,8391177,8387338,8391161,111128656,XM_022474403.1,uncharacterized LOC111128656,3823
NC_035783.1,8387338,8391177,8387338,8391177,111128656,XM_022474405.1,uncharacterized LOC111128656,3839
NC_035783.1,21632932,21682043,21632932,21682043,111128657,XM_022474407.1,uncharacterized LOC111128657,49111
NC_035783.1,21605504,21611998,21605504,21611998,111128661,XM_022474416.1,uncharacterized LOC111128661,6494
NC_035783.1,10443601,10446924,10443601,10446924,111128662,XM_022474417.1,uncharacterized LOC111128662,3323
NC_035783.1,16378577,16382636,16378577,16379794,111128663,XM_022474419.1,uncharacterized LOC111128663,1217
NC_035783.1,16378577,16382636,16378577,16382636,111128663,XM_022474418.1,uncharacterized LOC111128663,4059
NC_035783.1,16381989,16386602,16381989,16386602,111128664,XM_022474420.1,uncharacterized LOC111128664,4613
NC_035783.1,10446993,10448804,10446993,10448804,111128667,XM_022474423.1,uncharacterized LOC111128667,1811
NC_035783.1,4046162,4061889,4046990,4061889,111128668,XM_022474425.1,uncharacterized LOC111128668,14899
NC_035783.1,4046162,4061889,4046162,4061889,111128668,XM_022474424.1,uncharacterized LOC111128668,15727
NC_035783.1,15345888,15352345,15345888,15352345,111128669,XM_022474426.1,uncharacterized LOC111128669,6457
NC_035783.1,15352775,15357469,15352775,15357469,111128670,XM_022474427.1,uncharacterized LOC111128670,4694
NC_035783.1,2247485,2255090,2247485,2255090,111128674,XM_022474431.1,uncharacterized LOC111128674,7605
NC_035783.1,12706875,12709156,12706875,12709156,111128677,XM_022474434.1,uncharacterized LOC111128677,2281
NC_035783.1,10675927,10793109,10675927,10793109,111128678,XM_022474436.1,uncharacterized LOC111128678,117182
NC_035783.1,41340697,41343335,41340697,41343335,111128680,XM_022474442.1,uncharacterized LOC111128680,2638
NC_035783.1,10796158,10810520,10796158,10810520,111128681,XM_022474443.1,uncharacterized LOC111128681,14362
NC_035780.1,62003504,62020300,62003504,62020300,111128689,XM_022474457.1,uncharacterized LOC111128689,16796
NC_035783.1,10814784,10844464,10814784,10844464,111128690,XM_022474455.1,uncharacterized LOC111128690,29680
NC_035783.1,58086106,58088522,58086106,58088522,111128701,XM_022474483.1,uncharacterized LOC111128701,2416
NC_035783.1,11254080,11265159,11254080,11265159,111128706,XM_022474490.1,uncharacterized LOC111128706,11079
NC_035783.1,37426816,37430416,37426816,37429009,111128713,XM_022474502.1,uncharacterized LOC111128713,2193
NC_035783.1,37426816,37430416,37426816,37430416,111128713,XM_022474499.1,uncharacterized LOC111128713,3600
NC_035783.1,11881278,11884119,11881278,11884119,111128716,XM_022474505.1,uncharacterized LOC111128716,2841
NC_035783.1,11910837,11912726,11910837,11912726,111128719,XM_022474506.1,uncharacterized LOC111128719,1889
NC_035783.1,1470617,1475520,1470617,1475520,111128720,XM_022474507.1,uncharacterized LOC111128720,4903
NC_035783.1,12985648,12998398,12985648,12995670,111128722,XM_022474518.1,uncharacterized LOC111128722,10022
NC_035783.1,12985648,12998398,12985648,12995677,111128722,XM_022474519.1,uncharacterized LOC111128722,10029
NC_035783.1,12985648,12998398,12985648,12995686,111128722,XM_022474517.1,uncharacterized LOC111128722,10038
NC_035783.1,12985648,12998398,12985648,12995687,111128722,XM_022474516.1,uncharacterized LOC111128722,10039
NC_035783.1,12985648,12998398,12985648,12998398,111128722,XM_022474523.1,uncharacterized LOC111128722,12750
NC_035783.1,12985648,12998398,12990623,12995507,111128722,XM_022474522.1,uncharacterized LOC111128722,4884
NC_035783.1,12985648,12998398,12990618,12995670,111128722,XM_022474521.1,uncharacterized LOC111128722,5052
NC_035783.1,12992511,13004596,12992511,13004596,111128723,XM_022474524.1,uncharacterized LOC111128723,12085
NC_035783.1,51890185,51902417,51890185,51902417,111128724,XM_022474525.1,uncharacterized LOC111128724,12232
NC_035783.1,42117760,42151548,42117760,42151548,111128726,XM_022474532.1,uncharacterized LOC111128726,33788
NC_035783.1,51621922,51654529,51621922,51654529,111128727,XM_022474533.1,uncharacterized LOC111128727,32607
NC_035783.1,51638047,51654529,51638047,51654529,111128728,XM_022474534.1,uncharacterized LOC111128728,16482
NC_035783.1,51697695,51714581,51697695,51714581,111128730,XM_022474535.1,uncharacterized LOC111128730,16886
NC_035783.1,12754604,12755401,12754604,12755401,111128732,XM_022474538.1,uncharacterized LOC111128732,797
NC_035783.1,14516819,14519631,14516819,14519631,111128733,XM_022474539.1,uncharacterized LOC111128733,2812
NC_035780.1,59421434,59422587,59421434,59422587,111128735,XM_022474548.1,uncharacterized LOC111128735,1153
NC_035783.1,1297616,1300241,1297616,1300241,111128750,XM_022474579.1,uncharacterized LOC111128750,2625
NC_035783.1,38171234,38174614,38171234,38172999,111128761,XM_022474597.1,uncharacterized LOC111128761,1765
NC_035783.1,38171234,38174614,38171234,38174614,111128761,XM_022474595.1,uncharacterized LOC111128761,3380
NC_035783.1,38169198,38171021,38169198,38170373,111128762,XM_022474600.1,uncharacterized LOC111128762,1175
NC_035783.1,38169198,38171021,38169676,38171021,111128762,XM_022474598.1,uncharacterized LOC111128762,1345
NC_035783.1,13757020,13786242,13757020,13786242,111128763,XM_022474601.1,uncharacterized LOC111128763,29222
NC_035783.1,39609332,39643624,39609332,39627530,111128771,XM_022474616.1,uncharacterized LOC111128771,18198
NC_035783.1,39609332,39643624,39609332,39643624,111128771,XM_022474617.1,uncharacterized LOC111128771,34292
NC_035783.1,12216771,12239904,12216771,12239904,111128772,XM_022474618.1,uncharacterized LOC111128772,23133
NC_035783.1,38545532,38555517,38545532,38555517,111128778,XM_022474621.1,uncharacterized LOC111128778,9985
NC_035783.1,14568380,14569348,14568380,14569348,111128779,XM_022474623.1,uncharacterized LOC111128779,968
NC_035783.1,5048401,5057559,5048401,5057559,111128780,XM_022474624.1,uncharacterized LOC111128780,9158
NC_035780.1,7349046,7353965,7349046,7353965,111128784,XM_022474630.1,uncharacterized LOC111128784,4919
NC_035783.1,43529022,43539080,43529022,43539080,111128786,XM_022474628.1,uncharacterized LOC111128786,10058
NC_035783.1,14634605,14660252,14634605,14660252,111128787,XM_022474629.1,uncharacterized LOC111128787,25647
NC_035783.1,35963527,35972036,35963527,35972036,111128796,XM_022474652.1,uncharacterized LOC111128796,8509
NC_035783.1,27015867,27021613,27015867,27021613,111128801,XM_022474663.1,uncharacterized LOC111128801,5746
NC_035783.1,19197405,19211934,19197405,19211934,111128803,XM_022474666.1,uncharacterized LOC111128803,14529
NC_035783.1,19197405,19211934,19198676,19207061,111128803,XM_022474676.1,uncharacterized LOC111128803,8385
NC_035783.1,19197405,19211934,19197405,19207061,111128803,XM_022474668.1,uncharacterized LOC111128803,9656
NC_035780.1,14312012,14313791,14312012,14313791,111128804,XM_022474672.1,uncharacterized LOC111128804,1779
NC_035783.1,15783669,15788210,15783669,15788210,111128806,XM_022474679.1,uncharacterized LOC111128806,4541
NC_035783.1,31694765,31696681,31694765,31696681,111128813,XM_022474688.1,uncharacterized LOC111128813,1916
NC_035783.1,29889176,29899003,29889176,29899003,111128819,XM_022474702.1,uncharacterized LOC111128819,9827
NC_035783.1,15845160,15849729,15845160,15849729,111128826,XM_022474714.1,uncharacterized LOC111128826,4569
NC_035783.1,16251016,16260721,16251016,16260721,111128830,XM_022474720.1,uncharacterized LOC111128830,9705
NC_035783.1,15975838,15981874,15975838,15981874,111128835,XM_022474726.1,uncharacterized LOC111128835,6036
NC_035783.1,16561332,16566971,16561332,16566971,111128841,XM_022474733.1,uncharacterized LOC111128841,5639
NC_035783.1,59182214,59193804,59182214,59193804,111128843,XM_022474737.1,uncharacterized LOC111128843,11590
NC_035783.1,20153332,20157177,20153332,20157177,111128846,XM_022474741.1,uncharacterized LOC111128846,3845
NC_035783.1,17010593,17011327,17010593,17011327,111128849,XM_022474744.1,uncharacterized LOC111128849,734
NC_035783.1,17691713,17694758,17691713,17694243,111128850,XM_022474746.1,uncharacterized LOC111128850,2530
NC_035783.1,17691713,17694758,17691714,17694758,111128850,XM_022474745.1,uncharacterized LOC111128850,3044
NC_035783.1,8464372,8474993,8464372,8474993,111128855,XM_022474750.1,uncharacterized LOC111128855,10621
NC_035783.1,33400418,33402891,33400418,33402891,111128860,XM_022474764.1,uncharacterized LOC111128860,2473
NC_035783.1,39737664,39763038,39737664,39763038,111128861,XM_022474765.1,uncharacterized LOC111128861,25374
NC_035783.1,39730907,39736179,39730907,39736179,111128862,XM_022474767.1,uncharacterized LOC111128862,5272
NC_035783.1,17020848,17022620,17020848,17022620,111128866,XM_022474772.1,uncharacterized LOC111128866,1772
NC_035783.1,17022652,17024817,17022652,17024817,111128867,XM_022474773.1,uncharacterized LOC111128867,2165
NC_035783.1,41442712,41466492,41442713,41459916,111128871,XM_022474788.1,uncharacterized LOC111128871,17203
NC_035783.1,41442712,41466492,41442713,41460586,111128871,XM_022474789.1,uncharacterized LOC111128871,17873
NC_035783.1,41442712,41466492,41444323,41464168,111128871,XM_022474783.1,uncharacterized LOC111128871,19845
NC_035783.1,41442712,41466492,41443480,41464168,111128871,XM_022474782.1,uncharacterized LOC111128871,20688
NC_035783.1,41442712,41466492,41443458,41464168,111128871,XM_022474780.1,uncharacterized LOC111128871,20710
NC_035783.1,41442712,41466492,41442713,41464168,111128871,XM_022474779.1,uncharacterized LOC111128871,21455
NC_035783.1,41442712,41466492,41442712,41464168,111128871,XM_022474778.1,uncharacterized LOC111128871,21456
NC_035783.1,41442712,41466492,41442713,41464659,111128871,XM_022474787.1,uncharacterized LOC111128871,21946
NC_035783.1,41442712,41466492,41442713,41466492,111128871,XM_022474784.1,uncharacterized LOC111128871,23779
NC_035780.1,13509626,13513929,13509626,13513929,111128872,XM_022474793.1,uncharacterized LOC111128872,4303
NC_035783.1,4729456,4732217,4729456,4732217,111128875,XM_022474796.1,uncharacterized LOC111128875,2761
NC_035783.1,41014054,41033860,41014054,41015383,111128876,XM_022474797.1,uncharacterized LOC111128876,1329
NC_035783.1,41014054,41033860,41014054,41027977,111128876,XM_022474798.1,uncharacterized LOC111128876,13923
NC_035783.1,41014054,41033860,41014054,41033860,111128876,XM_022474799.1,uncharacterized LOC111128876,19806
NC_035783.1,19347479,19371410,19347479,19371410,111128881,XM_022474811.1,uncharacterized LOC111128881,23931
NC_035783.1,37795639,37827442,37795639,37827442,111128882,XM_022474812.1,uncharacterized LOC111128882,31803
NC_035783.1,13574490,13584245,13574490,13584245,111128886,XM_022474833.1,uncharacterized LOC111128886,9755
NC_035783.1,13208443,13218939,13208443,13218939,111128890,XM_022474834.1,uncharacterized LOC111128890,10496
NC_035783.1,19717414,19723517,19717414,19723517,111128895,XM_022474839.1,uncharacterized LOC111128895,6103
NC_035783.1,9947370,9948742,9947370,9948742,111128903,XM_022474856.1,uncharacterized LOC111128903,1372
NC_035783.1,9952563,9954149,9952563,9954149,111128904,XM_022474857.1,uncharacterized LOC111128904,1586
NC_035780.1,45651426,45724129,45651427,45716717,111128905,XM_022474884.1,uncharacterized LOC111128905,65290
NC_035780.1,45651426,45724129,45651426,45724129,111128905,XM_022474869.1,uncharacterized LOC111128905,72703
NC_035783.1,5971289,5977060,5971289,5977060,111128912,XM_022474866.1,uncharacterized LOC111128912,5771
NC_035783.1,40675697,40686772,40675733,40686772,111128917,XM_022474876.1,uncharacterized LOC111128917,11039
NC_035783.1,40675697,40686772,40675698,40686772,111128917,XM_022474878.1,uncharacterized LOC111128917,11074
NC_035783.1,40675697,40686772,40675697,40686772,111128917,XM_022474875.1,uncharacterized LOC111128917,11075
NC_035783.1,1339118,1343018,1339118,1343018,111128918,XM_022474879.1,uncharacterized LOC111128918,3900
NC_035783.1,56013096,56026228,56013096,56026228,111128923,XM_022474885.1,uncharacterized LOC111128923,13132
NC_035783.1,14302173,14309605,14306805,14309605,111128928,XM_022474893.1,uncharacterized LOC111128928,2800
NC_035783.1,14302173,14309605,14306566,14309605,111128928,XM_022474891.1,uncharacterized LOC111128928,3039
NC_035783.1,14302173,14309605,14302173,14309605,111128928,XM_022474892.1,uncharacterized LOC111128928,7432
NC_035780.1,45648858,45651387,45648858,45651387,111128929,XM_022474896.1,uncharacterized LOC111128929,2529
NC_035783.1,17292561,17295034,17292561,17295034,111128956,XM_022474930.1,uncharacterized LOC111128956,2473
NC_035783.1,5998785,6002082,5998785,6002082,111128957,XM_022474932.1,uncharacterized LOC111128957,3297
NC_035783.1,9158926,9183581,9164250,9183581,111128965,XM_022474943.1,uncharacterized LOC111128965,19331
NC_035783.1,9158926,9183581,9162762,9183581,111128965,XM_022474946.1,uncharacterized LOC111128965,20819
NC_035783.1,9158926,9183581,9159709,9183581,111128965,XM_022474942.1,uncharacterized LOC111128965,23872
NC_035783.1,9158926,9183581,9158926,9183581,111128965,XM_022474944.1,uncharacterized LOC111128965,24655
NC_035783.1,15862749,15872105,15862749,15872105,111128967,XM_022474950.1,uncharacterized LOC111128967,9356
NC_035783.1,15829061,15841819,15829061,15841819,111128968,XM_022474951.1,uncharacterized LOC111128968,12758
NC_035783.1,20303350,20313729,20303350,20313729,111128975,XM_022474956.1,uncharacterized LOC111128975,10379
NC_035783.1,2575619,2577334,2575619,2577334,111128984,XM_022474988.1,uncharacterized LOC111128984,1715
NC_035783.1,22294104,22312250,22294104,22312250,111128989,XM_022474997.1,uncharacterized LOC111128989,18146
NC_035783.1,12778245,12782022,12778245,12782022,111128993,XM_022475009.1,uncharacterized LOC111128993,3777
NC_035780.1,1229194,1261514,1229194,1261514,111128995,XM_022475013.1,uncharacterized LOC111128995,32320
NC_035780.1,25191083,25241551,25191083,25227302,111128999,XM_022475038.1,uncharacterized LOC111128999,36219
NC_035780.1,25191083,25241551,25191083,25241551,111128999,XM_022475029.1,uncharacterized LOC111128999,50468
NC_035783.1,22452116,22456673,22452116,22456673,111129000,XM_022475024.1,uncharacterized LOC111129000,4557
NC_035783.1,15127668,15136581,15127668,15136581,111129001,XM_022475025.1,uncharacterized LOC111129001,8913
NC_035783.1,32451021,32459097,32451021,32458541,111129007,XM_022475049.1,uncharacterized LOC111129007,7520
NC_035783.1,32451021,32459097,32451021,32458608,111129007,XM_022475047.1,uncharacterized LOC111129007,7587
NC_035783.1,32451021,32459097,32451021,32458640,111129007,XM_022475051.1,uncharacterized LOC111129007,7619
NC_035783.1,32451021,32459097,32451021,32458822,111129007,XM_022475048.1,uncharacterized LOC111129007,7801
NC_035783.1,32451021,32459097,32451021,32459097,111129007,XM_022475050.1,uncharacterized LOC111129007,8076
NC_035780.1,25329595,25331801,25329595,25331801,111129008,XM_022475053.1,uncharacterized LOC111129008,2206
NC_035783.1,20939477,20942690,20939477,20942690,111129013,XM_022475057.1,uncharacterized LOC111129013,3213
NC_035783.1,45481253,45486689,45481258,45486520,111129020,XM_022475066.1,uncharacterized LOC111129020,5262
NC_035783.1,45481253,45486689,45481258,45486689,111129020,XM_022475067.1,uncharacterized LOC111129020,5431
NC_035780.1,25332847,25334309,25332847,25334309,111129031,XM_022475089.1,uncharacterized LOC111129031,1462
NC_035783.1,1165504,1169671,1165504,1169671,111129034,XM_022475091.1,uncharacterized LOC111129034,4167
NC_035783.1,1089314,1110584,1089314,1110584,111129036,XM_022475093.1,uncharacterized LOC111129036,21270
NC_035783.1,1029932,1037576,1029932,1037576,111129037,XM_022475094.1,uncharacterized LOC111129037,7644
NC_035783.1,1015265,1017501,1015265,1017501,111129040,XM_022475098.1,uncharacterized LOC111129040,2236
NC_035783.1,1205623,1207873,1205629,1207873,111129041,XM_022475099.1,uncharacterized LOC111129041,2244
NC_035783.1,1205623,1207873,1205623,1207873,111129041,XM_022475100.1,uncharacterized LOC111129041,2250
NC_035783.1,947429,953842,952269,953842,111129043,XM_022475103.1,uncharacterized LOC111129043,1573
NC_035783.1,947429,953842,947429,953842,111129043,XM_022475102.1,uncharacterized LOC111129043,6413
NC_035783.1,48750742,48752979,48750742,48752979,111129059,XM_022475134.1,uncharacterized LOC111129059,2237
NC_035780.1,1332677,1336216,1332677,1336216,111129066,XM_022475144.1,uncharacterized LOC111129066,3539
NC_035783.1,18469819,18474397,18469819,18474397,111129067,XM_022475142.1,uncharacterized LOC111129067,4578
NC_035783.1,52746909,52765507,52746909,52765507,111129082,XM_022475166.1,uncharacterized LOC111129082,18598
NC_035783.1,16242994,16250677,16242994,16250676,111129085,XM_022475172.1,uncharacterized LOC111129085,7682
NC_035783.1,16242994,16250677,16242994,16250677,111129085,XM_022475171.1,uncharacterized LOC111129085,7683
NC_035783.1,16232118,16242414,16232118,16242414,111129087,XM_022475174.1,uncharacterized LOC111129087,10296
NC_035783.1,28259210,28262692,28259210,28262692,111129089,XM_022475192.1,uncharacterized LOC111129089,3482
NC_035783.1,28227690,28232788,28227690,28232065,111129093,XM_022475204.1,uncharacterized LOC111129093,4375
NC_035783.1,28227690,28232788,28227690,28232785,111129093,XM_022475205.1,uncharacterized LOC111129093,5095
NC_035783.1,28227690,28232788,28227690,28232788,111129093,XM_022475203.1,uncharacterized LOC111129093,5098
NC_035783.1,28275348,28280483,28275348,28279436,111129094,XM_022475212.1,uncharacterized LOC111129094,4088
NC_035783.1,28275348,28280483,28275348,28279724,111129094,XM_022475211.1,uncharacterized LOC111129094,4376
NC_035783.1,28275348,28280483,28275348,28280341,111129094,XM_022475209.1,uncharacterized LOC111129094,4993
NC_035783.1,28275348,28280483,28275348,28280361,111129094,XM_022475206.1,uncharacterized LOC111129094,5013
NC_035783.1,28275348,28280483,28275348,28280471,111129094,XM_022475208.1,uncharacterized LOC111129094,5123
NC_035783.1,28275348,28280483,28275348,28280483,111129094,XM_022475210.1,uncharacterized LOC111129094,5135
NC_035780.1,1575100,1575558,1575100,1575558,111129108,XM_022475230.1,uncharacterized LOC111129108,458
NC_035783.1,24131109,24134107,24131109,24134107,111129111,XM_022475229.1,uncharacterized LOC111129111,2998
NC_035783.1,16652335,16655648,16652335,16655648,111129113,XM_022475233.1,uncharacterized LOC111129113,3313
NC_035783.1,51726040,51742006,51726040,51742006,111129129,XM_022475267.1,uncharacterized LOC111129129,15966
NC_035783.1,14760199,14806575,14762802,14806575,111129131,XM_022475270.1,uncharacterized LOC111129131,43773
NC_035783.1,14760199,14806575,14760224,14806575,111129131,XM_022475269.1,uncharacterized LOC111129131,46351
NC_035783.1,14760199,14806575,14760199,14806575,111129131,XM_022475268.1,uncharacterized LOC111129131,46376
NC_035780.1,36478974,36483024,36478974,36483024,111129132,XM_022475277.1,uncharacterized LOC111129132,4050
NC_035783.1,40394163,40397021,40394163,40397021,111129134,XM_022475282.1,uncharacterized LOC111129134,2858
NC_035783.1,41512596,41514369,41512596,41514369,111129140,XM_022475287.1,uncharacterized LOC111129140,1773
NC_035783.1,20364135,20374155,20364135,20374155,111129141,XM_022475288.1,uncharacterized LOC111129141,10020
NC_035783.1,20375736,20379021,20375736,20379021,111129142,XM_022475289.1,uncharacterized LOC111129142,3285
NC_035783.1,20059637,20091331,20059640,20078905,111129143,XM_022475293.1,uncharacterized LOC111129143,19265
NC_035783.1,20059637,20091331,20059639,20078905,111129143,XM_022475297.1,uncharacterized LOC111129143,19266
NC_035783.1,20059637,20091331,20059638,20078905,111129143,XM_022475295.1,uncharacterized LOC111129143,19267
NC_035783.1,20059637,20091331,20059637,20078905,111129143,XM_022475298.1,uncharacterized LOC111129143,19268
NC_035783.1,20059637,20091331,20059640,20091331,111129143,XM_022475296.1,uncharacterized LOC111129143,31691
NC_035783.1,20101083,20102330,20101083,20102330,111129148,XM_022475304.1,uncharacterized LOC111129148,1247
NC_035783.1,248731,251681,248731,251681,111129154,XM_022475313.1,uncharacterized LOC111129154,2950
NC_035783.1,40285881,40308309,40293777,40308309,111129162,XM_022475343.1,uncharacterized LOC111129162,14532
NC_035783.1,40285881,40308309,40292378,40308309,111129162,XM_022475340.1,uncharacterized LOC111129162,15931
NC_035783.1,40285881,40308309,40292236,40308309,111129162,XM_022475344.1,uncharacterized LOC111129162,16073
NC_035783.1,40285881,40308309,40291793,40308309,111129162,XM_022475341.1,uncharacterized LOC111129162,16516
NC_035783.1,40285881,40308309,40291350,40308309,111129162,XM_022475345.1,uncharacterized LOC111129162,16959
NC_035783.1,40285881,40308309,40291021,40308309,111129162,XM_022475342.1,uncharacterized LOC111129162,17288
NC_035783.1,40285881,40308309,40288201,40306945,111129162,XM_022475322.1,uncharacterized LOC111129162,18744
NC_035783.1,40285881,40308309,40288201,40306976,111129162,XM_022475331.1,uncharacterized LOC111129162,18775
NC_035783.1,40285881,40308309,40288201,40307801,111129162,XM_022475329.1,uncharacterized LOC111129162,19600
NC_035783.1,40285881,40308309,40288201,40307812,111129162,XM_022475333.1,uncharacterized LOC111129162,19611
NC_035783.1,40285881,40308309,40288201,40307817,111129162,XM_022475330.1,uncharacterized LOC111129162,19616
NC_035783.1,40285881,40308309,40288201,40307831,111129162,XM_022475334.1,uncharacterized LOC111129162,19630
NC_035783.1,40285881,40308309,40288201,40308309,111129162,XM_022475321.1,uncharacterized LOC111129162,20108
NC_035783.1,40285881,40308309,40287765,40308309,111129162,XM_022475339.1,uncharacterized LOC111129162,20544
NC_035783.1,40285881,40308309,40287748,40308309,111129162,XM_022475335.1,uncharacterized LOC111129162,20561
NC_035783.1,40285881,40308309,40285881,40308309,111129162,XM_022475332.1,uncharacterized LOC111129162,22428
NC_035780.1,36527773,36538457,36527773,36538457,111129178,XM_022475414.1,uncharacterized LOC111129178,10684
NC_035780.1,36527773,36538457,36527773,36537600,111129178,XM_022475421.1,uncharacterized LOC111129178,9827
NC_035783.1,276597,281328,276597,281328,111129179,XM_022475408.1,uncharacterized LOC111129179,4731
NC_035783.1,54561753,54564279,54561753,54564279,111129183,XM_022475415.1,uncharacterized LOC111129183,2526
NC_035783.1,32531127,32552038,32531127,32552038,111129190,XM_022475426.1,uncharacterized LOC111129190,20911
NC_035780.1,36487177,36496384,36487177,36496384,111129192,XM_022475436.1,uncharacterized LOC111129192,9207
NC_035783.1,41994559,42018302,41994559,42018302,111129198,XM_022475442.1,uncharacterized LOC111129198,23743
NC_035780.1,36422923,36431866,36422923,36430852,111129199,XM_022475454.1,uncharacterized LOC111129199,7929
NC_035780.1,36422923,36431866,36422923,36431866,111129199,XM_022475447.1,uncharacterized LOC111129199,8943
NC_035783.1,42019836,42024346,42019836,42024346,111129200,XM_022475444.1,uncharacterized LOC111129200,4510
NC_035783.1,37567441,37570915,37567441,37570915,111129209,XM_022475455.1,uncharacterized LOC111129209,3474
NC_035783.1,37570991,37573244,37570991,37573244,111129211,XM_022475457.1,uncharacterized LOC111129211,2253
NC_035780.1,14423271,14425110,14423271,14425110,111129213,XM_022475496.1,uncharacterized LOC111129213,1839
NC_035780.1,36410781,36419005,36410781,36419005,111129216,XM_022475465.1,uncharacterized LOC111129216,8224
NC_035783.1,5316048,5325931,5318547,5325931,111129217,XM_022475463.1,uncharacterized LOC111129217,7384
NC_035783.1,5316048,5325931,5316048,5325928,111129217,XM_022475464.1,uncharacterized LOC111129217,9880
NC_035783.1,9666893,9684201,9666893,9684201,111129223,XM_022475475.1,uncharacterized LOC111129223,17308
NC_035783.1,11884165,11885741,11884165,11885741,111129227,XM_022475481.1,uncharacterized LOC111129227,1576
NC_035783.1,11854982,11859792,11854982,11859781,111129230,XM_022475484.1,uncharacterized LOC111129230,4799
NC_035783.1,11854982,11859792,11854982,11859792,111129230,XM_022475485.1,uncharacterized LOC111129230,4810
NC_035783.1,11818284,11820519,11818284,11820519,111129232,XM_022475486.1,uncharacterized LOC111129232,2235
NC_035783.1,11811130,11812441,11811130,11812441,111129233,XM_022475487.1,uncharacterized LOC111129233,1311
NC_035783.1,11872863,11874904,11872863,11874904,111129234,XM_022475489.1,uncharacterized LOC111129234,2041
NC_035783.1,11905742,11908619,11905742,11908619,111129235,XM_022475490.1,uncharacterized LOC111129235,2877
NC_035783.1,3649158,3659260,3649158,3659251,111129249,XM_022475508.1,uncharacterized LOC111129249,10093
NC_035783.1,3649158,3659260,3651895,3659260,111129249,XM_022475507.1,uncharacterized LOC111129249,7365
NC_035783.1,35594396,35598275,35594396,35598275,111129251,XM_022475511.1,uncharacterized LOC111129251,3879
NC_035783.1,35618956,35624638,35618956,35624638,111129254,XM_022475520.1,uncharacterized LOC111129254,5682
NC_035780.1,8109797,8111841,8109797,8111841,111129268,XM_022475544.1,uncharacterized LOC111129268,2044
NC_035783.1,16966031,16976717,16966031,16976717,111129272,XM_022475552.1,uncharacterized LOC111129272,10686
NC_035783.1,16957338,16964623,16957338,16964623,111129273,XM_022475553.1,uncharacterized LOC111129273,7285
NC_035780.1,1892805,1898535,1892805,1898535,111129274,XM_022475556.1,uncharacterized LOC111129274,5730
NC_035783.1,1728509,1821967,1728509,1821965,111129277,XM_022475562.1,uncharacterized LOC111129277,93456
NC_035783.1,1728509,1821967,1728509,1821966,111129277,XM_022475560.1,uncharacterized LOC111129277,93457
NC_035783.1,1728509,1821967,1728509,1821967,111129277,XM_022475559.1,uncharacterized LOC111129277,93458
NC_035783.1,1748573,1750657,1748573,1750657,111129278,XM_022475563.1,uncharacterized LOC111129278,2084
NC_035783.1,47611184,47613840,47611184,47613840,111129298,XM_022475583.1,uncharacterized LOC111129298,2656
NC_035783.1,45191264,45202054,45191264,45202054,111129299,XM_022475584.1,uncharacterized LOC111129299,10790
NC_035783.1,36036524,36051310,36036524,36051310,111129303,XM_022475590.1,uncharacterized LOC111129303,14786
NC_035783.1,36054319,36068844,36054320,36068844,111129304,XM_022475593.1,uncharacterized LOC111129304,14524
NC_035783.1,36054319,36068844,36054319,36068844,111129304,XM_022475594.1,uncharacterized LOC111129304,14525
NC_035783.1,53580093,53585162,53580093,53585162,111129306,XM_022475596.1,uncharacterized LOC111129306,5069
NC_035783.1,9409690,9456090,9409690,9456090,111129309,XM_022475598.1,uncharacterized LOC111129309,46400
NC_035783.1,49066339,49113886,49066339,49113886,111129310,XM_022475599.1,uncharacterized LOC111129310,47547
NC_035783.1,58501753,58507918,58501753,58507918,111129314,XM_022475607.1,uncharacterized LOC111129314,6165
NC_035783.1,13917268,13933267,13917268,13933267,111129317,XM_022475611.1,uncharacterized LOC111129317,15999
NC_035783.1,49277255,49279765,49277255,49279765,111129325,XM_022475622.1,uncharacterized LOC111129325,2510
NC_035780.1,20270626,20286553,20270626,20286553,111129328,XM_022475637.1,uncharacterized LOC111129328,15927
NC_035783.1,49462815,49464112,49462815,49464112,111129329,XM_022475625.1,uncharacterized LOC111129329,1297
NC_035783.1,49273988,49295874,49273988,49295874,111129330,XM_022475626.1,uncharacterized LOC111129330,21886
NC_035783.1,8505073,8522191,8505073,8520173,111129339,XM_022475656.1,uncharacterized LOC111129339,15100
NC_035783.1,8505073,8522191,8505073,8522191,111129339,XM_022475655.1,uncharacterized LOC111129339,17118
NC_035783.1,811346,903138,811347,903138,111129343,XM_022475665.1,uncharacterized LOC111129343,91791
NC_035783.1,811346,903138,811346,903138,111129343,XM_022475661.1,uncharacterized LOC111129343,91792
NC_035783.1,19453046,19458930,19453046,19458930,111129347,XM_022475670.1,uncharacterized LOC111129347,5884
NC_035780.1,30350098,30352316,30350098,30352316,111129353,XM_022475691.1,uncharacterized LOC111129353,2218
NC_035783.1,11093036,11096609,11093036,11096609,111129359,XM_022475695.1,uncharacterized LOC111129359,3573
NC_035783.1,26322968,26326975,26322968,26326975,111129361,XM_022475697.1,uncharacterized LOC111129361,4007
NC_035780.1,2510379,2516296,2510379,2516296,111129378,XM_022475742.1,uncharacterized LOC111129378,5917
NC_035783.1,29071420,29073385,29071420,29073385,111129407,XM_022475780.1,uncharacterized LOC111129407,1965
NC_035783.1,29207466,29209416,29207466,29209416,111129412,XM_022475784.1,uncharacterized LOC111129412,1950
NC_035783.1,28643453,28648844,28643456,28648844,111129413,XM_022475786.1,uncharacterized LOC111129413,5388
NC_035783.1,28643453,28648844,28643453,28648844,111129413,XM_022475785.1,uncharacterized LOC111129413,5391
NC_035783.1,28565192,28571400,28565192,28571400,111129415,XM_022475788.1,uncharacterized LOC111129415,6208
NC_035783.1,28679913,28682104,28679913,28682104,111129417,XM_022475791.1,uncharacterized LOC111129417,2191
NC_035783.1,29286778,29290411,29286778,29290411,111129418,XM_022475792.1,uncharacterized LOC111129418,3633
NC_035783.1,29092034,29095660,29092034,29095660,111129419,XM_022475793.1,uncharacterized LOC111129419,3626
NC_035780.1,2677962,2698757,2677962,2698757,111129421,XM_022475798.1,uncharacterized LOC111129421,20795
NC_035783.1,28671749,28679621,28671749,28679621,111129424,XM_022475797.1,uncharacterized LOC111129424,7872
NC_035783.1,28695372,28697473,28695372,28697473,111129426,XM_022475801.1,uncharacterized LOC111129426,2101
NC_035780.1,2715859,2743633,2715859,2743633,111129446,XM_022475840.1,uncharacterized LOC111129446,27774
NC_035783.1,29104805,29111825,29104805,29111825,111129451,XM_022475842.1,uncharacterized LOC111129451,7020
NC_035783.1,35980376,36001344,35980376,36000811,111129471,XM_022475862.1,uncharacterized LOC111129471,20435
NC_035783.1,35980376,36001344,35980377,36001344,111129471,XM_022475863.1,uncharacterized LOC111129471,20967
NC_035783.1,35990921,35993367,35990921,35993195,111129472,XM_022475864.1,uncharacterized LOC111129472,2274
NC_035783.1,36858015,36873891,36858015,36873891,111129481,XM_022475884.1,uncharacterized LOC111129481,15876
NC_035783.1,36858015,36873891,36865047,36873594,111129481,XM_022475883.1,uncharacterized LOC111129481,8547
NC_035783.1,14213197,14236646,14213198,14236646,111129501,XM_022475920.1,uncharacterized LOC111129501,23448
NC_035783.1,14213197,14236646,14213197,14236646,111129501,XM_022475918.1,uncharacterized LOC111129501,23449
NC_035783.1,43669157,43673790,43669157,43673790,111129505,XM_022475926.1,uncharacterized LOC111129505,4633
NC_035780.1,62161592,62166531,62163572,62166531,111129509,XM_022475931.1,uncharacterized LOC111129509,2959
NC_035780.1,62161592,62166531,62161592,62166531,111129509,XM_022475947.1,uncharacterized LOC111129509,4939
NC_035783.1,55193831,55204661,55193831,55204661,111129517,XM_022475970.1,uncharacterized LOC111129517,10830
NC_035783.1,48223298,48237859,48223298,48237859,111129520,XM_022475972.1,uncharacterized LOC111129520,14561
NC_035783.1,18724443,18742328,18724443,18742328,111129527,XM_022475982.1,uncharacterized LOC111129527,17885
NC_035783.1,19372833,19378894,19372833,19378894,111129532,XM_022475985.1,uncharacterized LOC111129532,6061
NC_035783.1,20505982,20522709,20505982,20522709,111129533,XM_022475987.1,uncharacterized LOC111129533,16727
NC_035783.1,20534504,20537076,20534504,20537076,111129534,XM_022475988.1,uncharacterized LOC111129534,2572
NC_035783.1,20567746,20592830,20567746,20592830,111129536,XM_022475990.1,uncharacterized LOC111129536,25084
NC_035783.1,21002865,21005170,21002865,21005170,111129538,XM_022475992.1,uncharacterized LOC111129538,2305
NC_035783.1,21306037,21306534,21306037,21306534,111129544,XM_022475998.1,uncharacterized LOC111129544,497
NC_035783.1,21308725,21309396,21308725,21309396,111129545,XM_022475999.1,uncharacterized LOC111129545,671
NC_035783.1,21546055,21549473,21546055,21549473,111129549,XM_022476003.1,uncharacterized LOC111129549,3418
NC_035783.1,22251480,22252172,22251480,22252172,111129551,XM_022476005.1,uncharacterized LOC111129551,692
NC_035783.1,23063493,23067614,23063493,23067614,111129555,XM_022476010.1,uncharacterized LOC111129555,4121
NC_035783.1,23484858,23491340,23484858,23491340,111129558,XM_022476012.1,uncharacterized LOC111129558,6482
NC_035783.1,24018237,24020150,24018237,24020150,111129560,XM_022476014.1,uncharacterized LOC111129560,1913
NC_035783.1,24092456,24108049,24092456,24108049,111129561,XM_022476015.1,uncharacterized LOC111129561,15593
NC_035780.1,59467957,59475764,59468999,59475764,111129562,XM_022476027.1,uncharacterized LOC111129562,6765
NC_035780.1,59467957,59475764,59467957,59475764,111129562,XM_022476019.1,uncharacterized LOC111129562,7807
NC_035783.1,24365495,24367525,24365495,24367525,111129565,XM_022476018.1,uncharacterized LOC111129565,2030
NC_035783.1,25439964,25440723,25439964,25440723,111129573,XM_022476028.1,uncharacterized LOC111129573,759
NC_035783.1,25884692,25888292,25884692,25888292,111129574,XM_022476029.1,uncharacterized LOC111129574,3600
NC_035783.1,25894406,25897729,25894406,25897729,111129575,XM_022476030.1,uncharacterized LOC111129575,3323
NC_035783.1,26682629,26683855,26682629,26683855,111129578,XM_022476033.1,uncharacterized LOC111129578,1226
NC_035780.1,59478195,59488909,59478195,59488463,111129580,XM_022476051.1,uncharacterized LOC111129580,10268
NC_035780.1,59478195,59488909,59478195,59488581,111129580,XM_022476043.1,uncharacterized LOC111129580,10386
NC_035780.1,59478195,59488909,59478195,59488909,111129580,XM_022476038.1,uncharacterized LOC111129580,10714
NC_035780.1,59478195,59488909,59478195,59488153,111129580,XM_022476059.1,uncharacterized LOC111129580,9958
NC_035783.1,27494750,27499205,27494750,27499205,111129581,XM_022476035.1,uncharacterized LOC111129581,4455
NC_035783.1,27503970,27507667,27503970,27507667,111129582,XM_022476036.1,uncharacterized LOC111129582,3697
NC_035783.1,27613450,27617710,27613450,27617710,111129583,XM_022476037.1,uncharacterized LOC111129583,4260
NC_035783.1,27771103,27772724,27771103,27772724,111129584,XM_022476039.1,uncharacterized LOC111129584,1621
NC_035783.1,27916804,27918358,27916804,27918358,111129586,XM_022476041.1,uncharacterized LOC111129586,1554
NC_035780.1,40092046,40120011,40092046,40120010,111129591,XM_022476222.1,uncharacterized LOC111129591,27964
NC_035780.1,40092046,40120011,40092046,40120011,111129591,XM_022476153.1,uncharacterized LOC111129591,27965
NC_035783.1,28503935,28519256,28503935,28519256,111129592,XM_022476045.1,uncharacterized LOC111129592,15321
NC_035783.1,28686522,28694825,28686522,28694825,111129596,XM_022476049.1,uncharacterized LOC111129596,8303
NC_035783.1,28933909,28934748,28933909,28934748,111129597,XM_022476050.1,uncharacterized LOC111129597,839
NC_035783.1,30341669,30344717,30341669,30344717,111129602,XM_022476056.1,uncharacterized LOC111129602,3048
NC_035783.1,31052110,31057276,31052110,31057276,111129604,XM_022476058.1,uncharacterized LOC111129604,5166
NC_035783.1,31195356,31198339,31195356,31198339,111129605,XM_022476060.1,uncharacterized LOC111129605,2983
NC_035783.1,31231765,31233926,31231765,31233926,111129606,XM_022476061.1,uncharacterized LOC111129606,2161
NC_035783.1,31370260,31371132,31370260,31371132,111129607,XM_022476062.1,uncharacterized LOC111129607,872
NC_035783.1,32193131,32208073,32193131,32208073,111129611,XM_022476067.1,uncharacterized LOC111129611,14942
NC_035783.1,32870134,32872633,32870134,32872633,111129612,XM_022476068.1,uncharacterized LOC111129612,2499
NC_035783.1,32929094,32946526,32929094,32946526,111129613,XM_022476069.1,uncharacterized LOC111129613,17432
NC_035783.1,33467670,33468362,33467670,33468362,111129616,XM_022476072.1,uncharacterized LOC111129616,692
NC_035780.1,59464074,59510512,59494972,59510512,111129617,XM_022476085.1,uncharacterized LOC111129617,15540
NC_035780.1,59464074,59510512,59464074,59510512,111129617,XM_022476076.1,uncharacterized LOC111129617,46438
NC_035783.1,33653124,33655215,33653124,33655215,111129619,XM_022476074.1,uncharacterized LOC111129619,2091
NC_035783.1,34097016,34116883,34097016,34116883,111129620,XM_022476075.1,uncharacterized LOC111129620,19867
NC_035783.1,34431770,34439836,34431770,34439836,111129622,XM_022476078.1,uncharacterized LOC111129622,8066
NC_035783.1,34438217,34442307,34438217,34442307,111129623,XM_022476079.1,uncharacterized LOC111129623,4090
NC_035783.1,34513625,34516573,34513625,34516573,111129624,XM_022476080.1,uncharacterized LOC111129624,2948
NC_035783.1,34522161,34542301,34522161,34542301,111129625,XM_022476082.1,uncharacterized LOC111129625,20140
NC_035783.1,34780983,34805756,34780983,34805756,111129627,XM_022476084.1,uncharacterized LOC111129627,24773
NC_035783.1,34884930,34885484,34884930,34885484,111129628,XM_022476086.1,uncharacterized LOC111129628,554
NC_035783.1,34885693,34891581,34885693,34891581,111129629,XM_022476087.1,uncharacterized LOC111129629,5888
NC_035783.1,35156864,35169283,35156864,35169283,111129631,XM_022476089.1,uncharacterized LOC111129631,12419
NC_035783.1,35498853,35502729,35498853,35502729,111129632,XM_022476090.1,uncharacterized LOC111129632,3876
NC_035783.1,35766881,35767498,35766881,35767498,111129634,XM_022476092.1,uncharacterized LOC111129634,617
NC_035783.1,35919606,35920442,35919606,35920442,111129636,XM_022476093.1,uncharacterized LOC111129636,836
NC_035783.1,37029121,37048615,37029121,37048615,111129638,XM_022476095.1,uncharacterized LOC111129638,19494
NC_035783.1,37272658,37278267,37272658,37278267,111129639,XM_022476096.1,uncharacterized LOC111129639,5609
NC_035783.1,37338049,37338897,37338049,37338897,111129640,XM_022476097.1,uncharacterized LOC111129640,848
NC_035780.1,25733048,25785975,25762284,25785975,111129644,XM_022476107.1,uncharacterized LOC111129644,23691
NC_035780.1,25733048,25785975,25733052,25785975,111129644,XM_022476115.1,uncharacterized LOC111129644,52923
NC_035780.1,25733048,25785975,25733048,25785975,111129644,XM_022476122.1,uncharacterized LOC111129644,52927
NC_035783.1,37425033,37426178,37425033,37426178,111129645,XM_022476104.1,uncharacterized LOC111129645,1145
NC_035783.1,37476769,37477868,37476769,37477868,111129646,XM_022476105.1,uncharacterized LOC111129646,1099
NC_035783.1,38067868,38069091,38067868,38069091,111129647,XM_022476106.1,uncharacterized LOC111129647,1223
NC_035783.1,38225730,38227194,38225730,38227194,111129651,XM_022476111.1,uncharacterized LOC111129651,1464
NC_035783.1,38667806,38672484,38667806,38672484,111129654,XM_022476114.1,uncharacterized LOC111129654,4678
NC_035783.1,38912380,38920654,38912380,38920654,111129655,XM_022476116.1,uncharacterized LOC111129655,8274
NC_035783.1,39524532,39530540,39524532,39530540,111129657,XM_022476118.1,uncharacterized LOC111129657,6008
NC_035783.1,40744351,40744927,40744351,40744927,111129660,XM_022476121.1,uncharacterized LOC111129660,576
NC_035783.1,40769255,40779081,40769255,40779081,111129661,XM_022476123.1,uncharacterized LOC111129661,9826
NC_035783.1,41965636,41969260,41965636,41969260,111129663,XM_022476125.1,uncharacterized LOC111129663,3624
NC_035783.1,42914289,42917987,42914289,42917987,111129672,XM_022476134.1,uncharacterized LOC111129672,3698
NC_035783.1,42980369,42981058,42980369,42981058,111129673,XM_022476135.1,uncharacterized LOC111129673,689
NC_035783.1,42987642,42988280,42987642,42988280,111129674,XM_022476136.1,uncharacterized LOC111129674,638
NC_035783.1,43222118,43223523,43222118,43223523,111129676,XM_022476138.1,uncharacterized LOC111129676,1405
NC_035783.1,43538899,43550262,43538899,43550262,111129677,XM_022476139.1,uncharacterized LOC111129677,11363
NC_035783.1,43790345,43805771,43790345,43805771,111129678,XM_022476141.1,uncharacterized LOC111129678,15426
NC_035783.1,44763811,44767927,44763811,44767927,111129682,XM_022476145.1,uncharacterized LOC111129682,4116
NC_035783.1,44773154,44774383,44773154,44774383,111129683,XM_022476146.1,uncharacterized LOC111129683,1229
NC_035783.1,44860502,44862173,44860502,44862173,111129687,XM_022476149.1,uncharacterized LOC111129687,1671
NC_035783.1,44952600,44957945,44952600,44957945,111129689,XM_022476150.1,uncharacterized LOC111129689,5345
NC_035783.1,44960289,44961046,44960289,44961046,111129690,XM_022476151.1,uncharacterized LOC111129690,757
NC_035783.1,45246357,45252960,45246357,45252960,111129692,XM_022476154.1,uncharacterized LOC111129692,6603
NC_035783.1,45849229,45850236,45849229,45850236,111129695,XM_022476156.1,uncharacterized LOC111129695,1007
NC_035783.1,45913579,45916667,45913579,45916667,111129696,XM_022476157.1,uncharacterized LOC111129696,3088
NC_035783.1,46378461,46379291,46378461,46379291,111129697,XM_022476159.1,uncharacterized LOC111129697,830
NC_035783.1,46379547,46384124,46379547,46384124,111129698,XM_022476160.1,uncharacterized LOC111129698,4577
NC_035783.1,46480266,46484078,46480266,46484078,111129700,XM_022476162.1,uncharacterized LOC111129700,3812
NC_035783.1,46512302,46513414,46512302,46513414,111129701,XM_022476163.1,uncharacterized LOC111129701,1112
NC_035783.1,47055183,47059026,47055183,47059026,111129709,XM_022476176.1,uncharacterized LOC111129709,3843
NC_035783.1,47073028,47081786,47073028,47081786,111129710,XM_022476177.1,uncharacterized LOC111129710,8758
NC_035783.1,48024722,48026069,48024722,48026069,111129711,XM_022476179.1,uncharacterized LOC111129711,1347
NC_035783.1,48209976,48212470,48209976,48212470,111129713,XM_022476181.1,uncharacterized LOC111129713,2494
NC_035783.1,48216413,48219545,48216413,48219545,111129714,XM_022476182.1,uncharacterized LOC111129714,3132
NC_035783.1,49279769,49281085,49279769,49281085,111129717,XM_022476185.1,uncharacterized LOC111129717,1316
NC_035783.1,49281176,49282580,49281176,49282580,111129718,XM_022476187.1,uncharacterized LOC111129718,1404
NC_035783.1,49954476,49955373,49954476,49955373,111129723,XM_022476192.1,uncharacterized LOC111129723,897
NC_035783.1,49956963,49958816,49956963,49958816,111129724,XM_022476194.1,uncharacterized LOC111129724,1853
NC_035783.1,50243887,50244462,50243887,50244462,111129725,XM_022476195.1,uncharacterized LOC111129725,575
NC_035783.1,50244555,50245457,50244555,50245457,111129726,XM_022476196.1,uncharacterized LOC111129726,902
NC_035783.1,50396286,50398403,50396286,50398403,111129727,XM_022476197.1,uncharacterized LOC111129727,2117
NC_035783.1,51180373,51180837,51180373,51180837,111129737,XM_022476207.1,uncharacterized LOC111129737,464
NC_035780.1,3016638,3022277,3016638,3022277,111129738,XM_022476211.1,uncharacterized LOC111129738,5639
NC_035783.1,51535455,51536702,51535455,51536702,111129739,XM_022476208.1,uncharacterized LOC111129739,1247
NC_035783.1,51544524,51552130,51544524,51552130,111129740,XM_022476209.1,uncharacterized LOC111129740,7606
NC_035783.1,52362064,52363363,52362064,52363363,111129743,XM_022476212.1,uncharacterized LOC111129743,1299
NC_035783.1,52484432,52492549,52484432,52492549,111129744,XM_022476213.1,uncharacterized LOC111129744,8117
NC_035783.1,52520130,52521426,52520130,52521426,111129745,XM_022476214.1,uncharacterized LOC111129745,1296
NC_035783.1,52639611,52640683,52639611,52640683,111129746,XM_022476215.1,uncharacterized LOC111129746,1072
NC_035783.1,52879510,52880787,52879510,52880787,111129749,XM_022476216.1,uncharacterized LOC111129749,1277
NC_035783.1,52911030,52912229,52911030,52912229,111129751,XM_022476218.1,uncharacterized LOC111129751,1199
NC_035783.1,53125640,53133023,53125640,53133023,111129755,XM_022476224.1,uncharacterized LOC111129755,7383
NC_035783.1,53277221,53289625,53277221,53289625,111129760,XM_022476227.1,uncharacterized LOC111129760,12404
NC_035783.1,54812545,54813651,54812545,54813651,111129769,XM_022476232.1,uncharacterized LOC111129769,1106
NC_035783.1,56270520,56272466,56270520,56272466,111129778,XM_022476237.1,uncharacterized LOC111129778,1946
NC_035783.1,56308276,56310683,56308276,56310683,111129779,XM_022476238.1,uncharacterized LOC111129779,2407
NC_035783.1,56433821,56445590,56433821,56445590,111129782,XM_022476242.1,uncharacterized LOC111129782,11769
NC_035783.1,56794918,56797376,56794918,56797376,111129784,XM_022476243.1,uncharacterized LOC111129784,2458
NC_035783.1,56987370,56995682,56987370,56995682,111129785,XM_022476244.1,uncharacterized LOC111129785,8312
NC_035783.1,57139808,57141405,57139808,57141405,111129786,XM_022476245.1,uncharacterized LOC111129786,1597
NC_035780.1,3189045,3193152,3189045,3193152,111129787,XM_022476248.1,uncharacterized LOC111129787,4107
NC_035783.1,57215914,57227369,57215914,57227369,111129789,XM_022476247.1,uncharacterized LOC111129789,11455
NC_035783.1,57348566,57354423,57348566,57354423,111129792,XM_022476250.1,uncharacterized LOC111129792,5857
NC_035783.1,58701561,58715265,58701561,58715265,111129801,XM_022476257.1,uncharacterized LOC111129801,13704
NC_035783.1,58789904,58794171,58789904,58794171,111129803,XM_022476260.1,uncharacterized LOC111129803,4267
NC_035783.1,58840062,58844207,58840062,58844207,111129804,XM_022476261.1,uncharacterized LOC111129804,4145
NC_035783.1,58867252,58871220,58867252,58871220,111129805,XM_022476262.1,uncharacterized LOC111129805,3968
NC_035783.1,58877063,58891641,58877063,58891641,111129806,XM_022476263.1,uncharacterized LOC111129806,14578
NC_035783.1,59348821,59351003,59348821,59351003,111129807,XM_022476264.1,uncharacterized LOC111129807,2182
NC_035780.1,62588942,62591483,62588942,62591483,111129809,XM_022476269.1,uncharacterized LOC111129809,2541
NC_035783.1,59513151,59519649,59513151,59519649,111129810,XM_022476266.1,uncharacterized LOC111129810,6498
NC_035783.1,26822544,26839457,26823229,26839456,111129817,XM_022476276.1,uncharacterized LOC111129817,16227
NC_035783.1,26822544,26839457,26823205,26839456,111129817,XM_022476275.1,uncharacterized LOC111129817,16251
NC_035783.1,26822544,26839457,26822554,26839456,111129817,XM_022476274.1,uncharacterized LOC111129817,16902
NC_035783.1,26822544,26839457,26822544,26839457,111129817,XM_022476277.1,uncharacterized LOC111129817,16913
NC_035783.1,18176685,18189499,18176685,18189499,111129830,XM_022476304.1,uncharacterized LOC111129830,12814
NC_035783.1,20031100,20038020,20031100,20038020,111129834,XM_022476310.1,uncharacterized LOC111129834,6920
NC_035780.1,3341512,3342570,3341512,3342570,111129845,XM_022476333.1,uncharacterized LOC111129845,1058
NC_035783.1,24954661,24970493,24954661,24970493,111129847,XM_022476330.1,uncharacterized LOC111129847,15832
NC_035783.1,40974073,40990605,40974073,40990605,111129848,XM_022476332.1,uncharacterized LOC111129848,16532
NC_035783.1,40710726,40726330,40710726,40726330,111129849,XM_022476334.1,uncharacterized LOC111129849,15604
NC_035780.1,3342747,3343880,3342747,3343880,111129861,XM_022476352.1,uncharacterized LOC111129861,1133
NC_035783.1,18139314,18141162,18139314,18141162,111129867,XM_022476359.1,uncharacterized LOC111129867,1848
NC_035783.1,18120802,18139287,18120802,18139287,111129868,XM_022476360.1,uncharacterized LOC111129868,18485
NC_035780.1,3343958,3345355,3343958,3345355,111129869,XM_022476365.1,uncharacterized LOC111129869,1397
NC_035783.1,9957605,9985489,9957605,9985489,111129872,XM_022476363.1,uncharacterized LOC111129872,27884
NC_035780.1,3348104,3354091,3348104,3354091,111129878,XM_022476393.1,uncharacterized LOC111129878,5987
NC_035783.1,12187610,12199115,12187610,12199115,111129879,XM_022476390.1,uncharacterized LOC111129879,11505
NC_035783.1,11961771,11969088,11961771,11969088,111129881,XM_022476392.1,uncharacterized LOC111129881,7317
NC_035783.1,12045294,12047465,12045300,12047465,111129893,XM_022476412.1,uncharacterized LOC111129893,2165
NC_035783.1,12045294,12047465,12045294,12047465,111129893,XM_022476411.1,uncharacterized LOC111129893,2171
NC_035783.1,12180431,12183507,12180431,12183507,111129896,XM_022476415.1,uncharacterized LOC111129896,3076
NC_035783.1,35728300,35750775,35734406,35750775,111129899,XM_022476422.1,uncharacterized LOC111129899,16369
NC_035783.1,35728300,35750775,35734400,35750775,111129899,XM_022476419.1,uncharacterized LOC111129899,16375
NC_035783.1,35728300,35750775,35734113,35750775,111129899,XM_022476425.1,uncharacterized LOC111129899,16662
NC_035783.1,35728300,35750775,35733886,35750775,111129899,XM_022476426.1,uncharacterized LOC111129899,16889
NC_035783.1,35728300,35750775,35733885,35750775,111129899,XM_022476421.1,uncharacterized LOC111129899,16890
NC_035783.1,35728300,35750775,35728450,35750775,111129899,XM_022476424.1,uncharacterized LOC111129899,22325
NC_035783.1,35728300,35750775,35728300,35750775,111129899,XM_022476420.1,uncharacterized LOC111129899,22475
NC_035783.1,35728300,35750775,35741015,35750775,111129899,XM_022476427.1,uncharacterized LOC111129899,9760
NC_035783.1,47930806,47998253,47930806,47998253,111129908,XM_022476443.1,uncharacterized LOC111129908,67447
NC_035783.1,20740303,20744801,20740303,20744801,111129915,XM_022476458.1,uncharacterized LOC111129915,4498
NC_035783.1,20689804,20696743,20689804,20696743,111129918,XM_022476462.1,uncharacterized LOC111129918,6939
NC_035783.1,50498328,50509357,50498378,50509357,111129921,XM_022476464.1,uncharacterized LOC111129921,10979
NC_035783.1,50498328,50509357,50498328,50509357,111129921,XM_022476465.1,uncharacterized LOC111129921,11029
NC_035780.1,3414281,3415915,3414281,3415915,111129927,XM_022476478.1,uncharacterized LOC111129927,1634
NC_035783.1,40501068,40504267,40501068,40504267,111129931,XM_022476481.1,uncharacterized LOC111129931,3199
NC_035783.1,40504479,40511614,40504479,40506484,111129933,XM_022476485.1,uncharacterized LOC111129933,2005
NC_035783.1,40504479,40511614,40504479,40511612,111129933,XM_022476484.1,uncharacterized LOC111129933,7133
NC_035783.1,9513518,9553264,9513518,9553264,111129939,XM_022476493.1,uncharacterized LOC111129939,39746
NC_035783.1,54645333,54650432,54645333,54650432,111129941,XM_022476495.1,uncharacterized LOC111129941,5099
NC_035783.1,34547748,34550340,34547748,34550340,111129943,XM_022476497.1,uncharacterized LOC111129943,2592
NC_035780.1,54629879,54662876,54639208,54662876,111129944,XM_022476523.1,uncharacterized LOC111129944,23668
NC_035780.1,54629879,54662876,54638901,54662876,111129944,XM_022476518.1,uncharacterized LOC111129944,23975
NC_035780.1,54629879,54662876,54637129,54662876,111129944,XM_022476501.1,uncharacterized LOC111129944,25747
NC_035780.1,54629879,54662876,54629879,54662876,111129944,XM_022476509.1,uncharacterized LOC111129944,32997
NC_035783.1,1933346,1934970,1933346,1934970,111129946,XM_022476499.1,uncharacterized LOC111129946,1624
NC_035783.1,18056701,18066317,18056701,18066317,111129969,XM_022476534.1,uncharacterized LOC111129969,9616
NC_035783.1,3173758,3186009,3173758,3186009,111129982,XM_022476559.1,uncharacterized LOC111129982,12251
NC_035783.1,40876054,40941900,40876054,40941900,111129987,XM_022476564.1,uncharacterized LOC111129987,65846
NC_035783.1,40847217,40871428,40847217,40871428,111129988,XM_022476565.1,uncharacterized LOC111129988,24211
NC_035783.1,40894380,40903368,40894383,40901247,111129989,XM_022476566.1,uncharacterized LOC111129989,6864
NC_035783.1,40894380,40903368,40894380,40903368,111129989,XM_022476567.1,uncharacterized LOC111129989,8988
NC_035783.1,40891023,40893994,40891023,40893994,111129990,XM_022476568.1,uncharacterized LOC111129990,2971
NC_035783.1,34562996,34572131,34562997,34572129,111130000,XM_022476584.1,uncharacterized LOC111130000,9132
NC_035783.1,34562996,34572131,34562997,34572130,111130000,XM_022476583.1,uncharacterized LOC111130000,9133
NC_035783.1,34562996,34572131,34562996,34572131,111130000,XM_022476585.1,uncharacterized LOC111130000,9135
NC_035783.1,40353975,40361551,40356381,40361551,111130010,XM_022476603.1,uncharacterized LOC111130010,5170
NC_035783.1,40353975,40361551,40354817,40361551,111130010,XM_022476605.1,uncharacterized LOC111130010,6734
NC_035783.1,40353975,40361551,40353975,40361551,111130010,XM_022476602.1,uncharacterized LOC111130010,7576
NC_035783.1,53514296,53516837,53514296,53516837,111130044,XM_022476691.1,uncharacterized LOC111130044,2541
NC_035783.1,41387761,41395218,41387761,41395218,111130049,XM_022476699.1,uncharacterized LOC111130049,7457
NC_035783.1,37588761,37609542,37588761,37607186,111130054,XM_022476725.1,uncharacterized LOC111130054,18425
NC_035783.1,37588761,37609542,37588761,37609542,111130054,XM_022476724.1,uncharacterized LOC111130054,20781
NC_035783.1,18532618,18534225,18532618,18534225,111130056,XM_022476729.1,uncharacterized LOC111130056,1607
NC_035783.1,26576969,26592346,26576969,26591675,111130060,XM_022476736.1,uncharacterized LOC111130060,14706
NC_035783.1,26576969,26592346,26576969,26591684,111130060,XM_022476735.1,uncharacterized LOC111130060,14715
NC_035783.1,26576969,26592346,26576969,26592343,111130060,XM_022476734.1,uncharacterized LOC111130060,15374
NC_035783.1,26576969,26592346,26576969,26592346,111130060,XM_022476737.1,uncharacterized LOC111130060,15377
NC_035783.1,1636392,1671546,1636392,1671546,111130061,XM_022476739.1,uncharacterized LOC111130061,35154
NC_035783.1,25498733,25512115,25498733,25512115,111130066,XM_022476748.1,uncharacterized LOC111130066,13382
NC_035783.1,30371263,30384645,30371263,30382857,111130073,XM_022476761.1,uncharacterized LOC111130073,11594
NC_035783.1,30371263,30384645,30371263,30384645,111130073,XM_022476760.1,uncharacterized LOC111130073,13382
NC_035783.1,30363604,30370760,30365261,30370760,111130074,XM_022476762.1,uncharacterized LOC111130074,5499
NC_035783.1,9601417,9608994,9601417,9608994,111130080,XM_022476770.1,uncharacterized LOC111130080,7577
NC_035783.1,40091712,40096982,40092624,40096982,111130104,XM_022476803.1,uncharacterized LOC111130104,4358
NC_035783.1,40091712,40096982,40091712,40096982,111130104,XM_022476802.1,uncharacterized LOC111130104,5270
NC_035783.1,23336869,23341417,23336869,23341417,111130124,XM_022476848.1,uncharacterized LOC111130124,4548
NC_035783.1,38339328,38362136,38339328,38362136,111130137,XM_022476868.1,uncharacterized LOC111130137,22808
NC_035783.1,35937883,35939976,35937883,35939976,111130139,XM_022476871.1,uncharacterized LOC111130139,2093
NC_035783.1,35945634,35947313,35945634,35947313,111130141,XM_022476873.1,uncharacterized LOC111130141,1679
NC_035783.1,34666024,34668883,34666024,34668883,111130145,XM_022476878.1,uncharacterized LOC111130145,2859
NC_035783.1,16191451,16194514,16192613,16194514,111130148,XM_022476884.1,uncharacterized LOC111130148,1901
NC_035783.1,16191451,16194514,16191451,16194513,111130148,XM_022476883.1,uncharacterized LOC111130148,3062
NC_035780.1,3643906,3644577,3643906,3644577,111130149,XM_022476889.1,uncharacterized LOC111130149,671
NC_035783.1,41227994,41231231,41227994,41231116,111130154,XM_022476896.1,uncharacterized LOC111130154,3122
NC_035783.1,41227994,41231231,41227994,41231231,111130154,XM_022476895.1,uncharacterized LOC111130154,3237
NC_035783.1,41218181,41227834,41225830,41227831,111130156,XM_022476901.1,uncharacterized LOC111130156,2001
NC_035783.1,41218181,41227834,41218861,41227834,111130156,XM_022476902.1,uncharacterized LOC111130156,8973
NC_035783.1,41218181,41227834,41218181,41227830,111130156,XM_022476900.1,uncharacterized LOC111130156,9649
NC_035783.1,46674575,46695337,46674575,46695337,111130159,XM_022476908.1,uncharacterized LOC111130159,20762
NC_035783.1,46674575,46695337,46674575,46682129,111130159,XM_022476909.1,uncharacterized LOC111130159,7554
NC_035780.1,3758532,3765298,3758532,3765298,111130161,XM_022476915.1,uncharacterized LOC111130161,6766
NC_035783.1,56999239,57015755,56999239,57015755,111130167,XM_022476919.1,uncharacterized LOC111130167,16516
NC_035783.1,41737825,41754419,41741406,41754419,111130168,XM_022476922.1,uncharacterized LOC111130168,13013
NC_035783.1,41737825,41754419,41737836,41754419,111130168,XM_022476921.1,uncharacterized LOC111130168,16583
NC_035783.1,41737825,41754419,41737825,41754419,111130168,XM_022476920.1,uncharacterized LOC111130168,16594
NC_035783.1,41737825,41754419,41745292,41754419,111130168,XM_022476923.1,uncharacterized LOC111130168,9127
NC_035780.1,44222435,44226925,44222435,44226925,111130169,XM_022476928.1,uncharacterized LOC111130169,4490
NC_035783.1,41759709,41765778,41759860,41765778,111130170,XM_022476924.1,uncharacterized LOC111130170,5918
NC_035783.1,41759709,41765778,41759709,41765778,111130170,XM_022476925.1,uncharacterized LOC111130170,6069
NC_035783.1,29679695,29686993,29679695,29686993,111130172,XM_022476929.1,uncharacterized LOC111130172,7298
NC_035783.1,23987485,23990627,23987485,23990627,111130173,XM_022476930.1,uncharacterized LOC111130173,3142
NC_035783.1,23978725,23981091,23978725,23981091,111130174,XM_022476931.1,uncharacterized LOC111130174,2366
NC_035783.1,52773189,52800373,52773189,52792725,111130178,XM_022476938.1,uncharacterized LOC111130178,19536
NC_035783.1,52773189,52800373,52773189,52800373,111130178,XM_022476940.1,uncharacterized LOC111130178,27184
NC_035780.1,45367519,45376990,45368323,45376990,111130185,XM_022476961.1,uncharacterized LOC111130185,8667
NC_035780.1,45367519,45376990,45367519,45376990,111130185,XM_022476952.1,uncharacterized LOC111130185,9471
NC_035783.1,34107928,34109337,34107928,34109337,111130186,XM_022476949.1,uncharacterized LOC111130186,1409
NC_035783.1,52757,54984,52757,54984,111130198,XM_022476979.1,uncharacterized LOC111130198,2227
NC_035780.1,4071898,4073025,4071898,4073025,111130204,XM_022476986.1,uncharacterized LOC111130204,1127
NC_035783.1,7005576,7017936,7005576,7017936,111130205,XM_022476985.1,uncharacterized LOC111130205,12360
NC_035783.1,6973547,6987652,6973547,6987652,111130206,XM_022476987.1,uncharacterized LOC111130206,14105
NC_035783.1,7024213,7037833,7024213,7037833,111130207,XM_022476988.1,uncharacterized LOC111130207,13620
NC_035783.1,38963057,38995757,38967741,38995757,111130211,XM_022476996.1,uncharacterized LOC111130211,28016
NC_035783.1,38963057,38995757,38963057,38995757,111130211,XM_022476995.1,uncharacterized LOC111130211,32700
NC_035783.1,38921261,38940509,38921261,38937227,111130212,XM_022476997.1,uncharacterized LOC111130212,15966
NC_035780.1,30109270,30117579,30109270,30117579,111130213,XM_022477033.1,uncharacterized LOC111130213,8309
NC_035783.1,20440205,20443124,20440205,20443124,111130222,XM_022477005.1,uncharacterized LOC111130222,2919
NC_035783.1,13724647,13738914,13724647,13738914,111130228,XM_022477013.1,uncharacterized LOC111130228,14267
NC_035783.1,13057911,13069228,13057911,13069228,111130235,XM_022477022.1,uncharacterized LOC111130235,11317
NC_035783.1,56834331,56840792,56834331,56840792,111130242,XM_022477030.1,uncharacterized LOC111130242,6461
NC_035780.1,4373699,4380364,4373699,4380364,111130247,XM_022477046.1,uncharacterized LOC111130247,6665
NC_035783.1,57440496,57452326,57440496,57452326,111130248,XM_022477043.1,uncharacterized LOC111130248,11830
NC_035783.1,57457188,57468138,57457189,57468138,111130249,XM_022477048.1,uncharacterized LOC111130249,10949
NC_035783.1,57457188,57468138,57457188,57468138,111130249,XM_022477044.1,uncharacterized LOC111130249,10950
NC_035783.1,57457188,57468138,57457188,57460936,111130249,XM_022477045.1,uncharacterized LOC111130249,3748
NC_035783.1,57457188,57468138,57457188,57464596,111130249,XM_022477047.1,uncharacterized LOC111130249,7408
NC_035783.1,15644759,15656314,15644759,15656314,111130265,XM_022477092.1,uncharacterized LOC111130265,11555
NC_035783.1,15644759,15656314,15647295,15654610,111130265,XM_022477093.1,uncharacterized LOC111130265,7315
NC_035780.1,34881501,34908505,34894308,34908505,111130267,XM_022477118.1,uncharacterized LOC111130267,14197
NC_035780.1,34881501,34908505,34891495,34908505,111130267,XM_022477109.1,uncharacterized LOC111130267,17010
NC_035780.1,34881501,34908505,34887851,34908505,111130267,XM_022477126.1,uncharacterized LOC111130267,20654
NC_035780.1,34881501,34908505,34881501,34908505,111130267,XM_022477100.1,uncharacterized LOC111130267,27004
NC_035783.1,15657260,15661881,15657260,15660944,111130269,XM_022477102.1,uncharacterized LOC111130269,3684
NC_035783.1,15657260,15661881,15657260,15661881,111130269,XM_022477101.1,uncharacterized LOC111130269,4621
NC_035783.1,15642597,15665190,15642597,15665190,111130270,XM_022477103.1,uncharacterized LOC111130270,22593
NC_035783.1,11126522,11130539,11126522,11130539,111130278,XM_022477121.1,uncharacterized LOC111130278,4017
NC_035783.1,42271998,42285307,42271998,42285307,111130281,XM_022477124.1,uncharacterized LOC111130281,13309
NC_035783.1,17991863,17997075,17991863,17997075,111130299,XM_022477190.1,uncharacterized LOC111130299,5212
NC_035783.1,43865716,43880714,43865716,43880292,111130304,XM_022477197.1,uncharacterized LOC111130304,14576
NC_035783.1,43865716,43880714,43865716,43880714,111130304,XM_022477196.1,uncharacterized LOC111130304,14998
NC_035783.1,43857592,43876508,43857592,43875782,111130306,XM_022477199.1,uncharacterized LOC111130306,18190
NC_035783.1,43857592,43876508,43857592,43876508,111130306,XM_022477200.1,uncharacterized LOC111130306,18916
NC_035783.1,43857592,43876508,43857593,43861614,111130306,XM_022477198.1,uncharacterized LOC111130306,4021
NC_035783.1,43857592,43876508,43857593,43861831,111130306,XM_022477201.1,uncharacterized LOC111130306,4238
NC_035783.1,34619150,34623418,34619150,34623418,111130308,XM_022477204.1,uncharacterized LOC111130308,4268
NC_035783.1,29593230,29596765,29593230,29596765,111130313,XM_022477212.1,uncharacterized LOC111130313,3535
NC_035783.1,2902642,2914491,2902642,2914491,111130315,XM_022477217.1,uncharacterized LOC111130315,11849
NC_035783.1,38608943,38621227,38608943,38621227,111130316,XM_022477220.1,uncharacterized LOC111130316,12284
NC_035783.1,38622288,38642271,38623535,38642271,111130317,XM_022477223.1,uncharacterized LOC111130317,18736
NC_035783.1,38622288,38642271,38622288,38642271,111130317,XM_022477222.1,uncharacterized LOC111130317,19983
NC_035783.1,38559585,38574375,38559585,38574375,111130319,XM_022477224.1,uncharacterized LOC111130319,14790
NC_035783.1,5695852,5699112,5695852,5699112,111130320,XM_022477225.1,uncharacterized LOC111130320,3260
NC_035783.1,42510854,42514724,42510854,42514724,111130321,XM_022477226.1,uncharacterized LOC111130321,3870
NC_035783.1,24414433,24436130,24414433,24436130,111130324,XM_022477236.1,uncharacterized LOC111130324,21697
NC_035783.1,17721244,17733004,17721244,17733004,111130328,XM_022477239.1,uncharacterized LOC111130328,11760
NC_035783.1,17233324,17244070,17233324,17244070,111130331,XM_022477243.1,uncharacterized LOC111130331,10746
NC_035783.1,56538691,56549909,56538692,56549909,111130332,XM_022477252.1,uncharacterized LOC111130332,11217
NC_035783.1,56538691,56549909,56538691,56549909,111130332,XM_022477251.1,uncharacterized LOC111130332,11218
NC_035783.1,56538691,56549909,56538691,56547918,111130332,XM_022477245.1,uncharacterized LOC111130332,9227
NC_035783.1,25822181,25861445,25822181,25861445,111130338,XM_022477283.1,uncharacterized LOC111130338,39264
NC_035783.1,25706259,25731404,25706259,25729013,111130339,XM_022477285.1,uncharacterized LOC111130339,22754
NC_035783.1,25706259,25731404,25706259,25731404,111130339,XM_022477286.1,uncharacterized LOC111130339,25145
NC_035783.1,25767463,25813432,25767463,25797800,111130340,XM_022477288.1,uncharacterized LOC111130340,30337
NC_035783.1,25767463,25813432,25767463,25810996,111130340,XM_022477293.1,uncharacterized LOC111130340,43533
NC_035783.1,25767463,25813432,25767463,25813432,111130340,XM_022477289.1,uncharacterized LOC111130340,45969
NC_035783.1,25762020,25763626,25762020,25763626,111130341,XM_022477294.1,uncharacterized LOC111130341,1606
NC_035783.1,19700841,19704076,19700841,19704076,111130349,XM_022477317.1,uncharacterized LOC111130349,3235
NC_035780.1,24102769,24129452,24102769,24129452,111130352,XM_022477328.1,uncharacterized LOC111130352,26683
NC_035783.1,51045119,51059137,51045119,51059137,111130362,XM_022477367.1,uncharacterized LOC111130362,14018
NC_035783.1,23492434,23503936,23492853,23503936,111130369,XM_022477382.1,uncharacterized LOC111130369,11083
NC_035783.1,23492434,23503936,23492638,23503936,111130369,XM_022477383.1,uncharacterized LOC111130369,11298
NC_035783.1,23492434,23503936,23492465,23503936,111130369,XM_022477380.1,uncharacterized LOC111130369,11471
NC_035783.1,23492434,23503936,23492434,23503936,111130369,XM_022477377.1,uncharacterized LOC111130369,11502
NC_035783.1,23492434,23503936,23496036,23503936,111130369,XM_022477379.1,uncharacterized LOC111130369,7900
NC_035783.1,23492434,23503936,23495621,23503936,111130369,XM_022477378.1,uncharacterized LOC111130369,8315
NC_035783.1,23492434,23503936,23495565,23503936,111130369,XM_022477376.1,uncharacterized LOC111130369,8371
NC_035780.1,23975843,23987394,23975843,23987394,111130377,XM_022477403.1,uncharacterized LOC111130377,11551
NC_035783.1,13900465,13908590,13900467,13908590,111130379,XM_022477401.1,uncharacterized LOC111130379,8123
NC_035783.1,13900465,13908590,13900465,13908590,111130379,XM_022477400.1,uncharacterized LOC111130379,8125
NC_035783.1,12719921,12739063,12719921,12739063,111130381,XM_022477406.1,uncharacterized LOC111130381,19142
NC_035780.1,24151293,24158105,24151293,24158105,111130385,XM_022477416.1,uncharacterized LOC111130385,6812
NC_035783.1,34179196,34194218,34179196,34193694,111130388,XM_022477422.1,uncharacterized LOC111130388,14498
NC_035783.1,34179196,34194218,34179196,34194218,111130388,XM_022477421.1,uncharacterized LOC111130388,15022
NC_035783.1,34171299,34189934,34171299,34189299,111130389,XM_022477425.1,uncharacterized LOC111130389,18000
NC_035783.1,34171299,34189934,34171299,34189934,111130389,XM_022477424.1,uncharacterized LOC111130389,18635
NC_035783.1,34171299,34189934,34171299,34175307,111130389,XM_022477423.1,uncharacterized LOC111130389,4008
NC_035783.1,34171299,34189934,34171299,34175643,111130389,XM_022477426.1,uncharacterized LOC111130389,4344
NC_035783.1,44187008,44190676,44187008,44190358,111130401,XM_022477452.1,uncharacterized LOC111130401,3350
NC_035783.1,44187008,44190676,44187008,44190676,111130401,XM_022477451.1,uncharacterized LOC111130401,3668
NC_035780.1,24135862,24138031,24135862,24138031,111130406,XM_022477460.1,uncharacterized LOC111130406,2169
NC_035783.1,26048829,26059713,26048829,26059713,111130407,XM_022477458.1,uncharacterized LOC111130407,10884
NC_035783.1,26048829,26059713,26055277,26059530,111130407,XM_022477457.1,uncharacterized LOC111130407,4253
NC_035780.1,24164344,24167649,24164344,24167649,111130410,XM_022477476.1,uncharacterized LOC111130410,3305
NC_035780.1,24314111,24315915,24314111,24315915,111130415,XM_022477487.1,uncharacterized LOC111130415,1804
NC_035780.1,16532669,16536443,16532669,16536443,111130420,XM_022477529.1,uncharacterized LOC111130420,3774
NC_035780.1,24077787,24080431,24077787,24080431,111130424,XM_022477498.1,uncharacterized LOC111130424,2644
NC_035783.1,36379820,36387463,36379823,36387463,111130427,XM_022477499.1,uncharacterized LOC111130427,7640
NC_035783.1,36379820,36387463,36379820,36387463,111130427,XM_022477497.1,uncharacterized LOC111130427,7643
NC_035780.1,23788999,23791460,23788999,23791460,111130433,XM_022477510.1,uncharacterized LOC111130433,2461
NC_035783.1,53854958,53859380,53854958,53859380,111130440,XM_022477515.1,uncharacterized LOC111130440,4422
NC_035783.1,53853330,53854701,53853330,53854701,111130442,XM_022477517.1,uncharacterized LOC111130442,1371
NC_035780.1,24273323,24275481,24273323,24275481,111130443,XM_022477521.1,uncharacterized LOC111130443,2158
NC_035783.1,30021782,30030238,30022850,30030238,111130446,XM_022477520.1,uncharacterized LOC111130446,7388
NC_035783.1,30021782,30030238,30021782,30030238,111130446,XM_022477522.1,uncharacterized LOC111130446,8456
NC_035783.1,30015461,30018355,30015461,30018355,111130447,XM_022477523.1,uncharacterized LOC111130447,2894
NC_035783.1,30021061,30022341,30021061,30022341,111130448,XM_022477524.1,uncharacterized LOC111130448,1280
NC_035783.1,35585609,35590668,35585934,35590668,111130449,XM_022477525.1,uncharacterized LOC111130449,4734
NC_035783.1,35585609,35590668,35585609,35590668,111130449,XM_022477526.1,uncharacterized LOC111130449,5059
NC_035783.1,35577461,35583945,35577461,35583945,111130450,XM_022477527.1,uncharacterized LOC111130450,6484
NC_035780.1,24036141,24041051,24036141,24041051,111130453,XM_022477534.1,uncharacterized LOC111130453,4910
NC_035783.1,46351290,46355550,46351290,46355550,111130454,XM_022477531.1,uncharacterized LOC111130454,4260
NC_035783.1,33738991,33751358,33738991,33751358,111130457,XM_022477542.1,uncharacterized LOC111130457,12367
NC_035783.1,13490873,13495867,13490873,13495867,111130468,XM_022477559.1,uncharacterized LOC111130468,4994
NC_035783.1,26172657,26175767,26172657,26175767,111130472,XM_022477572.1,uncharacterized LOC111130472,3110
NC_035783.1,26161387,26166168,26161387,26166168,111130474,XM_022477575.1,uncharacterized LOC111130474,4781
NC_035783.1,29778801,29789311,29778801,29789311,111130477,XM_022477581.1,uncharacterized LOC111130477,10510
NC_035783.1,24556628,24557511,24556628,24557511,111130496,XM_022477630.1,uncharacterized LOC111130496,883
NC_035783.1,24543580,24546161,24543580,24546161,111130497,XM_022477631.1,uncharacterized LOC111130497,2581
NC_035783.1,14317149,14361751,14317149,14337923,111130498,XM_022477638.1,uncharacterized LOC111130498,20774
NC_035783.1,14317149,14361751,14317149,14361751,111130498,XM_022477639.1,uncharacterized LOC111130498,44602
NC_035783.1,35299482,35301478,35299482,35301478,111130504,XM_022477647.1,uncharacterized LOC111130504,1996
NC_035783.1,41643029,41649913,41643029,41648436,111130515,XM_022477659.1,uncharacterized LOC111130515,5407
NC_035783.1,41643029,41649913,41643029,41649913,111130515,XM_022477658.1,uncharacterized LOC111130515,6884
NC_035783.1,50298587,50306145,50298587,50301035,111130518,XM_022477663.1,uncharacterized LOC111130518,2448
NC_035783.1,50298587,50306145,50298587,50302721,111130518,XM_022477665.1,uncharacterized LOC111130518,4134
NC_035783.1,50298587,50306145,50298587,50303150,111130518,XM_022477664.1,uncharacterized LOC111130518,4563
NC_035783.1,50298587,50306145,50298587,50306145,111130518,XM_022477662.1,uncharacterized LOC111130518,7558
NC_035783.1,7152760,7173629,7152760,7173629,111130522,XM_022477669.1,uncharacterized LOC111130522,20869
NC_035783.1,7175649,7185947,7175649,7185947,111130523,XM_022477671.1,uncharacterized LOC111130523,10298
NC_035783.1,7138767,7150145,7138825,7150145,111130524,XM_022477673.1,uncharacterized LOC111130524,11320
NC_035783.1,7138767,7150145,7138767,7150145,111130524,XM_022477672.1,uncharacterized LOC111130524,11378
NC_035783.1,7168744,7170849,7168744,7170849,111130525,XM_022477674.1,uncharacterized LOC111130525,2105
NC_035783.1,23045659,23060050,23045659,23060050,111130532,XM_022477680.1,uncharacterized LOC111130532,14391
NC_035783.1,7370102,7380324,7370102,7380324,111130555,XM_022477705.1,uncharacterized LOC111130555,10222
NC_035783.1,7370102,7380324,7370102,7374387,111130555,XM_022477704.1,uncharacterized LOC111130555,4285
NC_035783.1,43797545,43798925,43797545,43798925,111130558,XM_022477708.1,uncharacterized LOC111130558,1380
NC_035783.1,51010974,51018398,51010974,51018398,111130571,XM_022477730.1,uncharacterized LOC111130571,7424
NC_035783.1,46577942,46579707,46577942,46579707,111130583,XM_022477748.1,uncharacterized LOC111130583,1765
NC_035783.1,51470436,51473722,51470436,51473722,111130584,XM_022477749.1,uncharacterized LOC111130584,3286
NC_035783.1,20144602,20148937,20145159,20148937,111130585,XM_022477751.1,uncharacterized LOC111130585,3778
NC_035783.1,20144602,20148937,20144602,20148937,111130585,XM_022477750.1,uncharacterized LOC111130585,4335
NC_035783.1,41189496,41193501,41189496,41193501,111130586,XM_022477752.1,uncharacterized LOC111130586,4005
NC_035783.1,49512326,49519677,49512326,49519668,111130587,XM_022477753.1,uncharacterized LOC111130587,7342
NC_035783.1,3330340,3333228,3330340,3332323,111130595,XM_022477762.1,uncharacterized LOC111130595,1983
NC_035783.1,3330340,3333228,3330348,3333228,111130595,XM_022477761.1,uncharacterized LOC111130595,2880
NC_035783.1,2669148,2673276,2669148,2673250,111130598,XM_022477764.1,uncharacterized LOC111130598,4102
NC_035783.1,16631710,16632943,16631710,16632943,111130605,XM_022477770.1,uncharacterized LOC111130605,1233
NC_035783.1,16632963,16633710,16632963,16633710,111130606,XM_022477771.1,uncharacterized LOC111130606,747
NC_035783.1,27209548,27212895,27209548,27212895,111130611,XM_022477777.1,uncharacterized LOC111130611,3347
NC_035783.1,27218906,27222762,27218906,27222762,111130613,XM_022477779.1,uncharacterized LOC111130613,3856
NC_035783.1,48004587,48006476,48004587,48006476,111130628,XM_022477793.1,uncharacterized LOC111130628,1889
NC_035783.1,42756753,42758988,42756753,42758988,111130635,XM_022477799.1,uncharacterized LOC111130635,2235
NC_035783.1,41283845,41290256,41284950,41290256,111130639,XM_022477805.1,uncharacterized LOC111130639,5306
NC_035783.1,41283845,41290256,41283845,41290256,111130639,XM_022477804.1,uncharacterized LOC111130639,6411
NC_035783.1,58627445,58628837,58627445,58628837,111130643,XM_022477810.1,uncharacterized LOC111130643,1392
NC_035783.1,31192988,31195062,31193443,31195062,111130648,XM_022477815.1,uncharacterized LOC111130648,1619
NC_035783.1,31192988,31195062,31193131,31195062,111130648,XM_022477817.1,uncharacterized LOC111130648,1931
NC_035783.1,31192988,31195062,31192988,31195062,111130648,XM_022477816.1,uncharacterized LOC111130648,2074
NC_035783.1,6393566,6404290,6393566,6404287,111130654,XM_022477829.1,uncharacterized LOC111130654,10721
NC_035783.1,6393566,6404290,6393566,6404290,111130654,XM_022477830.1,uncharacterized LOC111130654,10724
NC_035783.1,6393566,6404290,6394583,6404287,111130654,XM_022477831.1,uncharacterized LOC111130654,9704
NC_035783.1,6403058,6409393,6406003,6409393,111130655,XM_022477833.1,uncharacterized LOC111130655,3390
NC_035783.1,6403058,6409393,6403058,6409393,111130655,XM_022477834.1,uncharacterized LOC111130655,6335
NC_035783.1,27371805,27374762,27371805,27374762,111130658,XM_022477836.1,uncharacterized LOC111130658,2957
NC_035783.1,57473703,57484794,57473703,57484794,111130662,XM_022477840.1,uncharacterized LOC111130662,11091
NC_035783.1,2175689,2181258,2175689,2181258,111130663,XM_022477842.1,uncharacterized LOC111130663,5569
NC_035780.1,45507272,45523006,45507272,45523006,111130664,XM_022477884.1,uncharacterized LOC111130664,15734
NC_035783.1,31423218,31438551,31423218,31438551,111130669,XM_022477848.1,uncharacterized LOC111130669,15333
NC_035783.1,26020063,26023817,26020063,26023817,111130670,XM_022477849.1,uncharacterized LOC111130670,3754
NC_035783.1,48493020,48496028,48493020,48496028,111130686,XM_022477880.1,uncharacterized LOC111130686,3008
NC_035780.1,5090616,5128577,5090616,5128577,111130687,XM_022477885.1,uncharacterized LOC111130687,37961
NC_035783.1,3725823,3728412,3725823,3728412,111130694,XM_022477889.1,uncharacterized LOC111130694,2589
NC_035783.1,36240650,36287176,36240650,36287176,111130701,XM_022477901.1,uncharacterized LOC111130701,46526
NC_035783.1,55699223,55702996,55699223,55702996,111130703,XM_022477903.1,uncharacterized LOC111130703,3773
NC_035780.1,5226306,5247588,5226306,5247588,111130705,XM_022477909.1,uncharacterized LOC111130705,21282
NC_035783.1,13319366,13323954,13319366,13323874,111130712,XM_022477920.1,uncharacterized LOC111130712,4508
NC_035783.1,13319366,13323954,13319366,13323954,111130712,XM_022477919.1,uncharacterized LOC111130712,4588
NC_035783.1,56402605,56405224,56402605,56405224,111130713,XM_022477922.1,uncharacterized LOC111130713,2619
NC_035783.1,39860070,39868261,39860070,39868261,111130717,XM_022477927.1,uncharacterized LOC111130717,8191
NC_035783.1,47329357,47331132,47329357,47331132,111130721,XM_022477933.1,uncharacterized LOC111130721,1775
NC_035783.1,38207646,38209339,38207646,38209339,111130723,XM_022477934.1,uncharacterized LOC111130723,1693
NC_035783.1,13979581,13984927,13979581,13984927,111130727,XM_022477938.1,uncharacterized LOC111130727,5346
NC_035783.1,11787943,11794813,11787943,11794813,111130756,XM_022477983.1,uncharacterized LOC111130756,6870
NC_035783.1,37461055,37462725,37461055,37462725,111130757,XM_022477984.1,uncharacterized LOC111130757,1670
NC_035783.1,41884081,41892277,41884081,41892277,111130765,XM_022477997.1,uncharacterized LOC111130765,8196
NC_035783.1,40241144,40243127,40241144,40243127,111130782,XM_022478019.1,uncharacterized LOC111130782,1983
NC_035783.1,21051898,21055203,21051898,21055203,111130784,XM_022478021.1,uncharacterized LOC111130784,3305
NC_035783.1,1892440,1897170,1892440,1897170,111130786,XM_022478023.1,uncharacterized LOC111130786,4730
NC_035783.1,1897257,1901919,1897257,1901919,111130787,XM_022478024.1,uncharacterized LOC111130787,4662
NC_035783.1,3374406,3377824,3374406,3377824,111130788,XM_022478025.1,uncharacterized LOC111130788,3418
NC_035783.1,37779443,37789773,37779443,37789773,111130792,XM_022478032.1,uncharacterized LOC111130792,10330
NC_035783.1,50253247,50258428,50253247,50258428,111130794,XM_022478035.1,uncharacterized LOC111130794,5181
NC_035783.1,50259895,50263010,50259895,50263010,111130795,XM_022478036.1,uncharacterized LOC111130795,3115
NC_035783.1,778986,782211,778986,782193,111130798,XM_022478041.1,uncharacterized LOC111130798,3207
NC_035783.1,778986,782211,778986,782211,111130798,XM_022478040.1,uncharacterized LOC111130798,3225
NC_035783.1,42697839,42702061,42697839,42702061,111130800,XM_022478042.1,uncharacterized LOC111130800,4222
NC_035783.1,180052,181413,180052,181413,111130806,XM_022478052.1,uncharacterized LOC111130806,1361
NC_035783.1,8792914,8796396,8792914,8796396,111130807,XM_022478053.1,uncharacterized LOC111130807,3482
NC_035783.1,53038162,53041936,53038162,53041936,111130815,XM_022478058.1,uncharacterized LOC111130815,3774
NC_035783.1,8477457,8479918,8477457,8479918,111130823,XM_022478064.1,uncharacterized LOC111130823,2461
NC_035783.1,30813413,30822868,30813413,30822358,111130825,XM_022478068.1,uncharacterized LOC111130825,8945
NC_035783.1,30813413,30822868,30813413,30822868,111130825,XM_022478067.1,uncharacterized LOC111130825,9455
NC_035783.1,18234375,18246060,18234375,18246060,111130829,XM_022478072.1,uncharacterized LOC111130829,11685
NC_035783.1,18264069,18272593,18264069,18272593,111130830,XM_022478073.1,uncharacterized LOC111130830,8524
NC_035783.1,31473579,31475720,31473579,31475207,111130845,XM_022478095.1,uncharacterized LOC111130845,1628
NC_035783.1,31473579,31475720,31473579,31475720,111130845,XM_022478096.1,uncharacterized LOC111130845,2141
NC_035783.1,21125298,21132902,21125298,21132902,111130846,XM_022478097.1,uncharacterized LOC111130846,7604
NC_035780.1,7362650,7386171,7362650,7386171,111130848,XM_022478104.1,uncharacterized LOC111130848,23521
NC_035783.1,59521661,59525267,59521661,59525267,111130849,XM_022478101.1,uncharacterized LOC111130849,3606
NC_035783.1,37122470,37138919,37122470,37138919,111130858,XM_022478114.1,uncharacterized LOC111130858,16449
NC_035783.1,32386125,32390766,32386125,32390766,111130861,XM_022478118.1,uncharacterized LOC111130861,4641
NC_035783.1,54752789,54759242,54752789,54758128,111130862,XM_022478120.1,uncharacterized LOC111130862,5339
NC_035783.1,54752789,54759242,54752789,54759242,111130862,XM_022478119.1,uncharacterized LOC111130862,6453
NC_035783.1,37464046,37475567,37464046,37475567,111130868,XM_022478128.1,uncharacterized LOC111130868,11521
NC_035783.1,34910953,34914353,34910953,34913367,111130871,XM_022478132.1,uncharacterized LOC111130871,2414
NC_035783.1,34910953,34914353,34910953,34914353,111130871,XM_022478133.1,uncharacterized LOC111130871,3400
NC_035783.1,34914349,34920488,34915413,34920488,111130872,XM_022478135.1,uncharacterized LOC111130872,5075
NC_035783.1,34914349,34920488,34914349,34920488,111130872,XM_022478136.1,uncharacterized LOC111130872,6139
NC_035783.1,16313203,16318167,16313203,16318167,111130878,XM_022478145.1,uncharacterized LOC111130878,4964
NC_035783.1,47263571,47299833,47263571,47299833,111130887,XM_022478155.1,uncharacterized LOC111130887,36262
NC_035783.1,13627076,13639228,13627076,13639228,111130889,XM_022478158.1,uncharacterized LOC111130889,12152
NC_035783.1,31418021,31420706,31418021,31420706,111130893,XM_022478165.1,uncharacterized LOC111130893,2685
NC_035780.1,8102203,8103999,8102203,8103999,111130894,XM_022478169.1,uncharacterized LOC111130894,1796
NC_035783.1,1500659,1521764,1500659,1521764,111130895,XM_022478167.1,uncharacterized LOC111130895,21105
NC_035783.1,1437018,1441525,1437018,1441525,111130906,XM_022478178.1,uncharacterized LOC111130906,4507
NC_035783.1,21165361,21168956,21165361,21168956,111130911,XM_022478182.1,uncharacterized LOC111130911,3595
NC_035783.1,46927642,46936107,46927642,46936107,111130923,XM_022478208.1,uncharacterized LOC111130923,8465
NC_035783.1,34975583,34980069,34975583,34980069,111130928,XM_022478214.1,uncharacterized LOC111130928,4486
NC_035780.1,8381914,8388705,8381914,8388705,111130942,XM_022478242.1,uncharacterized LOC111130942,6791
NC_035783.1,1948477,1950181,1948477,1950181,111130947,XM_022478246.1,uncharacterized LOC111130947,1704
NC_035780.1,62741197,62750429,62741197,62750429,111130952,XM_022478254.1,uncharacterized LOC111130952,9232
NC_035783.1,2842610,2844606,2842610,2844606,111130957,XM_022478263.1,uncharacterized LOC111130957,1996
NC_035783.1,4232600,4237600,4232600,4237600,111130963,XM_022478269.1,uncharacterized LOC111130963,5000
NC_035783.1,3309355,3315809,3309355,3315249,111130965,XM_022478273.1,uncharacterized LOC111130965,5894
NC_035783.1,3309355,3315809,3309356,3315809,111130965,XM_022478272.1,uncharacterized LOC111130965,6453
NC_035783.1,50725513,50727894,50725513,50727894,111130975,XM_022478284.1,uncharacterized LOC111130975,2381
NC_035783.1,41606056,41611607,41606064,41611607,111130978,XM_022478288.1,uncharacterized LOC111130978,5543
NC_035783.1,41606056,41611607,41606056,41611607,111130978,XM_022478287.1,uncharacterized LOC111130978,5551
NC_035783.1,33753073,33755549,33753073,33755549,111130980,XM_022478291.1,uncharacterized LOC111130980,2476
NC_035783.1,7335123,7337170,7335123,7336559,111130984,XM_022478294.1,uncharacterized LOC111130984,1436
NC_035783.1,7335123,7337170,7335123,7337170,111130984,XM_022478295.1,uncharacterized LOC111130984,2047
NC_035783.1,11762984,11769820,11762984,11769820,111130989,XM_022478300.1,uncharacterized LOC111130989,6836
NC_035780.1,9143133,9157522,9143133,9157522,111130991,XM_022478306.1,uncharacterized LOC111130991,14389
NC_035783.1,36971282,36989121,36971282,36986512,111130995,XM_022478308.1,uncharacterized LOC111130995,15230
NC_035783.1,36971282,36989121,36971282,36989121,111130995,XM_022478309.1,uncharacterized LOC111130995,17839
NC_035780.1,9197675,9209800,9197675,9209800,111130999,XM_022478318.1,uncharacterized LOC111130999,12125
NC_035783.1,30973854,30976097,30973854,30976097,111131002,XM_022478319.1,uncharacterized LOC111131002,2243
NC_035783.1,25411262,25415747,25411262,25415747,111131008,XM_022478326.1,uncharacterized LOC111131008,4485
NC_035783.1,52430127,52435662,52430127,52435662,111131014,XM_022478333.1,uncharacterized LOC111131014,5535
NC_035780.1,9398174,9399067,9398174,9399067,111131018,XM_022478341.1,uncharacterized LOC111131018,893
NC_035783.1,3985457,4005293,3985457,4005293,111131024,XM_022478345.1,uncharacterized LOC111131024,19836
NC_035780.1,9778175,9779050,9778175,9779050,111131027,XM_022478353.1,uncharacterized LOC111131027,875
NC_035780.1,9879091,9880776,9879091,9880776,111131034,XM_022478365.1,uncharacterized LOC111131034,1685
NC_035783.1,24464800,24466972,24464800,24466972,111131037,XM_022478366.1,uncharacterized LOC111131037,2172
NC_035783.1,37837760,37842580,37837760,37842580,111131047,XM_022478376.1,uncharacterized LOC111131047,4820
NC_035783.1,29667051,29670624,29667052,29670613,111131055,XM_022478388.1,uncharacterized LOC111131055,3561
NC_035783.1,29667051,29670624,29667051,29670624,111131055,XM_022478386.1,uncharacterized LOC111131055,3573
NC_035783.1,176260,177774,176260,177774,111131064,XM_022478398.1,uncharacterized LOC111131064,1514
NC_035783.1,32901750,32906323,32901750,32906310,111131067,XM_022478402.1,uncharacterized LOC111131067,4560
NC_035783.1,32901750,32906323,32901750,32906323,111131067,XM_022478403.1,uncharacterized LOC111131067,4573
NC_035783.1,32911904,32920420,32911904,32920420,111131068,XM_022478404.1,uncharacterized LOC111131068,8516
NC_035783.1,30106052,30111631,30106052,30111631,111131069,XM_022478405.1,uncharacterized LOC111131069,5579
NC_035783.1,6714684,6715741,6714684,6715741,111131071,XM_022478410.1,uncharacterized LOC111131071,1057
NC_035783.1,35182527,35184733,35182527,35184733,111131072,XM_022478411.1,uncharacterized LOC111131072,2206
NC_035783.1,5943017,5953026,5943017,5953026,111131073,XM_022478412.1,uncharacterized LOC111131073,10009
NC_035783.1,5943017,5953026,5943017,5947224,111131073,XM_022478413.1,uncharacterized LOC111131073,4207
NC_035783.1,5943017,5953026,5943017,5949584,111131073,XM_022478414.1,uncharacterized LOC111131073,6567
NC_035783.1,5943017,5953026,5943017,5951361,111131073,XM_022478415.1,uncharacterized LOC111131073,8344
NC_035783.1,20149904,20152309,20149904,20152309,111131075,XM_022478416.1,uncharacterized LOC111131075,2405
NC_035783.1,39985530,40004936,39985530,39995851,111131080,XM_022478427.1,uncharacterized LOC111131080,10321
NC_035783.1,39985530,40004936,39985530,40001200,111131080,XM_022478423.1,uncharacterized LOC111131080,15670
NC_035783.1,39985530,40004936,39985530,40004936,111131080,XM_022478424.1,uncharacterized LOC111131080,19406
NC_035783.1,25938434,25946376,25938434,25946376,111131083,XM_022478431.1,uncharacterized LOC111131083,7942
NC_035783.1,53156060,53159944,53156060,53159944,111131088,XM_022478437.1,uncharacterized LOC111131088,3884
NC_035783.1,48094733,48098287,48094733,48098062,111131093,XM_022478442.1,uncharacterized LOC111131093,3329
NC_035783.1,48094733,48098287,48094733,48098275,111131093,XM_022478441.1,uncharacterized LOC111131093,3542
NC_035783.1,48094733,48098287,48094733,48098287,111131093,XM_022478440.1,uncharacterized LOC111131093,3554
NC_035783.1,45125028,45132686,45125028,45132686,111131098,XM_022478447.1,uncharacterized LOC111131098,7658
NC_035783.1,18853637,18860496,18853643,18860496,111131101,XM_022478473.1,uncharacterized LOC111131101,6853
NC_035783.1,18853637,18860496,18853637,18860496,111131101,XM_022478472.1,uncharacterized LOC111131101,6859
NC_035783.1,36583807,36586055,36583834,36586055,111131102,XM_022478474.1,uncharacterized LOC111131102,2221
NC_035783.1,38324080,38325712,38324080,38325712,111131109,XM_022478483.1,uncharacterized LOC111131109,1632
NC_035783.1,50544921,50550971,50544921,50550971,111131117,XM_022478494.1,uncharacterized LOC111131117,6050
NC_035783.1,46431284,46436579,46433889,46436579,111131118,XM_022478496.1,uncharacterized LOC111131118,2690
NC_035783.1,46431284,46436579,46431284,46436579,111131118,XM_022478495.1,uncharacterized LOC111131118,5295
NC_035780.1,10665347,10666253,10665347,10666253,111131125,XM_022478505.1,uncharacterized LOC111131125,906
NC_035783.1,37278132,37282052,37278132,37282052,111131130,XM_022478507.1,uncharacterized LOC111131130,3920
NC_035783.1,16397647,16399050,16397647,16399050,111131131,XM_022478508.1,uncharacterized LOC111131131,1403
NC_035783.1,35050263,35052550,35050263,35052550,111131132,XM_022478510.1,uncharacterized LOC111131132,2287
NC_035783.1,2751994,2753975,2751994,2753961,111131137,XM_022478516.1,uncharacterized LOC111131137,1967
NC_035783.1,2751994,2753975,2751995,2753972,111131137,XM_022478517.1,uncharacterized LOC111131137,1977
NC_035783.1,2751994,2753975,2751997,2753975,111131137,XM_022478515.1,uncharacterized LOC111131137,1978
NC_035783.1,44411857,44416295,44411857,44416295,111131145,XM_022478525.1,uncharacterized LOC111131145,4438
NC_035783.1,20402653,20408420,20402653,20408420,111131149,XM_022478549.1,uncharacterized LOC111131149,5767
NC_035783.1,7310673,7312323,7310673,7312323,111131150,XM_022478550.1,uncharacterized LOC111131150,1650
NC_035783.1,38844763,38854872,38844763,38854872,111131161,XM_022478562.1,uncharacterized LOC111131161,10109
NC_035783.1,49741740,49743284,49741740,49742906,111131162,XM_022478563.1,uncharacterized LOC111131162,1166
NC_035783.1,27448831,27456314,27448831,27456314,111131166,XM_022478570.1,uncharacterized LOC111131166,7483
NC_035783.1,7066696,7086487,7066696,7086487,111131169,XM_022478574.1,uncharacterized LOC111131169,19791
NC_035783.1,53904504,53910106,53904515,53910106,111131174,XM_022478585.1,uncharacterized LOC111131174,5591
NC_035783.1,53904504,53910106,53904512,53910106,111131174,XM_022478581.1,uncharacterized LOC111131174,5594
NC_035783.1,53904504,53910106,53904508,53910106,111131174,XM_022478580.1,uncharacterized LOC111131174,5598
NC_035783.1,53904504,53910106,53904506,53910106,111131174,XM_022478584.1,uncharacterized LOC111131174,5600
NC_035783.1,35305139,35310456,35305139,35310456,111131177,XM_022478588.1,uncharacterized LOC111131177,5317
NC_035783.1,16320676,16327628,16320676,16327623,111131181,XM_022478593.1,uncharacterized LOC111131181,6947
NC_035783.1,16320676,16327628,16320676,16327628,111131181,XM_022478592.1,uncharacterized LOC111131181,6952
NC_035783.1,46922497,46925516,46922497,46925516,111131183,XM_022478595.1,uncharacterized LOC111131183,3019
NC_035783.1,58631067,58632614,58631067,58632614,111131185,XM_022478598.1,uncharacterized LOC111131185,1547
NC_035783.1,25283873,25284784,25283873,25284784,111131192,XM_022478609.1,uncharacterized LOC111131192,911
NC_035783.1,56887392,56891474,56887392,56891474,111131194,XM_022478613.1,uncharacterized LOC111131194,4082
NC_035783.1,15559071,15561054,15559071,15561054,111131198,XM_022478617.1,uncharacterized LOC111131198,1983
NC_035783.1,11221608,11223138,11221608,11223138,111131202,XM_022478621.1,uncharacterized LOC111131202,1530
NC_035783.1,11232526,11234771,11232526,11234771,111131203,XM_022478622.1,uncharacterized LOC111131203,2245
NC_035783.1,3911636,3920096,3911636,3920096,111131204,XM_022478623.1,uncharacterized LOC111131204,8460
NC_035783.1,3895558,3909163,3895558,3909163,111131205,XM_022478624.1,uncharacterized LOC111131205,13605
NC_035783.1,3923044,3933749,3923044,3933749,111131206,XM_022478625.1,uncharacterized LOC111131206,10705
NC_035783.1,9024652,9029584,9024652,9029584,111131207,XM_022478627.1,uncharacterized LOC111131207,4932
NC_035783.1,21945349,21947757,21945349,21947757,111131211,XM_022478631.1,uncharacterized LOC111131211,2408
NC_035780.1,12339671,12341356,12339671,12341356,111131215,XM_022478640.1,uncharacterized LOC111131215,1685
NC_035783.1,4062849,4078266,4062849,4078266,111131221,XM_022478649.1,uncharacterized LOC111131221,15417
NC_035783.1,24658593,24661011,24658593,24661011,111131223,XM_022478650.1,uncharacterized LOC111131223,2418
NC_035783.1,37999025,38007836,37999025,38007836,111131234,XM_022478671.1,uncharacterized LOC111131234,8811
NC_035783.1,39330032,39332193,39330032,39332193,111131235,XM_022478672.1,uncharacterized LOC111131235,2161
NC_035783.1,27940618,27943887,27940618,27943887,111131236,XM_022478673.1,uncharacterized LOC111131236,3269
NC_035783.1,27943964,27947557,27943964,27946468,111131237,XM_022478674.1,uncharacterized LOC111131237,2504
NC_035783.1,27943964,27947557,27943964,27947557,111131237,XM_022478675.1,uncharacterized LOC111131237,3593
NC_035780.1,12832504,12835540,12832504,12835540,111131238,XM_022478678.1,uncharacterized LOC111131238,3036
NC_035783.1,44599532,44602045,44599532,44602045,111131246,XM_022478683.1,uncharacterized LOC111131246,2513
NC_035780.1,13136352,13163579,13136352,13163579,111131248,XM_022478686.1,uncharacterized LOC111131248,27227
NC_035783.1,5829229,5837925,5829229,5837925,111131250,XM_022478685.1,uncharacterized LOC111131250,8696
NC_035783.1,14279471,14280996,14279471,14280996,111131255,XM_022478689.1,uncharacterized LOC111131255,1525
NC_035780.1,13166202,13185062,13166202,13185062,111131259,XM_022478696.1,uncharacterized LOC111131259,18860
NC_035783.1,49955876,49957288,49955876,49957288,111131261,XM_022478694.1,uncharacterized LOC111131261,1412
NC_035783.1,1530162,1541615,1530162,1541615,111131262,XM_022478695.1,uncharacterized LOC111131262,11453
NC_035783.1,16998785,17004043,16998785,17004043,111131263,XM_022478698.1,uncharacterized LOC111131263,5258
NC_035783.1,35433857,35444120,35433857,35444120,111131265,XM_022478701.1,uncharacterized LOC111131265,10263
NC_035783.1,35433857,35444120,35433857,35440623,111131265,XM_022478704.1,uncharacterized LOC111131265,6766
NC_035783.1,35433857,35444120,35433857,35440827,111131265,XM_022478703.1,uncharacterized LOC111131265,6970
NC_035783.1,35433857,35444120,35433857,35440845,111131265,XM_022478702.1,uncharacterized LOC111131265,6988
NC_035783.1,44247314,44249252,44247314,44249252,111131275,XM_022478719.1,uncharacterized LOC111131275,1938
NC_035783.1,50991647,50996249,50991647,50996249,111131277,XM_022478721.1,uncharacterized LOC111131277,4602
NC_035783.1,5701010,5706846,5701010,5706846,111131279,XM_022478726.1,uncharacterized LOC111131279,5836
NC_035783.1,45604478,45606862,45604478,45606862,111131283,XM_022478729.1,uncharacterized LOC111131283,2384
NC_035783.1,34197527,34199453,34197527,34199429,111131286,XM_022478734.1,uncharacterized LOC111131286,1902
NC_035783.1,34197527,34199453,34197527,34199453,111131286,XM_022478733.1,uncharacterized LOC111131286,1926
NC_035783.1,43882046,43883971,43882046,43883947,111131287,XM_022478736.1,uncharacterized LOC111131287,1901
NC_035783.1,43882046,43883971,43882046,43883971,111131287,XM_022478735.1,uncharacterized LOC111131287,1925
NC_035783.1,42379168,42382507,42379168,42382507,111131291,XM_022478740.1,uncharacterized LOC111131291,3339
NC_035780.1,3953804,3966889,3953804,3966889,111131292,XM_022478782.1,uncharacterized LOC111131292,13085
NC_035783.1,4371886,4372934,4371886,4372934,111131297,XM_022478750.1,uncharacterized LOC111131297,1048
NC_035783.1,37770974,37774387,37770974,37774387,111131299,XM_022478751.1,uncharacterized LOC111131299,3413
NC_035783.1,39885371,39887542,39885371,39887542,111131304,XM_022478769.1,uncharacterized LOC111131304,2171
NC_035783.1,55074405,55085791,55074405,55085791,111131305,XM_022478770.1,uncharacterized LOC111131305,11386
NC_035783.1,22355325,22360090,22355325,22360090,111131307,XM_022478777.1,uncharacterized LOC111131307,4765
NC_035783.1,3762252,3764567,3762252,3764567,111131310,XM_022478779.1,uncharacterized LOC111131310,2315
NC_035783.1,10752819,10766363,10752819,10766363,111131311,XM_022478780.1,uncharacterized LOC111131311,13544
NC_035783.1,48968557,48973585,48968557,48973584,111131325,XM_022478799.1,uncharacterized LOC111131325,5027
NC_035783.1,48968557,48973585,48968557,48973585,111131325,XM_022478798.1,uncharacterized LOC111131325,5028
NC_035783.1,42161883,42166742,42161883,42166742,111131326,XM_022478800.1,uncharacterized LOC111131326,4859
NC_035783.1,36579468,36580652,36579468,36580652,111131331,XM_022478803.1,uncharacterized LOC111131331,1184
NC_035783.1,41480574,41482651,41480574,41482651,111131332,XM_022478804.1,uncharacterized LOC111131332,2077
NC_035783.1,55414180,55426416,55414180,55426416,111131337,XM_022478809.1,uncharacterized LOC111131337,12236
NC_035783.1,37149341,37151570,37149341,37151570,111131340,XM_022478812.1,uncharacterized LOC111131340,2229
NC_035783.1,14680126,14686769,14680126,14686769,111131343,XM_022478814.1,uncharacterized LOC111131343,6643
NC_035783.1,52235508,52263271,52253270,52263271,111131344,XM_022478825.1,uncharacterized LOC111131344,10001
NC_035783.1,52235508,52263271,52252985,52263271,111131344,XM_022478820.1,uncharacterized LOC111131344,10286
NC_035783.1,52235508,52263271,52246556,52263271,111131344,XM_022478818.1,uncharacterized LOC111131344,16715
NC_035783.1,52235508,52263271,52246552,52263271,111131344,XM_022478819.1,uncharacterized LOC111131344,16719
NC_035783.1,52235508,52263271,52240936,52263271,111131344,XM_022478821.1,uncharacterized LOC111131344,22335
NC_035783.1,52235508,52263271,52237129,52263271,111131344,XM_022478823.1,uncharacterized LOC111131344,26142
NC_035783.1,52235508,52263271,52235508,52263271,111131344,XM_022478822.1,uncharacterized LOC111131344,27763
NC_035783.1,40270213,40272165,40270213,40272165,111131354,XM_022478836.1,uncharacterized LOC111131354,1952
NC_035783.1,30082473,30094073,30082473,30094073,111131357,XM_022478839.1,uncharacterized LOC111131357,11600
NC_035783.1,30082473,30094073,30082473,30085069,111131357,XM_022478838.1,uncharacterized LOC111131357,2596
NC_035783.1,18199115,18203951,18199154,18203951,111131361,XM_022478844.1,uncharacterized LOC111131361,4797
NC_035783.1,18199115,18203951,18199115,18203951,111131361,XM_022478843.1,uncharacterized LOC111131361,4836
NC_035783.1,15498543,15504384,15498543,15504384,111131363,XM_022478845.1,uncharacterized LOC111131363,5841
NC_035780.1,12702661,12705837,12702661,12705837,111131366,XM_022478851.1,uncharacterized LOC111131366,3176
NC_035783.1,39876338,39877614,39876338,39877614,111131368,XM_022478849.1,uncharacterized LOC111131368,1276
NC_035783.1,6465612,6468280,6465612,6468280,111131372,XM_022478853.1,uncharacterized LOC111131372,2668
NC_035783.1,5924849,5939596,5924849,5939596,111131373,XM_022478854.1,uncharacterized LOC111131373,14747
NC_035783.1,5924849,5939596,5934052,5939596,111131373,XM_022478856.1,uncharacterized LOC111131373,5544
NC_035783.1,5924849,5939596,5931792,5939596,111131373,XM_022478855.1,uncharacterized LOC111131373,7804
NC_035783.1,2825529,2827739,2825529,2827739,111131378,XM_022478858.1,uncharacterized LOC111131378,2210
NC_035780.1,14066971,14080909,14066971,14080909,111131385,XM_022478873.1,uncharacterized LOC111131385,13938
NC_035783.1,36086163,36089542,36086163,36089542,111131390,XM_022478881.1,uncharacterized LOC111131390,3379
NC_035783.1,8394742,8395823,8394742,8395823,111131394,XM_022478883.1,uncharacterized LOC111131394,1081
NC_035783.1,54723955,54745112,54723955,54742631,111131395,XM_022478884.1,uncharacterized LOC111131395,18676
NC_035783.1,54723955,54745112,54723955,54742632,111131395,XM_022478888.1,uncharacterized LOC111131395,18677
NC_035783.1,54723955,54745112,54723955,54742829,111131395,XM_022478886.1,uncharacterized LOC111131395,18874
NC_035783.1,54723955,54745112,54723955,54745112,111131395,XM_022478887.1,uncharacterized LOC111131395,21157
NC_035783.1,38535401,38538778,38535401,38538778,111131402,XM_022478903.1,uncharacterized LOC111131402,3377
NC_035780.1,14681634,14695941,14681634,14695941,111131411,XM_022478925.1,uncharacterized LOC111131411,14307
NC_035783.1,4283739,4286050,4283739,4286050,111131416,XM_022478927.1,uncharacterized LOC111131416,2311
NC_035780.1,14744587,14764014,14744587,14764014,111131419,XM_022478938.1,uncharacterized LOC111131419,19427
NC_035783.1,1304527,1307469,1304527,1307469,111131420,XM_022478939.1,uncharacterized LOC111131420,2942
NC_035783.1,47067875,47073023,47067875,47073023,111131421,XM_022478940.1,uncharacterized LOC111131421,5148
NC_035783.1,6813681,6815313,6813681,6815313,111131423,XM_022478942.1,uncharacterized LOC111131423,1632
NC_035783.1,10413256,10414889,10413256,10414329,111131424,XM_022478943.1,uncharacterized LOC111131424,1073
NC_035780.1,14814638,14828641,14814638,14828641,111131426,XM_022478948.1,uncharacterized LOC111131426,14003
NC_035783.1,49732149,49733619,49732149,49733619,111131427,XM_022478945.1,uncharacterized LOC111131427,1470
NC_035783.1,2961541,2963520,2961541,2963520,111131431,XM_022478951.1,uncharacterized LOC111131431,1979
NC_035783.1,56009539,56011923,56009539,56011915,111131434,XM_022478955.1,uncharacterized LOC111131434,2376
NC_035783.1,56009539,56011923,56009539,56011923,111131434,XM_022478954.1,uncharacterized LOC111131434,2384
NC_035780.1,14873384,14884005,14873384,14884005,111131436,XM_022478961.1,uncharacterized LOC111131436,10621
NC_035783.1,43335333,43349626,43335333,43349626,111131442,XM_022478979.1,uncharacterized LOC111131442,14293
NC_035783.1,43354819,43373201,43354819,43373201,111131443,XM_022478980.1,uncharacterized LOC111131443,18382
NC_035783.1,26630196,26631215,26630196,26631215,111131444,XM_022478981.1,uncharacterized LOC111131444,1019
NC_035780.1,59324769,59348590,59324769,59341558,111131447,XM_022479335.1,uncharacterized LOC111131447,16789
NC_035780.1,59324769,59348590,59324769,59341559,111131447,XM_022479107.1,uncharacterized LOC111131447,16790
NC_035780.1,59324769,59348590,59324769,59346686,111131447,XM_022479261.1,uncharacterized LOC111131447,21917
NC_035780.1,59324769,59348590,59324769,59348590,111131447,XM_022479022.1,uncharacterized LOC111131447,23821
NC_035783.1,44489924,44494036,44489924,44494036,111131451,XM_022478986.1,uncharacterized LOC111131451,4112
NC_035783.1,48107767,48114171,48107767,48114002,111131455,XM_022478993.1,uncharacterized LOC111131455,6235
NC_035783.1,48107767,48114171,48107767,48114171,111131455,XM_022478992.1,uncharacterized LOC111131455,6404
NC_035780.1,15071862,15086213,15071862,15086213,111131458,XM_022478999.1,uncharacterized LOC111131458,14351
NC_035783.1,6163390,6188218,6163390,6184510,111131459,XM_022479000.1,uncharacterized LOC111131459,21120
NC_035783.1,6163390,6188218,6163390,6187517,111131459,XM_022478998.1,uncharacterized LOC111131459,24127
NC_035783.1,6163390,6188218,6163390,6188174,111131459,XM_022478997.1,uncharacterized LOC111131459,24784
NC_035783.1,6163390,6188218,6163390,6188195,111131459,XM_022478995.1,uncharacterized LOC111131459,24805
NC_035783.1,6163390,6188218,6163390,6188218,111131459,XM_022478996.1,uncharacterized LOC111131459,24828
NC_035783.1,35016309,35018619,35016309,35018619,111131463,XM_022479004.1,uncharacterized LOC111131463,2310
NC_035783.1,4271028,4272660,4271028,4272660,111131482,XM_022479030.1,uncharacterized LOC111131482,1632
NC_035783.1,24305748,24307986,24305748,24307986,111131485,XM_022479033.1,uncharacterized LOC111131485,2238
NC_035783.1,27533907,27568843,27533907,27568843,111131488,XM_022479040.1,uncharacterized LOC111131488,34936
NC_035783.1,27644136,27675749,27655655,27675746,111131489,XM_022479051.1,uncharacterized LOC111131489,20091
NC_035783.1,27644136,27675749,27649981,27675748,111131489,XM_022479050.1,uncharacterized LOC111131489,25767
NC_035783.1,27644136,27675749,27646112,27675749,111131489,XM_022479048.1,uncharacterized LOC111131489,29637
NC_035783.1,27644136,27675749,27644136,27675748,111131489,XM_022479049.1,uncharacterized LOC111131489,31612
NC_035783.1,27577662,27612227,27591587,27612227,111131490,XM_022479052.1,uncharacterized LOC111131490,20640
NC_035783.1,27577662,27612227,27589221,27612227,111131490,XM_022479053.1,uncharacterized LOC111131490,23006
NC_035783.1,27577662,27612227,27577682,27612227,111131490,XM_022479055.1,uncharacterized LOC111131490,34545
NC_035783.1,27577662,27612227,27577662,27612227,111131490,XM_022479054.1,uncharacterized LOC111131490,34565
NC_035780.1,15315031,15321152,15315031,15321152,111131491,XM_022479059.1,uncharacterized LOC111131491,6121
NC_035783.1,4030717,4044216,4030717,4044216,111131493,XM_022479058.1,uncharacterized LOC111131493,13499
NC_035783.1,12880877,12906354,12880877,12906354,111131498,XM_022479064.1,uncharacterized LOC111131498,25477
NC_035783.1,35902225,35904829,35902225,35904829,111131504,XM_022479074.1,uncharacterized LOC111131504,2604
NC_035783.1,32890315,32900137,32890315,32900136,111131516,XM_022479096.1,uncharacterized LOC111131516,9821
NC_035783.1,32890315,32900137,32890315,32900137,111131516,XM_022479098.1,uncharacterized LOC111131516,9822
NC_035783.1,28106979,28134580,28106979,28126651,111131519,XM_022479103.1,uncharacterized LOC111131519,19672
NC_035783.1,28106979,28134580,28106979,28134580,111131519,XM_022479102.1,uncharacterized LOC111131519,27601
NC_035783.1,28106979,28134580,28106979,28116571,111131519,XM_022479101.1,uncharacterized LOC111131519,9592
NC_035783.1,21159857,21162595,21159857,21162595,111131524,XM_022479112.1,uncharacterized LOC111131524,2738
NC_035783.1,4619242,4621872,4619242,4621872,111131532,XM_022479121.1,uncharacterized LOC111131532,2630
NC_035783.1,2421243,2425997,2421243,2425997,111131536,XM_022479126.1,uncharacterized LOC111131536,4754
NC_035783.1,20530926,20534301,20530926,20534301,111131540,XM_022479133.1,uncharacterized LOC111131540,3375
NC_035780.1,16052731,16066326,16052731,16066326,111131545,XM_022479141.1,uncharacterized LOC111131545,13595
NC_035783.1,41782417,41787402,41784618,41787402,111131559,XM_022479154.1,uncharacterized LOC111131559,2784
NC_035783.1,41782417,41787402,41782417,41787402,111131559,XM_022479153.1,uncharacterized LOC111131559,4985
NC_035783.1,37774783,37779207,37774783,37779207,111131562,XM_022479158.1,uncharacterized LOC111131562,4424
NC_035783.1,4182250,4188675,4182250,4188675,111131567,XM_022479163.1,uncharacterized LOC111131567,6425
NC_035783.1,35932619,35935540,35932619,35935540,111131582,XM_022479184.1,uncharacterized LOC111131582,2921
NC_035783.1,35929858,35932620,35930050,35932620,111131583,XM_022479186.1,uncharacterized LOC111131583,2570
NC_035783.1,35929858,35932620,35929858,35932620,111131583,XM_022479185.1,uncharacterized LOC111131583,2762
NC_035783.1,11265737,11268334,11265737,11268334,111131587,XM_022479191.1,uncharacterized LOC111131587,2597
NC_035783.1,24495344,24508157,24495344,24508157,111131592,XM_022479199.1,uncharacterized LOC111131592,12813
NC_035783.1,51065657,51090087,51065658,51090087,111131594,XM_022479200.1,uncharacterized LOC111131594,24429
NC_035783.1,51065657,51090087,51065657,51090087,111131594,XM_022479201.1,uncharacterized LOC111131594,24430
NC_035783.1,42759679,42764796,42759679,42764796,111131598,XM_022479206.1,uncharacterized LOC111131598,5117
NC_035783.1,12655657,12669546,12655657,12669546,111131601,XM_022479211.1,uncharacterized LOC111131601,13889
NC_035783.1,12655657,12669546,12655662,12664499,111131601,XM_022479212.1,uncharacterized LOC111131601,8837
NC_035783.1,21536590,21539721,21536590,21539721,111131602,XM_022479213.1,uncharacterized LOC111131602,3131
NC_035783.1,56627558,56630964,56627558,56630964,111131604,XM_022479215.1,uncharacterized LOC111131604,3406
NC_035783.1,31380551,31397796,31380551,31397796,111131605,XM_022479216.1,uncharacterized LOC111131605,17245
NC_035783.1,31382584,31383931,31382584,31383931,111131606,XM_022479217.1,uncharacterized LOC111131606,1347
NC_035783.1,56190673,56194518,56190673,56194518,111131607,XM_022479219.1,uncharacterized LOC111131607,3845
NC_035783.1,11797219,11799602,11797219,11799602,111131611,XM_022479222.1,uncharacterized LOC111131611,2383
NC_035783.1,3789241,3791053,3789241,3791053,111131612,XM_022479223.1,uncharacterized LOC111131612,1812
NC_035783.1,57736528,57739121,57736528,57739121,111131617,XM_022479229.1,uncharacterized LOC111131617,2593
NC_035783.1,26784879,26785849,26784879,26785849,111131618,XM_022479230.1,uncharacterized LOC111131618,970
NC_035783.1,4294739,4301428,4294739,4301428,111131619,XM_022479232.1,uncharacterized LOC111131619,6689
NC_035783.1,6815468,6826680,6815468,6826680,111131621,XM_022479234.1,uncharacterized LOC111131621,11212
NC_035783.1,10496246,10498197,10496246,10498197,111131622,XM_022479235.1,uncharacterized LOC111131622,1951
NC_035783.1,22040448,22057102,22040453,22057096,111131623,XM_022479237.1,uncharacterized LOC111131623,16643
NC_035783.1,22040448,22057102,22040448,22057102,111131623,XM_022479236.1,uncharacterized LOC111131623,16654
NC_035783.1,35924587,35926772,35924587,35926772,111131624,XM_022479238.1,uncharacterized LOC111131624,2185
NC_035783.1,38319159,38323421,38319159,38323421,111131627,XM_022479241.1,uncharacterized LOC111131627,4262
NC_035783.1,20553073,20557787,20553589,20557787,111131629,XM_022479243.1,uncharacterized LOC111131629,4198
NC_035783.1,20553073,20557787,20553073,20557787,111131629,XM_022479244.1,uncharacterized LOC111131629,4714
NC_035783.1,59214225,59217193,59214225,59216971,111131634,XM_022479255.1,uncharacterized LOC111131634,2746
NC_035783.1,59214225,59217193,59214225,59217193,111131634,XM_022479254.1,uncharacterized LOC111131634,2968
NC_035783.1,45571617,45582803,45571617,45582803,111131636,XM_022479258.1,uncharacterized LOC111131636,11186
NC_035783.1,4258410,4270875,4258410,4270875,111131639,XM_022479263.1,uncharacterized LOC111131639,12465
NC_035783.1,19611205,19621722,19611205,19621722,111131642,XM_022479267.1,uncharacterized LOC111131642,10517
NC_035783.1,18330787,18345936,18330787,18345936,111131659,XM_022479286.1,uncharacterized LOC111131659,15149
NC_035783.1,18321310,18330534,18321310,18328117,111131661,XM_022479289.1,uncharacterized LOC111131661,6807
NC_035783.1,18321310,18330534,18321310,18328613,111131661,XM_022479293.1,uncharacterized LOC111131661,7303
NC_035783.1,18321310,18330534,18321310,18329398,111131661,XM_022479287.1,uncharacterized LOC111131661,8088
NC_035783.1,18321310,18330534,18321310,18330524,111131661,XM_022479292.1,uncharacterized LOC111131661,9214
NC_035783.1,18321310,18330534,18321310,18330532,111131661,XM_022479288.1,uncharacterized LOC111131661,9222
NC_035783.1,18321310,18330534,18321310,18330534,111131661,XM_022479290.1,uncharacterized LOC111131661,9224
NC_035783.1,42766671,42769716,42766671,42769716,111131665,XM_022479300.1,uncharacterized LOC111131665,3045
NC_035783.1,38540956,38545211,38540956,38545211,111131670,XM_022479306.1,uncharacterized LOC111131670,4255
NC_035783.1,6898432,6906496,6898432,6906496,111131672,XM_022479308.1,uncharacterized LOC111131672,8064
NC_035783.1,13872986,13878879,13873102,13878879,111131678,XM_022479313.1,uncharacterized LOC111131678,5777
NC_035783.1,13872986,13878879,13872986,13878879,111131678,XM_022479314.1,uncharacterized LOC111131678,5893
NC_035783.1,3943879,3972306,3943879,3972306,111131680,XM_022479317.1,uncharacterized LOC111131680,28427
NC_035783.1,3973797,3978967,3973797,3978967,111131681,XM_022479318.1,uncharacterized LOC111131681,5170
NC_035783.1,38211784,38224939,38211784,38224939,111131685,XM_022479321.1,uncharacterized LOC111131685,13155
NC_035783.1,6800783,6801844,6800783,6801844,111131701,XM_022479345.1,uncharacterized LOC111131701,1061
NC_035783.1,57755039,57768473,57755039,57768473,111131702,XM_022479349.1,uncharacterized LOC111131702,13434
NC_035783.1,57755039,57768473,57765549,57768473,111131702,XM_022479347.1,uncharacterized LOC111131702,2924
NC_035783.1,57755039,57768473,57755041,57762737,111131702,XM_022479348.1,uncharacterized LOC111131702,7696
NC_035783.1,6644032,6654641,6644032,6654641,111131708,XM_022479357.1,uncharacterized LOC111131708,10609
NC_035783.1,6644032,6654641,6645090,6654641,111131708,XM_022479358.1,uncharacterized LOC111131708,9551
NC_035783.1,7112261,7127791,7112261,7127791,111131709,XM_022479359.1,uncharacterized LOC111131709,15530
NC_035783.1,7099346,7110296,7099346,7110296,111131710,XM_022479360.1,uncharacterized LOC111131710,10950
NC_035783.1,42423186,42428788,42423186,42426525,111131712,XM_022479364.1,uncharacterized LOC111131712,3339
NC_035783.1,42423186,42428788,42423186,42428788,111131712,XM_022479365.1,uncharacterized LOC111131712,5602
NC_035783.1,42423186,42428788,42423186,42424131,111131712,XM_022479363.1,uncharacterized LOC111131712,945
NC_035783.1,17959438,17971195,17959468,17971195,111131714,XM_022479368.1,uncharacterized LOC111131714,11727
NC_035783.1,17959438,17971195,17959438,17971195,111131714,XM_022479367.1,uncharacterized LOC111131714,11757
NC_035783.1,17937235,17957336,17937235,17957336,111131715,XM_022479369.1,uncharacterized LOC111131715,20101
NC_035783.1,17942593,17946582,17942593,17946582,111131716,XM_022479371.1,uncharacterized LOC111131716,3989
NC_035783.1,53150367,53153277,53150367,53153277,111131722,XM_022479379.1,uncharacterized LOC111131722,2910
NC_035783.1,57787997,57789522,57787997,57789522,111131723,XM_022479380.1,uncharacterized LOC111131723,1525
NC_035783.1,57782864,57784271,57782864,57784271,111131724,XM_022479381.1,uncharacterized LOC111131724,1407
NC_035783.1,42851922,42855359,42851923,42855343,111131727,XM_022479393.1,uncharacterized LOC111131727,3420
NC_035783.1,42851922,42855359,42851922,42855359,111131727,XM_022479391.1,uncharacterized LOC111131727,3437
NC_035783.1,42359617,42373706,42359617,42373706,111131732,XM_022479398.1,uncharacterized LOC111131732,14089
NC_035783.1,7572748,7575409,7572748,7575409,111131734,XM_022479401.1,uncharacterized LOC111131734,2661
NC_035783.1,37315603,37326944,37315603,37326944,111131736,XM_022479405.1,uncharacterized LOC111131736,11341
NC_035783.1,37315603,37326944,37315603,37320694,111131736,XM_022479404.1,uncharacterized LOC111131736,5091
NC_035783.1,37315603,37326944,37315603,37323120,111131736,XM_022479403.1,uncharacterized LOC111131736,7517
NC_035783.1,59194930,59196861,59194930,59196861,111131742,XM_022479413.1,uncharacterized LOC111131742,1931
NC_035783.1,12950722,12957937,12950722,12957937,111131745,XM_022479416.1,uncharacterized LOC111131745,7215
NC_035780.1,54990984,54996722,54990984,54996722,111131746,XM_022479458.1,uncharacterized LOC111131746,5738
NC_035783.1,38046251,38057487,38046251,38057487,111131754,XM_022479430.1,uncharacterized LOC111131754,11236
NC_035783.1,38046251,38057487,38046251,38051360,111131754,XM_022479429.1,uncharacterized LOC111131754,5109
NC_035783.1,38046251,38057487,38046251,38054006,111131754,XM_022479427.1,uncharacterized LOC111131754,7755
NC_035783.1,30170407,30174366,30170407,30174366,111131761,XM_022479440.1,uncharacterized LOC111131761,3959
NC_035783.1,39945348,39949579,39945348,39949579,111131762,XM_022479441.1,uncharacterized LOC111131762,4231
NC_035783.1,6345688,6348449,6345688,6348449,111131774,XM_022479478.1,uncharacterized LOC111131774,2761
NC_035783.1,45254179,45268035,45254179,45268035,111131783,XM_022479485.1,uncharacterized LOC111131783,13856
NC_035783.1,57391124,57400608,57391735,57400608,111131785,XM_022479487.1,uncharacterized LOC111131785,8873
NC_035783.1,57391124,57400608,57391127,57400606,111131785,XM_022479488.1,uncharacterized LOC111131785,9479
NC_035783.1,57391124,57400608,57391124,57400608,111131785,XM_022479486.1,uncharacterized LOC111131785,9484
NC_035783.1,55985603,55988686,55985825,55988686,111131789,XM_022479494.1,uncharacterized LOC111131789,2861
NC_035783.1,55985603,55988686,55985603,55988686,111131789,XM_022479493.1,uncharacterized LOC111131789,3083
NC_035783.1,25439829,25443303,25439829,25443303,111131790,XM_022479495.1,uncharacterized LOC111131790,3474
NC_035783.1,19598913,19600843,19598913,19600843,111131796,XM_022479503.1,uncharacterized LOC111131796,1930
NC_035783.1,58411439,58416982,58411439,58416982,111131802,XM_022479509.1,uncharacterized LOC111131802,5543
NC_035783.1,47591592,47593594,47591592,47593254,111131803,XM_022479511.1,uncharacterized LOC111131803,1662
NC_035783.1,47591592,47593594,47591592,47593262,111131803,XM_022479512.1,uncharacterized LOC111131803,1670
NC_035783.1,47591592,47593594,47591592,47593594,111131803,XM_022479513.1,uncharacterized LOC111131803,2002
NC_035783.1,48876125,48877977,48876125,48877977,111131808,XM_022479524.1,uncharacterized LOC111131808,1852
NC_035783.1,3593855,3603645,3593858,3603636,111131813,XM_022479530.1,uncharacterized LOC111131813,9778
NC_035783.1,3593855,3603645,3593856,3603641,111131813,XM_022479529.1,uncharacterized LOC111131813,9785
NC_035783.1,3593855,3603645,3593856,3603645,111131813,XM_022479531.1,uncharacterized LOC111131813,9789
NC_035780.1,24891858,24896854,24891858,24896854,111131820,XM_022479578.1,uncharacterized LOC111131820,4996
NC_035783.1,3387095,3394667,3387095,3394667,111131821,XM_022479538.1,uncharacterized LOC111131821,7572
NC_035783.1,24242262,24245140,24242262,24245140,111131827,XM_022479551.1,uncharacterized LOC111131827,2878
NC_035783.1,9859025,9862209,9859025,9862209,111131831,XM_022479555.1,uncharacterized LOC111131831,3184
NC_035783.1,15816440,15819923,15816440,15819923,111131832,XM_022479556.1,uncharacterized LOC111131832,3483
NC_035783.1,14918902,14927726,14918902,14927726,111131841,XM_022479571.1,uncharacterized LOC111131841,8824
NC_035783.1,57284562,57288362,57284562,57288362,111131845,XM_022479577.1,uncharacterized LOC111131845,3800
NC_035783.1,940273,942486,940273,942486,111131847,XM_022479582.1,uncharacterized LOC111131847,2213
NC_035783.1,56143405,56154626,56143432,56154626,111131853,XM_022479592.1,uncharacterized LOC111131853,11194
NC_035783.1,56143405,56154626,56143405,56154625,111131853,XM_022479590.1,uncharacterized LOC111131853,11220
NC_035783.1,34209151,34216373,34211684,34216373,111131855,XM_022479596.1,uncharacterized LOC111131855,4689
NC_035783.1,34209151,34216373,34211450,34216373,111131855,XM_022479594.1,uncharacterized LOC111131855,4923
NC_035783.1,34209151,34216373,34209151,34216373,111131855,XM_022479595.1,uncharacterized LOC111131855,7222
NC_035783.1,44431288,44468600,44431670,44468600,111131863,XM_022479606.1,uncharacterized LOC111131863,36930
NC_035783.1,44431288,44468600,44431288,44468600,111131863,XM_022479605.1,uncharacterized LOC111131863,37312
NC_035783.1,44468319,44478570,44468319,44478570,111131865,XM_022479608.1,uncharacterized LOC111131865,10251
NC_035780.1,47807510,47822882,47807510,47822882,111131869,XM_022479615.1,uncharacterized LOC111131869,15372
NC_035783.1,17284208,17284952,17284208,17284952,111131873,XM_022479636.1,uncharacterized LOC111131873,744
NC_035783.1,16411552,16417979,16411552,16417979,111131874,XM_022479637.1,uncharacterized LOC111131874,6427
NC_035780.1,24806863,24810201,24806863,24810201,111132009,XM_022479681.1,uncharacterized LOC111132009,3338
NC_035784.1,3691496,3693544,3691496,3693544,111132025,XM_022479654.1,uncharacterized LOC111132025,2048
NC_035784.1,28042453,28046083,28042453,28046083,111132026,XM_022479655.1,uncharacterized LOC111132026,3630
NC_035784.1,95191868,95194998,95191868,95194998,111132027,XM_022479656.1,uncharacterized LOC111132027,3130
NC_035784.1,61873090,61874088,61873090,61874088,111132032,XM_022479666.1,uncharacterized LOC111132032,998
NC_035784.1,7867067,7878853,7867067,7878853,111132034,XM_022479667.1,uncharacterized LOC111132034,11786
NC_035784.1,61980807,62004055,61980807,62004055,111132044,XM_022479678.1,uncharacterized LOC111132044,23248
NC_035784.1,68800374,68803990,68800374,68803950,111132045,XM_022479680.1,uncharacterized LOC111132045,3576
NC_035784.1,68800374,68803990,68800374,68803959,111132045,XM_022479683.1,uncharacterized LOC111132045,3585
NC_035784.1,68800374,68803990,68800375,68803990,111132045,XM_022479679.1,uncharacterized LOC111132045,3615
NC_035784.1,27409412,27410977,27409412,27410977,111132048,XM_022479686.1,uncharacterized LOC111132048,1565
NC_035784.1,65987999,65994438,65987999,65994186,111132056,XM_022479694.1,uncharacterized LOC111132056,6187
NC_035784.1,65987999,65994438,65988000,65994438,111132056,XM_022479695.1,uncharacterized LOC111132056,6438
NC_035784.1,74344907,74351932,74344907,74351932,111132061,XM_022479709.1,uncharacterized LOC111132061,7025
NC_035784.1,75718000,75723165,75718000,75723165,111132064,XM_022479713.1,uncharacterized LOC111132064,5165
NC_035780.1,55472896,55477154,55472896,55476088,111132069,XM_022479754.1,uncharacterized LOC111132069,3192
NC_035780.1,55472896,55477154,55472896,55476096,111132069,XM_022479740.1,uncharacterized LOC111132069,3200
NC_035780.1,55472896,55477154,55472896,55476123,111132069,XM_022479745.1,uncharacterized LOC111132069,3227
NC_035780.1,55472896,55477154,55472896,55477154,111132069,XM_022479730.1,uncharacterized LOC111132069,4258
NC_035784.1,64422404,64424710,64422404,64424710,111132071,XM_022479720.1,uncharacterized LOC111132071,2306
NC_035784.1,83081565,83084038,83081565,83084038,111132074,XM_022479725.1,uncharacterized LOC111132074,2473
NC_035784.1,55307433,55313411,55307433,55313411,111132076,XM_022479727.1,uncharacterized LOC111132076,5978
NC_035784.1,82577687,82589676,82577687,82589676,111132079,XM_022479731.1,uncharacterized LOC111132079,11989
NC_035784.1,82577687,82589676,82588068,82589676,111132079,XM_022479733.1,uncharacterized LOC111132079,1608
NC_035784.1,82577687,82589676,82584857,82589676,111132079,XM_022479732.1,uncharacterized LOC111132079,4819
NC_035784.1,82577687,82589676,82583828,82589676,111132079,XM_022479734.1,uncharacterized LOC111132079,5848
NC_035784.1,83199863,83214855,83199863,83212253,111132081,XM_022479737.1,uncharacterized LOC111132081,12390
NC_035784.1,83199863,83214855,83199863,83212262,111132081,XM_022479736.1,uncharacterized LOC111132081,12399
NC_035784.1,83199863,83214855,83199863,83214855,111132081,XM_022479738.1,uncharacterized LOC111132081,14992
NC_035784.1,83190275,83193121,83190275,83193121,111132082,XM_022479739.1,uncharacterized LOC111132082,2846
NC_035784.1,41315217,41316730,41315217,41316730,111132085,XM_022479742.1,uncharacterized LOC111132085,1513
NC_035784.1,41318027,41320096,41318027,41320096,111132086,XM_022479743.1,uncharacterized LOC111132086,2069
NC_035784.1,74817020,74820376,74817020,74820376,111132087,XM_022479744.1,uncharacterized LOC111132087,3356
NC_035780.1,16766282,16785023,16766282,16785023,111132096,XM_022479809.1,uncharacterized LOC111132096,18741
NC_035784.1,58142900,58165216,58148609,58165216,111132098,XM_022479766.1,uncharacterized LOC111132098,16607
NC_035784.1,58142900,58165216,58142900,58165216,111132098,XM_022479767.1,uncharacterized LOC111132098,22316
NC_035784.1,58142900,58165216,58159880,58164976,111132098,XM_022479769.1,uncharacterized LOC111132098,5096
NC_035784.1,21396586,21417659,21396586,21416007,111132099,XM_022479771.1,uncharacterized LOC111132099,19421
NC_035784.1,21396586,21417659,21396586,21417642,111132099,XM_022479775.1,uncharacterized LOC111132099,21056
NC_035784.1,21396586,21417659,21396586,21417659,111132099,XM_022479773.1,uncharacterized LOC111132099,21073
NC_035784.1,45187307,45235812,45194066,45235789,111132100,XM_022479781.1,uncharacterized LOC111132100,41723
NC_035784.1,45187307,45235812,45194066,45235807,111132100,XM_022479779.1,uncharacterized LOC111132100,41741
NC_035784.1,45187307,45235812,45194066,45235812,111132100,XM_022479777.1,uncharacterized LOC111132100,41746
NC_035784.1,45187307,45235812,45187307,45235812,111132100,XM_022479780.1,uncharacterized LOC111132100,48505
NC_035784.1,3171856,3173578,3171856,3173578,111132101,XM_022479782.1,uncharacterized LOC111132101,1722
NC_035784.1,64721026,64728744,64721026,64728744,111132106,XM_022479790.1,uncharacterized LOC111132106,7718
NC_035784.1,64750468,64757199,64750468,64757199,111132108,XM_022479799.1,uncharacterized LOC111132108,6731
NC_035784.1,95161809,95174426,95161809,95174426,111132111,XM_022479802.1,uncharacterized LOC111132111,12617
NC_035784.1,95182386,95184804,95182386,95184804,111132112,XM_022479803.1,uncharacterized LOC111132112,2418
NC_035784.1,95150723,95153743,95150723,95153743,111132113,XM_022479805.1,uncharacterized LOC111132113,3020
NC_035784.1,95171304,95174320,95171304,95174320,111132114,XM_022479806.1,uncharacterized LOC111132114,3016
NC_035784.1,32584508,32600799,32584509,32600799,111132119,XM_022479831.1,uncharacterized LOC111132119,16290
NC_035784.1,32584508,32600799,32584508,32600799,111132119,XM_022479830.1,uncharacterized LOC111132119,16291
NC_035780.1,55422472,55423416,55422472,55423416,111132122,XM_022479839.1,uncharacterized LOC111132122,944
NC_035784.1,37046799,37048677,37046799,37048677,111132125,XM_022479848.1,uncharacterized LOC111132125,1878
NC_035784.1,37028810,37059427,37030144,37059427,111132127,XM_022479849.1,uncharacterized LOC111132127,29283
NC_035784.1,51015660,51020092,51015660,51020092,111132142,XM_022479873.1,uncharacterized LOC111132142,4432
NC_035784.1,51005745,51012170,51005745,51012170,111132143,XM_022479874.1,uncharacterized LOC111132143,6425
NC_035784.1,86994634,86996316,86994634,86996316,111132150,XM_022479891.1,uncharacterized LOC111132150,1682
NC_035784.1,50492587,50503953,50492587,50503953,111132151,XM_022479893.1,uncharacterized LOC111132151,11366
NC_035784.1,50492587,50503953,50494285,50503953,111132151,XM_022479892.1,uncharacterized LOC111132151,9668
NC_035784.1,39609188,39616081,39610998,39616081,111132152,XM_022479898.1,uncharacterized LOC111132152,5083
NC_035784.1,39609188,39616081,39609801,39616081,111132152,XM_022479896.1,uncharacterized LOC111132152,6280
NC_035784.1,39609188,39616081,39609553,39616081,111132152,XM_022479895.1,uncharacterized LOC111132152,6528
NC_035784.1,39609188,39616081,39609389,39616081,111132152,XM_022479894.1,uncharacterized LOC111132152,6692
NC_035784.1,39609188,39616081,39609188,39616081,111132152,XM_022479897.1,uncharacterized LOC111132152,6893
NC_035784.1,39605546,39609600,39605546,39609600,111132153,XM_022479899.1,uncharacterized LOC111132153,4054
NC_035784.1,276211,295815,276211,295815,111132164,XM_022479918.1,uncharacterized LOC111132164,19604
NC_035784.1,6584577,6601514,6584577,6601514,111132170,XM_022479930.1,uncharacterized LOC111132170,16937
NC_035784.1,86978811,86981293,86978811,86981293,111132173,XM_022479936.1,uncharacterized LOC111132173,2482
NC_035784.1,35887972,35894948,35887972,35894948,111132174,XM_022479937.1,uncharacterized LOC111132174,6976
NC_035784.1,84993661,84994491,84993661,84994491,111132177,XM_022479940.1,uncharacterized LOC111132177,830
NC_035784.1,27404534,27406376,27404534,27406376,111132187,XM_022479957.1,uncharacterized LOC111132187,1842
NC_035784.1,42599905,42608333,42599910,42608333,111132188,XM_022479958.1,uncharacterized LOC111132188,8423
NC_035784.1,42599905,42608333,42599907,42608332,111132188,XM_022479963.1,uncharacterized LOC111132188,8425
NC_035784.1,42599905,42608333,42599905,42608333,111132188,XM_022479962.1,uncharacterized LOC111132188,8428
NC_035780.1,48098382,48108616,48098382,48108616,111132193,XM_022479971.1,uncharacterized LOC111132193,10234
NC_035784.1,95131669,95134806,95131669,95134806,111132197,XM_022479973.1,uncharacterized LOC111132197,3137
NC_035784.1,28859108,28862351,28859108,28862351,111132198,XM_022479974.1,uncharacterized LOC111132198,3243
NC_035784.1,90756200,90774404,90756200,90774404,111132199,XM_022479975.1,uncharacterized LOC111132199,18204
NC_035784.1,45375756,45422765,45375756,45403297,111132200,XM_022479979.1,uncharacterized LOC111132200,27541
NC_035784.1,45375756,45422765,45375756,45422750,111132200,XM_022479977.1,uncharacterized LOC111132200,46994
NC_035784.1,45375756,45422765,45375756,45422765,111132200,XM_022479978.1,uncharacterized LOC111132200,47009
NC_035780.1,8778017,8782462,8778028,8782462,111132201,XM_022479990.1,uncharacterized LOC111132201,4434
NC_035780.1,8778017,8782462,8778017,8782462,111132201,XM_022479982.1,uncharacterized LOC111132201,4445
NC_035784.1,90478385,90482376,90479726,90482376,111132208,XM_022479986.1,uncharacterized LOC111132208,2650
NC_035784.1,90478385,90482376,90478385,90482376,111132208,XM_022479985.1,uncharacterized LOC111132208,3991
NC_035784.1,34247987,34252120,34247987,34252120,111132209,XM_022479987.1,uncharacterized LOC111132209,4133
NC_035784.1,17116389,17133692,17116389,17133692,111132219,XM_022480008.1,uncharacterized LOC111132219,17303
NC_035784.1,17280257,17281642,17280257,17281642,111132221,XM_022480010.1,uncharacterized LOC111132221,1385
NC_035784.1,17285128,17286516,17285128,17286516,111132222,XM_022480011.1,uncharacterized LOC111132222,1388
NC_035784.1,17508947,17511370,17508947,17511370,111132225,XM_022480013.1,uncharacterized LOC111132225,2423
NC_035784.1,17593133,17598566,17593133,17598566,111132226,XM_022480014.1,uncharacterized LOC111132226,5433
NC_035784.1,18423034,18423759,18423034,18423759,111132229,XM_022480017.1,uncharacterized LOC111132229,725
NC_035784.1,20110204,20120922,20110204,20120922,111132239,XM_022480030.1,uncharacterized LOC111132239,10718
NC_035784.1,20884635,20891822,20884635,20891822,111132241,XM_022480032.1,uncharacterized LOC111132241,7187
NC_035784.1,21421631,21422251,21421631,21422251,111132243,XM_022480033.1,uncharacterized LOC111132243,620
NC_035784.1,22765819,22770219,22765819,22770219,111132245,XM_022480036.1,uncharacterized LOC111132245,4400
NC_035784.1,23888089,23889414,23888089,23889414,111132249,XM_022480040.1,uncharacterized LOC111132249,1325
NC_035784.1,24487234,24490878,24487234,24490878,111132252,XM_022480044.1,uncharacterized LOC111132252,3644
NC_035784.1,24670696,24690668,24670696,24690668,111132253,XM_022480045.1,uncharacterized LOC111132253,19972
NC_035784.1,25050052,25052297,25050052,25052297,111132255,XM_022480047.1,uncharacterized LOC111132255,2245
NC_035784.1,25070372,25071553,25070372,25071553,111132256,XM_022480048.1,uncharacterized LOC111132256,1181
NC_035784.1,25126704,25130373,25126704,25130373,111132257,XM_022480049.1,uncharacterized LOC111132257,3669
NC_035784.1,25132647,25136564,25132647,25136564,111132258,XM_022480050.1,uncharacterized LOC111132258,3917
NC_035784.1,25210095,25220717,25210095,25220717,111132265,XM_022480058.1,uncharacterized LOC111132265,10622
NC_035784.1,26286874,26288636,26286874,26288636,111132273,XM_022480065.1,uncharacterized LOC111132273,1762
NC_035784.1,27235253,27249628,27235253,27249628,111132276,XM_022480068.1,uncharacterized LOC111132276,14375
NC_035784.1,27250195,27257943,27250195,27257943,111132277,XM_022480069.1,uncharacterized LOC111132277,7748
NC_035784.1,27385790,27387858,27385790,27387858,111132278,XM_022480071.1,uncharacterized LOC111132278,2068
NC_035784.1,27722393,27728064,27722393,27728064,111132279,XM_022480072.1,uncharacterized LOC111132279,5671
NC_035784.1,28349082,28352612,28349082,28352612,111132282,XM_022480075.1,uncharacterized LOC111132282,3530
NC_035784.1,28421920,28437242,28421920,28437242,111132283,XM_022480076.1,uncharacterized LOC111132283,15322
NC_035784.1,29120811,29142696,29120811,29142696,111132291,XM_022480085.1,uncharacterized LOC111132291,21885
NC_035784.1,29236158,29243044,29236158,29243044,111132292,XM_022480086.1,uncharacterized LOC111132292,6886
NC_035784.1,29464732,29470602,29464732,29470602,111132293,XM_022480088.1,uncharacterized LOC111132293,5870
NC_035784.1,29490164,29495891,29490164,29495891,111132294,XM_022480089.1,uncharacterized LOC111132294,5727
NC_035784.1,30894466,30895590,30894466,30895590,111132300,XM_022480096.1,uncharacterized LOC111132300,1124
NC_035784.1,30899133,30903065,30899133,30903065,111132302,XM_022480098.1,uncharacterized LOC111132302,3932
NC_035784.1,31295026,31306442,31295026,31306442,111132304,XM_022480101.1,uncharacterized LOC111132304,11416
NC_035784.1,31400672,31418996,31400672,31418996,111132305,XM_022480102.1,uncharacterized LOC111132305,18324
NC_035784.1,73005006,73006796,73005006,73006796,111132306,XM_022480103.1,uncharacterized LOC111132306,1790
NC_035784.1,31688453,31742236,31688453,31742236,111132307,XM_022480104.1,uncharacterized LOC111132307,53783
NC_035784.1,32791443,32792161,32791443,32792161,111132310,XM_022480107.1,uncharacterized LOC111132310,718
NC_035784.1,33351990,33362007,33351990,33362007,111132313,XM_022480110.1,uncharacterized LOC111132313,10017
NC_035784.1,33985159,33986994,33985159,33986994,111132316,XM_022480114.1,uncharacterized LOC111132316,1835
NC_035784.1,34428136,34442044,34428136,34442044,111132323,XM_022480124.1,uncharacterized LOC111132323,13908
NC_035784.1,34568692,34571315,34568692,34571315,111132324,XM_022480125.1,uncharacterized LOC111132324,2623
NC_035784.1,36090900,36098931,36090900,36098931,111132336,XM_022480138.1,uncharacterized LOC111132336,8031
NC_035784.1,36805522,36818876,36805522,36818876,111132337,XM_022480139.1,uncharacterized LOC111132337,13354
NC_035784.1,37201565,37213179,37201565,37213179,111132339,XM_022480141.1,uncharacterized LOC111132339,11614
NC_035784.1,37230224,37240810,37230224,37240810,111132340,XM_022480142.1,uncharacterized LOC111132340,10586
NC_035784.1,37589050,37609423,37589050,37609423,111132341,XM_022480143.1,uncharacterized LOC111132341,20373
NC_035784.1,79258666,79276112,79265938,79276112,111132343,XM_022480147.1,uncharacterized LOC111132343,10174
NC_035784.1,79258666,79276112,79258666,79276112,111132343,XM_022480146.1,uncharacterized LOC111132343,17446
NC_035784.1,37757641,37774018,37757641,37774018,111132344,XM_022480148.1,uncharacterized LOC111132344,16377
NC_035784.1,38193608,38196743,38193608,38196743,111132345,XM_022480149.1,uncharacterized LOC111132345,3135
NC_035784.1,38230810,38239747,38230810,38239747,111132346,XM_022480150.1,uncharacterized LOC111132346,8937
NC_035784.1,38667709,38670648,38667709,38670648,111132350,XM_022480153.1,uncharacterized LOC111132350,2939
NC_035784.1,38702609,38703843,38702609,38703843,111132352,XM_022480154.1,uncharacterized LOC111132352,1234
NC_035784.1,38798493,38799927,38798493,38799927,111132353,XM_022480156.1,uncharacterized LOC111132353,1434
NC_035784.1,38824516,38827830,38824516,38827830,111132355,XM_022480158.1,uncharacterized LOC111132355,3314
NC_035784.1,38827876,38829591,38827876,38829591,111132356,XM_022480159.1,uncharacterized LOC111132356,1715
NC_035784.1,38981263,38995460,38981263,38995460,111132358,XM_022480161.1,uncharacterized LOC111132358,14197
NC_035784.1,39235777,39236518,39235777,39236518,111132359,XM_022480163.1,uncharacterized LOC111132359,741
NC_035784.1,39870173,39875757,39870173,39875757,111132363,XM_022480167.1,uncharacterized LOC111132363,5584
NC_035784.1,40741262,40744036,40741262,40744036,111132364,XM_022480168.1,uncharacterized LOC111132364,2774
NC_035784.1,40960409,40963393,40960409,40963393,111132367,XM_022480170.1,uncharacterized LOC111132367,2984
NC_035784.1,41415645,41422683,41415645,41422683,111132370,XM_022480173.1,uncharacterized LOC111132370,7038
NC_035784.1,41696878,41698768,41696878,41698768,111132371,XM_022480174.1,uncharacterized LOC111132371,1890
NC_035784.1,41943802,41946301,41943802,41946301,111132374,XM_022480176.1,uncharacterized LOC111132374,2499
NC_035784.1,42054253,42065895,42054253,42065895,111132376,XM_022480179.1,uncharacterized LOC111132376,11642
NC_035784.1,42464813,42497349,42464813,42497349,111132377,XM_022480180.1,uncharacterized LOC111132377,32536
NC_035784.1,42928157,42931254,42928157,42931254,111132379,XM_022480182.1,uncharacterized LOC111132379,3097
NC_035784.1,42990714,42997258,42990714,42997258,111132380,XM_022480183.1,uncharacterized LOC111132380,6544
NC_035784.1,32206211,32216376,32206211,32216376,111132382,XM_022480185.1,uncharacterized LOC111132382,10165
NC_035784.1,43026974,43028254,43026974,43028254,111132385,XM_022480186.1,uncharacterized LOC111132385,1280
NC_035784.1,43291885,43294485,43291885,43294485,111132386,XM_022480187.1,uncharacterized LOC111132386,2600
NC_035784.1,43765261,43766388,43765261,43766388,111132388,XM_022480190.1,uncharacterized LOC111132388,1127
NC_035784.1,44835805,44837718,44835805,44837718,111132393,XM_022480195.1,uncharacterized LOC111132393,1913
NC_035780.1,27982409,27987135,27982409,27987135,111132395,XM_022480231.1,uncharacterized LOC111132395,4726
NC_035784.1,45094673,45101736,45094673,45101736,111132396,XM_022480198.1,uncharacterized LOC111132396,7063
NC_035784.1,46283125,46298418,46283125,46298418,111132398,XM_022480200.1,uncharacterized LOC111132398,15293
NC_035784.1,46650198,46663282,46650198,46663282,111132400,XM_022480202.1,uncharacterized LOC111132400,13084
NC_035784.1,46681231,46685448,46681231,46685448,111132401,XM_022480203.1,uncharacterized LOC111132401,4217
NC_035784.1,47053702,47061319,47053702,47061319,111132404,XM_022480206.1,uncharacterized LOC111132404,7617
NC_035784.1,47424384,47429806,47424384,47429806,111132407,XM_022480209.1,uncharacterized LOC111132407,5422
NC_035784.1,47455128,47455655,47455128,47455655,111132408,XM_022480210.1,uncharacterized LOC111132408,527
NC_035780.1,63613929,63627214,63613929,63627214,111132409,XM_022480243.1,uncharacterized LOC111132409,13285
NC_035780.1,63613929,63627214,63615588,63623220,111132409,XM_022480235.1,uncharacterized LOC111132409,7632
NC_035780.1,63613929,63627214,63614064,63623220,111132409,XM_022480227.1,uncharacterized LOC111132409,9156
NC_035780.1,63613929,63627214,63613947,63623220,111132409,XM_022480220.1,uncharacterized LOC111132409,9273
NC_035780.1,63613929,63627214,63613929,63623220,111132409,XM_022480214.1,uncharacterized LOC111132409,9291
NC_035784.1,47551943,47561986,47551943,47561986,111132410,XM_022480211.1,uncharacterized LOC111132410,10043
NC_035784.1,48190147,48192207,48190147,48192207,111132413,XM_022480215.1,uncharacterized LOC111132413,2060
NC_035784.1,48498478,48501003,48498478,48501003,111132417,XM_022480219.1,uncharacterized LOC111132417,2525
NC_035784.1,48559032,48584010,48559032,48584010,111132418,XM_022480221.1,uncharacterized LOC111132418,24978
NC_035784.1,48619386,48623487,48619386,48623487,111132419,XM_022480222.1,uncharacterized LOC111132419,4101
NC_035784.1,48840203,48840667,48840203,48840667,111132421,XM_022480224.1,uncharacterized LOC111132421,464
NC_035784.1,49401614,49405314,49401614,49405314,111132422,XM_022480225.1,uncharacterized LOC111132422,3700
NC_035784.1,49544189,49544617,49544189,49544617,111132424,XM_022480228.1,uncharacterized LOC111132424,428
NC_035784.1,28357484,28361056,28357484,28361056,111132426,XM_022480230.1,uncharacterized LOC111132426,3572
NC_035784.1,49711554,49712733,49711554,49712733,111132428,XM_022480233.1,uncharacterized LOC111132428,1179
NC_035784.1,49745460,49748598,49745460,49748598,111132429,XM_022480234.1,uncharacterized LOC111132429,3138
NC_035784.1,49809045,49814326,49809045,49814326,111132430,XM_022480236.1,uncharacterized LOC111132430,5281
NC_035784.1,7158697,7164828,7158697,7164828,111132431,XM_022480237.1,uncharacterized LOC111132431,6131
NC_035784.1,51323584,51325851,51323584,51325851,111132434,XM_022480240.1,uncharacterized LOC111132434,2267
NC_035784.1,51615261,51626179,51615261,51626179,111132439,XM_022480246.1,uncharacterized LOC111132439,10918
NC_035784.1,51660085,51668496,51660085,51668496,111132440,XM_022480247.1,uncharacterized LOC111132440,8411
NC_035784.1,52321880,52336061,52321880,52336061,111132442,XM_022480249.1,uncharacterized LOC111132442,14181
NC_035784.1,52419763,52423377,52419763,52423377,111132443,XM_022480251.1,uncharacterized LOC111132443,3614
NC_035784.1,53052085,53056893,53052085,53056893,111132446,XM_022480254.1,uncharacterized LOC111132446,4808
NC_035784.1,53108551,53109807,53108551,53109807,111132447,XM_022480255.1,uncharacterized LOC111132447,1256
NC_035784.1,53452571,53454791,53452571,53454791,111132453,XM_022480260.1,uncharacterized LOC111132453,2220
NC_035784.1,53545509,53547796,53545509,53547796,111132456,XM_022480267.1,uncharacterized LOC111132456,2287
NC_035784.1,53642879,53650068,53642879,53650068,111132459,XM_022480269.1,uncharacterized LOC111132459,7189
NC_035784.1,53926931,53929717,53926931,53929717,111132460,XM_022480270.1,uncharacterized LOC111132460,2786
NC_035784.1,55081035,55083014,55081035,55083014,111132466,XM_022480277.1,uncharacterized LOC111132466,1979
NC_035784.1,55322518,55324281,55322518,55324281,111132468,XM_022480279.1,uncharacterized LOC111132468,1763
NC_035784.1,55330958,55334991,55330958,55334991,111132469,XM_022480280.1,uncharacterized LOC111132469,4033
NC_035784.1,55678184,55679775,55678184,55679775,111132470,XM_022480281.1,uncharacterized LOC111132470,1591
NC_035784.1,55680679,55725362,55680679,55725362,111132471,XM_022480282.1,uncharacterized LOC111132471,44683
NC_035784.1,56048926,56060372,56048926,56060372,111132472,XM_022480284.1,uncharacterized LOC111132472,11446
NC_035784.1,56819753,56823025,56819753,56823025,111132477,XM_022480287.1,uncharacterized LOC111132477,3272
NC_035784.1,56873092,56874817,56873092,56874817,111132478,XM_022480288.1,uncharacterized LOC111132478,1725
NC_035784.1,57146184,57162538,57146184,57162538,111132479,XM_022480290.1,uncharacterized LOC111132479,16354
NC_035784.1,57641213,57657587,57641213,57657587,111132482,XM_022480293.1,uncharacterized LOC111132482,16374
NC_035784.1,57809990,57810973,57809990,57810973,111132484,XM_022480294.1,uncharacterized LOC111132484,983
NC_035784.1,57904420,57907701,57904420,57907701,111132486,XM_022480296.1,uncharacterized LOC111132486,3281
NC_035784.1,15294069,15295376,15294069,15295376,111132487,XM_022480297.1,uncharacterized LOC111132487,1307
NC_035784.1,58664172,58667956,58664172,58667956,111132488,XM_022480298.1,uncharacterized LOC111132488,3784
NC_035784.1,58671493,58672617,58671493,58672617,111132490,XM_022480300.1,uncharacterized LOC111132490,1124
NC_035784.1,45103978,45117742,45103978,45117742,111132491,XM_022480302.1,uncharacterized LOC111132491,13764
NC_035784.1,45117756,45126485,45117756,45122467,111132493,XM_022480305.1,uncharacterized LOC111132493,4711
NC_035784.1,45117756,45126485,45117756,45122686,111132493,XM_022480303.1,uncharacterized LOC111132493,4930
NC_035784.1,45117756,45126485,45117756,45126480,111132493,XM_022480306.1,uncharacterized LOC111132493,8724
NC_035784.1,45117756,45126485,45117756,45126485,111132493,XM_022480304.1,uncharacterized LOC111132493,8729
NC_035784.1,10202197,10207704,10202197,10207704,111132496,XM_022480312.1,uncharacterized LOC111132496,5507
NC_035784.1,59387065,59388876,59387065,59388876,111132500,XM_022480316.1,uncharacterized LOC111132500,1811
NC_035784.1,59389483,59394108,59389483,59394108,111132501,XM_022480317.1,uncharacterized LOC111132501,4625
NC_035784.1,59396650,59398146,59396650,59398146,111132502,XM_022480319.1,uncharacterized LOC111132502,1496
NC_035784.1,60054313,60056819,60054313,60056819,111132504,XM_022480321.1,uncharacterized LOC111132504,2506
NC_035784.1,60303068,60304174,60303068,60304174,111132505,XM_022480322.1,uncharacterized LOC111132505,1106
NC_035784.1,60477674,60504656,60477674,60504656,111132506,XM_022480323.1,uncharacterized LOC111132506,26982
NC_035784.1,60909167,60910498,60909167,60910498,111132507,XM_022480324.1,uncharacterized LOC111132507,1331
NC_035784.1,60972589,60973557,60972589,60973557,111132509,XM_022480327.1,uncharacterized LOC111132509,968
NC_035784.1,61002401,61013684,61002401,61013684,111132510,XM_022480328.1,uncharacterized LOC111132510,11283
NC_035784.1,61031266,61039464,61031266,61039464,111132511,XM_022480329.1,uncharacterized LOC111132511,8198
NC_035784.1,61237509,61244296,61237509,61244296,111132513,XM_022480331.1,uncharacterized LOC111132513,6787
NC_035784.1,61844431,61845696,61844431,61845696,111132515,XM_022480334.1,uncharacterized LOC111132515,1265
NC_035784.1,61847717,61848621,61847717,61848621,111132516,XM_022480335.1,uncharacterized LOC111132516,904
NC_035784.1,63077893,63082277,63077893,63082277,111132517,XM_022480336.1,uncharacterized LOC111132517,4384
NC_035784.1,63302291,63319616,63302291,63319616,111132519,XM_022480338.1,uncharacterized LOC111132519,17325
NC_035784.1,63412402,63415796,63412402,63415796,111132520,XM_022480342.1,uncharacterized LOC111132520,3394
NC_035784.1,63590658,63605531,63590658,63605531,111132521,XM_022480343.1,uncharacterized LOC111132521,14873
NC_035784.1,63623870,63631907,63623870,63631907,111132522,XM_022480344.1,uncharacterized LOC111132522,8037
NC_035784.1,24953951,24956933,24953951,24956933,111132525,XM_022480346.1,uncharacterized LOC111132525,2982
NC_035784.1,64686930,64712060,64686930,64712060,111132529,XM_022480351.1,uncharacterized LOC111132529,25130
NC_035784.1,64954872,64968853,64954872,64968853,111132530,XM_022480352.1,uncharacterized LOC111132530,13981
NC_035784.1,64969001,64970269,64969001,64970269,111132531,XM_022480353.1,uncharacterized LOC111132531,1268
NC_035784.1,65360026,65368153,65360026,65368153,111132534,XM_022480357.1,uncharacterized LOC111132534,8127
NC_035784.1,65513010,65513450,65513010,65513450,111132535,XM_022480358.1,uncharacterized LOC111132535,440
NC_035784.1,66614095,66615982,66614095,66615982,111132537,XM_022480360.1,uncharacterized LOC111132537,1887
NC_035784.1,66628140,66631305,66628140,66631305,111132538,XM_022480361.1,uncharacterized LOC111132538,3165
NC_035784.1,66770586,66773050,66770586,66773050,111132539,XM_022480362.1,uncharacterized LOC111132539,2464
NC_035784.1,66941927,66947629,66941927,66947629,111132540,XM_022480364.1,uncharacterized LOC111132540,5702
NC_035784.1,68120103,68138926,68120103,68138926,111132543,XM_022480366.1,uncharacterized LOC111132543,18823
NC_035784.1,68484168,68485619,68484168,68485619,111132544,XM_022480367.1,uncharacterized LOC111132544,1451
NC_035784.1,69500290,69506406,69500290,69506406,111132553,XM_022480376.1,uncharacterized LOC111132553,6116
NC_035784.1,69747491,69748029,69747491,69748029,111132555,XM_022480378.1,uncharacterized LOC111132555,538
NC_035784.1,69848320,69849928,69848320,69849928,111132557,XM_022480381.1,uncharacterized LOC111132557,1608
NC_035784.1,57059468,57062416,57059468,57062416,111132562,XM_022480386.1,uncharacterized LOC111132562,2948
NC_035784.1,71924262,71952125,71924262,71952125,111132566,XM_022480391.1,uncharacterized LOC111132566,27863
NC_035784.1,72117359,72118532,72117359,72118532,111132568,XM_022480393.1,uncharacterized LOC111132568,1173
NC_035784.1,72149756,72200638,72149756,72200638,111132569,XM_022480394.1,uncharacterized LOC111132569,50882
NC_035780.1,6784469,6796441,6784476,6796441,111132570,XM_022480405.1,uncharacterized LOC111132570,11965
NC_035780.1,6784469,6796441,6784469,6796441,111132570,XM_022480398.1,uncharacterized LOC111132570,11972
NC_035784.1,72453685,72456017,72453685,72456017,111132572,XM_022480396.1,uncharacterized LOC111132572,2332
NC_035784.1,72595635,72597008,72595635,72597008,111132575,XM_022480400.1,uncharacterized LOC111132575,1373
NC_035784.1,72595457,72609073,72595457,72609073,111132576,XM_022480401.1,uncharacterized LOC111132576,13616
NC_035784.1,73883217,73884698,73883217,73884698,111132583,XM_022480411.1,uncharacterized LOC111132583,1481
NC_035784.1,74330834,74334933,74330834,74334933,111132584,XM_022480412.1,uncharacterized LOC111132584,4099
NC_035784.1,6212622,6218767,6212622,6218767,111132586,XM_022480416.1,uncharacterized LOC111132586,6145
NC_035784.1,74747711,74748838,74747711,74748838,111132588,XM_022480418.1,uncharacterized LOC111132588,1127
NC_035784.1,74752375,74756307,74752375,74756307,111132590,XM_022480420.1,uncharacterized LOC111132590,3932
NC_035780.1,6626250,6630796,6626250,6630796,111132592,XM_022480425.1,uncharacterized LOC111132592,4546
NC_035784.1,75420957,75443800,75420957,75443800,111132594,XM_022480423.1,uncharacterized LOC111132594,22843
NC_035784.1,75474656,75494206,75474656,75494206,111132595,XM_022480424.1,uncharacterized LOC111132595,19550
NC_035784.1,75755212,75756243,75755212,75756243,111132598,XM_022480428.1,uncharacterized LOC111132598,1031
NC_035784.1,76223411,76241107,76223411,76241107,111132600,XM_022480430.1,uncharacterized LOC111132600,17696
NC_035784.1,76271566,76298414,76271566,76298414,111132602,XM_022480432.1,uncharacterized LOC111132602,26848
NC_035780.1,6676126,6717050,6676126,6694856,111132603,XM_022480435.1,uncharacterized LOC111132603,18730
NC_035780.1,6676126,6717050,6676126,6702131,111132603,XM_022480446.1,uncharacterized LOC111132603,26005
NC_035780.1,6676126,6717050,6676126,6717050,111132603,XM_022480439.1,uncharacterized LOC111132603,40924
NC_035784.1,76640967,76668530,76640967,76668530,111132609,XM_022480436.1,uncharacterized LOC111132609,27563
NC_035784.1,77136709,77140808,77136709,77140808,111132611,XM_022480437.1,uncharacterized LOC111132611,4099
NC_035784.1,77141351,77142467,77141351,77142467,111132612,XM_022480438.1,uncharacterized LOC111132612,1116
NC_035784.1,77484086,77499863,77484086,77499863,111132613,XM_022480440.1,uncharacterized LOC111132613,15777
NC_035784.1,77611052,77611378,77611052,77611378,111132614,XM_022480441.1,uncharacterized LOC111132614,326
NC_035784.1,77907896,77917940,77907896,77917940,111132615,XM_022480442.1,uncharacterized LOC111132615,10044
NC_035784.1,77987357,77988082,77987357,77988082,111132617,XM_022480444.1,uncharacterized LOC111132617,725
NC_035784.1,78923869,78924884,78923869,78924884,111132619,XM_022480447.1,uncharacterized LOC111132619,1015
NC_035784.1,79473785,79474630,79473785,79474630,111132621,XM_022480449.1,uncharacterized LOC111132621,845
NC_035784.1,80104274,80108166,80104274,80108166,111132634,XM_022480460.1,uncharacterized LOC111132634,3892
NC_035784.1,80277394,80287204,80277394,80287204,111132635,XM_022480461.1,uncharacterized LOC111132635,9810
NC_035784.1,80591169,80596883,80591169,80596883,111132641,XM_022480467.1,uncharacterized LOC111132641,5714
NC_035784.1,92181845,92184460,92181845,92184460,111132643,XM_022480469.1,uncharacterized LOC111132643,2615
NC_035784.1,92109225,92122313,92109225,92122313,111132644,XM_022480470.1,uncharacterized LOC111132644,13088
NC_035784.1,92138261,92211965,92138261,92211965,111132645,XM_022480471.1,uncharacterized LOC111132645,73704
NC_035784.1,92128169,92140839,92128169,92140839,111132646,XM_022480472.1,uncharacterized LOC111132646,12670
NC_035784.1,80987809,80990913,80987809,80990913,111132652,XM_022480478.1,uncharacterized LOC111132652,3104
NC_035784.1,81142182,81143572,81142182,81143572,111132654,XM_022480480.1,uncharacterized LOC111132654,1390
NC_035780.1,54056039,54080164,54064073,54078414,111132656,XM_022480515.1,uncharacterized LOC111132656,14341
NC_035780.1,54056039,54080164,54061142,54078414,111132656,XM_022480748.1,uncharacterized LOC111132656,17272
NC_035780.1,54056039,54080164,54060766,54078414,111132656,XM_022480660.1,uncharacterized LOC111132656,17648
NC_035780.1,54056039,54080164,54058417,54078414,111132656,XM_022480580.1,uncharacterized LOC111132656,19997
NC_035780.1,54056039,54080164,54056039,54078414,111132656,XM_022481001.1,uncharacterized LOC111132656,22375
NC_035780.1,54056039,54080164,54056039,54080164,111132656,XM_022480835.1,uncharacterized LOC111132656,24125
NC_035780.1,6637619,6641442,6637619,6641442,111132666,XM_022480495.1,uncharacterized LOC111132666,3823
NC_035784.1,82320587,82327499,82320587,82327499,111132669,XM_022480494.1,uncharacterized LOC111132669,6912
NC_035784.1,83670524,83672570,83670524,83672570,111132674,XM_022480500.1,uncharacterized LOC111132674,2046
NC_035784.1,83950985,83952559,83950985,83952559,111132675,XM_022480501.1,uncharacterized LOC111132675,1574
NC_035780.1,6642642,6650302,6642642,6650302,111132676,XM_022480505.1,uncharacterized LOC111132676,7660
NC_035784.1,84117478,84138086,84117478,84138086,111132677,XM_022480502.1,uncharacterized LOC111132677,20608
NC_035784.1,84303477,84305008,84303477,84305008,111132678,XM_022480503.1,uncharacterized LOC111132678,1531
NC_035784.1,84738630,84740318,84738630,84740318,111132680,XM_022480506.1,uncharacterized LOC111132680,1688
NC_035784.1,85799907,85803237,85799907,85803237,111132682,XM_022480508.1,uncharacterized LOC111132682,3330
NC_035784.1,86281030,86281851,86281030,86281851,111132683,XM_022480509.1,uncharacterized LOC111132683,821
NC_035784.1,86463999,86465152,86463999,86465152,111132684,XM_022480510.1,uncharacterized LOC111132684,1153
NC_035784.1,86465158,86467334,86465158,86467334,111132685,XM_022480511.1,uncharacterized LOC111132685,2176
NC_035780.1,6651017,6651989,6651017,6651989,111132686,XM_022480516.1,uncharacterized LOC111132686,972
NC_035784.1,87192716,87193577,87192716,87193577,111132687,XM_022480512.1,uncharacterized LOC111132687,861
NC_035784.1,87516657,87532438,87516657,87532438,111132689,XM_022480514.1,uncharacterized LOC111132689,15781
NC_035784.1,87552754,87553695,87552754,87553695,111132690,XM_022480517.1,uncharacterized LOC111132690,941
NC_035784.1,87698728,87702699,87698728,87702699,111132691,XM_022480518.1,uncharacterized LOC111132691,3971
NC_035784.1,88081142,88106541,88081142,88106541,111132694,XM_022480520.1,uncharacterized LOC111132694,25399
NC_035784.1,88269592,88270802,88269592,88270802,111132695,XM_022480521.1,uncharacterized LOC111132695,1210
NC_035784.1,88468062,88471569,88468062,88471569,111132697,XM_022480522.1,uncharacterized LOC111132697,3507
NC_035784.1,88600282,88601859,88600282,88601859,111132698,XM_022480523.1,uncharacterized LOC111132698,1577
NC_035784.1,88999306,89000586,88999306,89000586,111132701,XM_022480526.1,uncharacterized LOC111132701,1280
NC_035784.1,89042542,89045341,89042542,89045341,111132702,XM_022480527.1,uncharacterized LOC111132702,2799
NC_035784.1,89147619,89149151,89147619,89149151,111132703,XM_022480528.1,uncharacterized LOC111132703,1532
NC_035784.1,89155193,89156071,89155193,89156071,111132705,XM_022480529.1,uncharacterized LOC111132705,878
NC_035784.1,89163597,89164736,89163597,89164736,111132706,XM_022480530.1,uncharacterized LOC111132706,1139
NC_035780.1,15675728,15677962,15675728,15677962,111132711,XM_022480542.1,uncharacterized LOC111132711,2234
NC_035784.1,89612381,89613865,89612381,89613865,111132712,XM_022480535.1,uncharacterized LOC111132712,1484
NC_035784.1,89693472,89694956,89693472,89694956,111132713,XM_022480536.1,uncharacterized LOC111132713,1484
NC_035784.1,89874932,89876960,89874932,89876960,111132715,XM_022480538.1,uncharacterized LOC111132715,2028
NC_035784.1,89912835,89914160,89912835,89914160,111132716,XM_022480539.1,uncharacterized LOC111132716,1325
NC_035784.1,89914227,89915562,89914227,89915562,111132717,XM_022480540.1,uncharacterized LOC111132717,1335
NC_035784.1,89933709,89940352,89933709,89940352,111132718,XM_022480541.1,uncharacterized LOC111132718,6643
NC_035784.1,90465360,90466856,90465360,90466856,111132719,XM_022480543.1,uncharacterized LOC111132719,1496
NC_035784.1,90550823,90552950,90550823,90552950,111132721,XM_022480545.1,uncharacterized LOC111132721,2127
NC_035784.1,1117888,1122962,1117888,1122962,111132722,XM_022480546.1,uncharacterized LOC111132722,5074
NC_035784.1,90824443,90825936,90824443,90825936,111132723,XM_022480547.1,uncharacterized LOC111132723,1493
NC_035784.1,91102270,91102989,91102270,91102989,111132724,XM_022480548.1,uncharacterized LOC111132724,719
NC_035780.1,15669756,15674561,15669758,15672076,111132726,XM_022480552.1,uncharacterized LOC111132726,2318
NC_035784.1,91600991,91601665,91600991,91601665,111132729,XM_022480551.1,uncharacterized LOC111132729,674
NC_035784.1,91790605,91791855,91790605,91791855,111132730,XM_022480553.1,uncharacterized LOC111132730,1250
NC_035784.1,91861358,91867868,91861358,91867868,111132731,XM_022480554.1,uncharacterized LOC111132731,6510
NC_035784.1,91976628,91978292,91976628,91978292,111132732,XM_022480555.1,uncharacterized LOC111132732,1664
NC_035784.1,92044874,92048296,92044874,92048296,111132733,XM_022480556.1,uncharacterized LOC111132733,3422
NC_035784.1,92167092,92168165,92167092,92168165,111132734,XM_022480557.1,uncharacterized LOC111132734,1073
NC_035784.1,92187738,92188253,92187738,92188253,111132735,XM_022480558.1,uncharacterized LOC111132735,515
NC_035784.1,92341583,92344955,92341583,92344955,111132736,XM_022480559.1,uncharacterized LOC111132736,3372
NC_035784.1,92406385,92407812,92406385,92407812,111132737,XM_022480560.1,uncharacterized LOC111132737,1427
NC_035784.1,92416882,92418140,92416882,92418140,111132738,XM_022480561.1,uncharacterized LOC111132738,1258
NC_035780.1,15714977,15720353,15714977,15720353,111132740,XM_022480564.1,uncharacterized LOC111132740,5376
NC_035784.1,92567828,92568274,92567828,92568274,111132744,XM_022480565.1,uncharacterized LOC111132744,446
NC_035784.1,92680328,92682583,92680328,92682583,111132745,XM_022480566.1,uncharacterized LOC111132745,2255
NC_035784.1,93847121,93859125,93847121,93859125,111132750,XM_022480569.1,uncharacterized LOC111132750,12004
NC_035784.1,94129939,94159489,94129939,94159489,111132753,XM_022480571.1,uncharacterized LOC111132753,29550
NC_035784.1,94159646,94163509,94159646,94163509,111132754,XM_022480572.1,uncharacterized LOC111132754,3863
NC_035784.1,94564161,94568840,94564161,94568840,111132756,XM_022480574.1,uncharacterized LOC111132756,4679
NC_035784.1,94571225,94587499,94571225,94587499,111132757,XM_022480575.1,uncharacterized LOC111132757,16274
NC_035784.1,94658552,94660716,94658552,94660716,111132760,XM_022480577.1,uncharacterized LOC111132760,2164
NC_035784.1,94815780,94816399,94815780,94816399,111132761,XM_022480578.1,uncharacterized LOC111132761,619
NC_035784.1,95204137,95211618,95204137,95211618,111132763,XM_022480581.1,uncharacterized LOC111132763,7481
NC_035784.1,95955678,95979883,95955678,95979883,111132767,XM_022480584.1,uncharacterized LOC111132767,24205
NC_035784.1,95984621,95986572,95984621,95986572,111132768,XM_022480585.1,uncharacterized LOC111132768,1951
NC_035784.1,96067661,96068325,96067661,96068325,111132769,XM_022480586.1,uncharacterized LOC111132769,664
NC_035784.1,96167354,96168484,96167354,96168484,111132770,XM_022480588.1,uncharacterized LOC111132770,1130
NC_035784.1,96178255,96191350,96178255,96191350,111132771,XM_022480589.1,uncharacterized LOC111132771,13095
NC_035784.1,96207532,96221215,96207532,96221215,111132772,XM_022480590.1,uncharacterized LOC111132772,13683
NC_035784.1,96229449,96230003,96229449,96230003,111132773,XM_022480591.1,uncharacterized LOC111132773,554
NC_035784.1,96230121,96230774,96230121,96230774,111132774,XM_022480592.1,uncharacterized LOC111132774,653
NC_035784.1,96232706,96233799,96232706,96233799,111132775,XM_022480593.1,uncharacterized LOC111132775,1093
NC_035784.1,96236735,96238638,96236735,96238638,111132776,XM_022480594.1,uncharacterized LOC111132776,1903
NC_035784.1,96911723,96914333,96911723,96914333,111132781,XM_022480599.1,uncharacterized LOC111132781,2610
NC_035784.1,97333644,97345774,97333644,97345774,111132783,XM_022480601.1,uncharacterized LOC111132783,12130
NC_035784.1,97542708,97545344,97542708,97545344,111132785,XM_022480603.1,uncharacterized LOC111132785,2636
NC_035784.1,97545250,97564989,97545250,97564989,111132789,XM_022480612.1,uncharacterized LOC111132789,19739
NC_035784.1,97787760,97819268,97787760,97819268,111132790,XM_022480613.1,uncharacterized LOC111132790,31508
NC_035784.1,97943855,97953284,97943855,97953284,111132791,XM_022480614.1,uncharacterized LOC111132791,9429
NC_035784.1,98641395,98645339,98641395,98645339,111132793,XM_022480615.1,uncharacterized LOC111132793,3944
NC_035784.1,98651001,98657243,98651001,98657243,111132795,XM_022480616.1,uncharacterized LOC111132795,6242
NC_035784.1,19824216,19829290,19824216,19829290,111132804,XM_022480641.1,uncharacterized LOC111132804,5074
NC_035784.1,96978690,96983344,96978690,96983344,111132806,XM_022480645.1,uncharacterized LOC111132806,4654
NC_035784.1,29969249,29972724,29969249,29972724,111132809,XM_022480650.1,uncharacterized LOC111132809,3475
NC_035784.1,18523782,18545130,18524530,18545130,111132812,XM_022480657.1,uncharacterized LOC111132812,20600
NC_035784.1,18523782,18545130,18523782,18545130,111132812,XM_022480655.1,uncharacterized LOC111132812,21348
NC_035784.1,40139820,40148871,40139820,40148871,111132816,XM_022480661.1,uncharacterized LOC111132816,9051
NC_035784.1,64433474,64436301,64433474,64436301,111132817,XM_022480662.1,uncharacterized LOC111132817,2827
NC_035784.1,38501860,38503425,38501860,38503425,111132823,XM_022480674.1,uncharacterized LOC111132823,1565
NC_035784.1,87373366,87382629,87373366,87382629,111132824,XM_022480675.1,uncharacterized LOC111132824,9263
NC_035784.1,90485949,90490995,90487290,90490995,111132825,XM_022480679.1,uncharacterized LOC111132825,3705
NC_035784.1,90485949,90490995,90486532,90490995,111132825,XM_022480678.1,uncharacterized LOC111132825,4463
NC_035784.1,90485949,90490995,90485949,90490995,111132825,XM_022480680.1,uncharacterized LOC111132825,5046
NC_035784.1,23638436,23652989,23638436,23652989,111132830,XM_022480690.1,uncharacterized LOC111132830,14553
NC_035784.1,23666187,23672921,23666188,23672896,111132831,XM_022480691.1,uncharacterized LOC111132831,6708
NC_035784.1,23666187,23672921,23666188,23672915,111132831,XM_022480692.1,uncharacterized LOC111132831,6727
NC_035784.1,23666187,23672921,23666187,23672921,111132831,XM_022480693.1,uncharacterized LOC111132831,6734
NC_035784.1,24028223,24042834,24028223,24042834,111132832,XM_022480694.1,uncharacterized LOC111132832,14611
NC_035784.1,23724133,23727774,23724133,23727774,111132836,XM_022480700.1,uncharacterized LOC111132836,3641
NC_035784.1,23892069,23904629,23892069,23904311,111132838,XM_022480705.1,uncharacterized LOC111132838,12242
NC_035784.1,23892069,23904629,23892069,23904629,111132838,XM_022480704.1,uncharacterized LOC111132838,12560
NC_035784.1,23662852,23665691,23662852,23665691,111132840,XM_022480707.1,uncharacterized LOC111132840,2839
NC_035784.1,24024404,24027987,24024404,24027987,111132842,XM_022480708.1,uncharacterized LOC111132842,3583
NC_035784.1,23956210,23966849,23956210,23966838,111132844,XM_022480711.1,uncharacterized LOC111132844,10628
NC_035784.1,23956210,23966849,23956210,23966849,111132844,XM_022480713.1,uncharacterized LOC111132844,10639
NC_035784.1,23956210,23966849,23956210,23963021,111132844,XM_022480710.1,uncharacterized LOC111132844,6811
NC_035784.1,23676396,23680844,23676396,23680844,111132847,XM_022480717.1,uncharacterized LOC111132847,4448
NC_035784.1,23949925,23954239,23949925,23954031,111132848,XM_022480719.1,uncharacterized LOC111132848,4106
NC_035784.1,23949925,23954239,23949925,23954032,111132848,XM_022480723.1,uncharacterized LOC111132848,4107
NC_035784.1,23949925,23954239,23949925,23954238,111132848,XM_022480737.1,uncharacterized LOC111132848,4313
NC_035784.1,23949925,23954239,23949925,23954239,111132848,XM_022480726.1,uncharacterized LOC111132848,4314
NC_035784.1,1316945,1326633,1316945,1326633,111132856,XM_022480753.1,uncharacterized LOC111132856,9688
NC_035784.1,53997022,54001893,53997022,54000745,111132860,XM_022480759.1,uncharacterized LOC111132860,3723
NC_035784.1,53997022,54001893,53997022,54001893,111132860,XM_022480760.1,uncharacterized LOC111132860,4871
NC_035784.1,94615675,94642452,94615675,94642452,111132867,XM_022480780.1,uncharacterized LOC111132867,26777
NC_035784.1,38478197,38481655,38478197,38481655,111132869,XM_022480782.1,uncharacterized LOC111132869,3458
NC_035784.1,47431198,47432628,47431198,47432628,111132871,XM_022480784.1,uncharacterized LOC111132871,1430
NC_035784.1,96306124,96307286,96306124,96307286,111132875,XM_022480789.1,uncharacterized LOC111132875,1162
NC_035784.1,46687429,46692682,46687429,46692682,111132876,XM_022480790.1,uncharacterized LOC111132876,5253
NC_035784.1,49978199,49983660,49978199,49983660,111132877,XM_022480791.1,uncharacterized LOC111132877,5461
NC_035784.1,92586065,92588323,92586065,92588323,111132878,XM_022480792.1,uncharacterized LOC111132878,2258
NC_035784.1,40827649,40831978,40827649,40831978,111132881,XM_022480803.1,uncharacterized LOC111132881,4329
NC_035784.1,54153247,54162315,54153247,54162315,111132882,XM_022480804.1,uncharacterized LOC111132882,9068
NC_035784.1,43209264,43227040,43209264,43227040,111132887,XM_022480809.1,uncharacterized LOC111132887,17776
NC_035784.1,13276684,13277830,13276684,13277830,111132889,XM_022480810.1,uncharacterized LOC111132889,1146
NC_035784.1,10978159,10981301,10978159,10981273,111132895,XM_022480823.1,uncharacterized LOC111132895,3114
NC_035784.1,10978159,10981301,10978159,10981301,111132895,XM_022480822.1,uncharacterized LOC111132895,3142
NC_035784.1,11017906,11022226,11017906,11022226,111132901,XM_022480831.1,uncharacterized LOC111132901,4320
NC_035784.1,10816337,10827484,10816337,10827426,111132902,XM_022480833.1,uncharacterized LOC111132902,11089
NC_035784.1,10816337,10827484,10816337,10827484,111132902,XM_022480832.1,uncharacterized LOC111132902,11147
NC_035780.1,64338092,64441946,64338092,64441945,111132907,XM_022480841.1,uncharacterized LOC111132907,103853
NC_035780.1,64338092,64441946,64338092,64441946,111132907,XM_022480850.1,uncharacterized LOC111132907,103854
NC_035784.1,28960553,28967896,28960553,28967896,111132910,XM_022480839.1,uncharacterized LOC111132910,7343
NC_035784.1,95123878,95127186,95123878,95127186,111132913,XM_022480847.1,uncharacterized LOC111132913,3308
NC_035784.1,12807764,12811749,12807764,12811721,111132914,XM_022480849.1,uncharacterized LOC111132914,3957
NC_035784.1,12807764,12811749,12807764,12811749,111132914,XM_022480848.1,uncharacterized LOC111132914,3985
NC_035784.1,44062042,44074785,44062042,44074785,111132926,XM_022480874.1,uncharacterized LOC111132926,12743
NC_035784.1,44062042,44074785,44068658,44074785,111132926,XM_022480873.1,uncharacterized LOC111132926,6127
NC_035784.1,44062042,44074785,44068332,44074783,111132926,XM_022480871.1,uncharacterized LOC111132926,6451
NC_035784.1,87480521,87491958,87480521,87491958,111132929,XM_022480876.1,uncharacterized LOC111132929,11437
NC_035784.1,35956449,35962574,35956981,35962574,111132934,XM_022480884.1,uncharacterized LOC111132934,5593
NC_035784.1,35956449,35962574,35956449,35962574,111132934,XM_022480883.1,uncharacterized LOC111132934,6125
NC_035784.1,12421475,12425414,12421475,12424699,111132937,XM_022480889.1,uncharacterized LOC111132937,3224
NC_035784.1,12421475,12425414,12421476,12425414,111132937,XM_022480888.1,uncharacterized LOC111132937,3938
NC_035784.1,76716610,76719190,76716610,76719190,111132938,XM_022480890.1,uncharacterized LOC111132938,2580
NC_035784.1,24148885,24151106,24148885,24151106,111132940,XM_022480899.1,uncharacterized LOC111132940,2221
NC_035784.1,24151210,24153308,24151210,24153308,111132941,XM_022480900.1,uncharacterized LOC111132941,2098
NC_035784.1,44867531,44871242,44867531,44871242,111132945,XM_022480903.1,uncharacterized LOC111132945,3711
NC_035784.1,44861621,44866389,44861621,44866389,111132946,XM_022480905.1,uncharacterized LOC111132946,4768
NC_035784.1,86800333,86836900,86800333,86829219,111132950,XM_022480909.1,uncharacterized LOC111132950,28886
NC_035784.1,86800333,86836900,86800333,86836900,111132950,XM_022480911.1,uncharacterized LOC111132950,36567
NC_035784.1,67771216,67775752,67771216,67775752,111132952,XM_022480913.1,uncharacterized LOC111132952,4536
NC_035784.1,6930042,6935489,6930042,6935489,111132954,XM_022480915.1,uncharacterized LOC111132954,5447
NC_035784.1,14443557,14447278,14443558,14447278,111132961,XM_022480925.1,uncharacterized LOC111132961,3720
NC_035784.1,14443557,14447278,14443557,14447278,111132961,XM_022480924.1,uncharacterized LOC111132961,3721
NC_035784.1,79555574,79556375,79555574,79556375,111132963,XM_022480931.1,uncharacterized LOC111132963,801
NC_035784.1,32805064,32817316,32805064,32817316,111132968,XM_022480955.1,uncharacterized LOC111132968,12252
NC_035784.1,32690565,32696177,32690565,32696177,111132970,XM_022480957.1,uncharacterized LOC111132970,5612
NC_035784.1,10130345,10135489,10130345,10135489,111132973,XM_022480959.1,uncharacterized LOC111132973,5144
NC_035784.1,39747862,39748860,39747862,39748860,111132980,XM_022480972.1,uncharacterized LOC111132980,998
NC_035784.1,15407396,15413776,15407981,15413776,111132981,XM_022480974.1,uncharacterized LOC111132981,5795
NC_035784.1,15407396,15413776,15407396,15413776,111132981,XM_022480973.1,uncharacterized LOC111132981,6380
NC_035784.1,9195076,9200473,9195076,9200473,111132983,XM_022480978.1,uncharacterized LOC111132983,5397
NC_035784.1,5780631,5797452,5780678,5797452,111132988,XM_022480991.1,uncharacterized LOC111132988,16774
NC_035784.1,5780631,5797452,5780640,5797452,111132988,XM_022480990.1,uncharacterized LOC111132988,16812
NC_035784.1,28632944,28636126,28632944,28636011,111132992,XM_022481004.1,uncharacterized LOC111132992,3067
NC_035784.1,28632944,28636126,28632944,28636126,111132992,XM_022481003.1,uncharacterized LOC111132992,3182
NC_035784.1,81427231,81439413,81427231,81439413,111132993,XM_022481008.1,uncharacterized LOC111132993,12182
NC_035784.1,81420688,81425491,81420696,81425113,111132994,XM_022481012.1,uncharacterized LOC111132994,4417
NC_035784.1,81420688,81425491,81420695,81425113,111132994,XM_022481011.1,uncharacterized LOC111132994,4418
NC_035784.1,81420688,81425491,81420688,81425491,111132994,XM_022481010.1,uncharacterized LOC111132994,4803
NC_035784.1,81444700,81452857,81444700,81452857,111132995,XM_022481013.1,uncharacterized LOC111132995,8157
NC_035784.1,34543550,34554988,34543550,34554988,111133003,XM_022481025.1,uncharacterized LOC111133003,11438
NC_035784.1,13680975,13685031,13680975,13685031,111133020,XM_022481052.1,uncharacterized LOC111133020,4056
NC_035784.1,10413029,10418468,10413029,10418468,111133024,XM_022481061.1,uncharacterized LOC111133024,5439
NC_035784.1,40563896,40565937,40563896,40565937,111133027,XM_022481067.1,uncharacterized LOC111133027,2041
NC_035784.1,29867540,29872840,29867540,29872840,111133028,XM_022481069.1,uncharacterized LOC111133028,5300
NC_035784.1,87091100,87092781,87091743,87092781,111133029,XM_022481070.1,uncharacterized LOC111133029,1038
NC_035784.1,55268508,55281381,55268508,55281381,111133035,XM_022481080.1,uncharacterized LOC111133035,12873
NC_035784.1,68168160,68173688,68168160,68173688,111133042,XM_022481093.1,uncharacterized LOC111133042,5528
NC_035784.1,35699581,35705527,35699581,35705291,111133055,XM_022481120.1,uncharacterized LOC111133055,5710
NC_035784.1,35699581,35705527,35699581,35705527,111133055,XM_022481119.1,uncharacterized LOC111133055,5946
NC_035780.1,33797763,33801555,33797763,33801555,111133058,XM_022481526.1,uncharacterized LOC111133058,3792
NC_035784.1,78101990,78105435,78101990,78105435,111133061,XM_022481126.1,uncharacterized LOC111133061,3445
NC_035784.1,16673468,16675894,16673468,16675894,111133063,XM_022481135.1,uncharacterized LOC111133063,2426
NC_035784.1,16657723,16658965,16657723,16658965,111133064,XM_022481136.1,uncharacterized LOC111133064,1242
NC_035784.1,16659726,16663729,16660612,16663724,111133065,XM_022481137.1,uncharacterized LOC111133065,3112
NC_035784.1,16659726,16663729,16659726,16663729,111133065,XM_022481138.1,uncharacterized LOC111133065,4003
NC_035784.1,17480401,17506483,17488209,17506483,111133066,XM_022481139.1,uncharacterized LOC111133066,18274
NC_035784.1,17480401,17506483,17487954,17506483,111133066,XM_022481142.1,uncharacterized LOC111133066,18529
NC_035784.1,17480401,17506483,17480530,17506483,111133066,XM_022481140.1,uncharacterized LOC111133066,25953
NC_035784.1,17480401,17506483,17480401,17506483,111133066,XM_022481141.1,uncharacterized LOC111133066,26082
NC_035784.1,17497108,17499035,17497108,17499035,111133067,XM_022481143.1,uncharacterized LOC111133067,1927
NC_035784.1,92890882,92920722,92890882,92920722,111133073,XM_022481149.1,uncharacterized LOC111133073,29840
NC_035784.1,95141224,95143575,95141224,95143575,111133076,XM_022481155.1,uncharacterized LOC111133076,2351
NC_035784.1,61860353,61863682,61860353,61863682,111133077,XM_022481156.1,uncharacterized LOC111133077,3329
NC_035784.1,17462209,17470338,17462209,17470338,111133081,XM_022481159.1,uncharacterized LOC111133081,8129
NC_035784.1,17453005,17458533,17453134,17458533,111133082,XM_022481160.1,uncharacterized LOC111133082,5399
NC_035784.1,67395840,67397726,67395840,67397726,111133083,XM_022481162.1,uncharacterized LOC111133083,1886
NC_035784.1,61041754,61054218,61042452,61054218,111133085,XM_022481176.1,uncharacterized LOC111133085,11766
NC_035784.1,61041754,61054218,61041754,61054218,111133085,XM_022481175.1,uncharacterized LOC111133085,12464
NC_035784.1,43557213,43561011,43557641,43561011,111133088,XM_022481177.1,uncharacterized LOC111133088,3370
NC_035784.1,43557213,43561011,43557213,43561011,111133088,XM_022481178.1,uncharacterized LOC111133088,3798
NC_035784.1,90790277,90798295,90790277,90796373,111133089,XM_022481180.1,uncharacterized LOC111133089,6096
NC_035784.1,90790277,90798295,90790277,90798256,111133089,XM_022481181.1,uncharacterized LOC111133089,7979
NC_035784.1,90790277,90798295,90790277,90798295,111133089,XM_022481179.1,uncharacterized LOC111133089,8018
NC_035784.1,11383013,11791230,11383014,11789943,111133093,XM_022481189.1,uncharacterized LOC111133093,406929
NC_035784.1,11383013,11791230,11383013,11791230,111133093,XM_022481188.1,uncharacterized LOC111133093,408217
NC_035784.1,11331777,11336927,11331777,11336927,111133094,XM_022481190.1,uncharacterized LOC111133094,5150
NC_035784.1,11393893,11727362,11721805,11727362,111133095,XM_022481191.1,uncharacterized LOC111133095,5557
NC_035784.1,11531553,11545699,11531553,11545699,111133096,XM_022481192.1,uncharacterized LOC111133096,14146
NC_035784.1,11575751,11616289,11575751,11616289,111133097,XM_022481193.1,uncharacterized LOC111133097,40538
NC_035784.1,11345757,11352344,11345757,11351171,111133102,XM_022481200.1,uncharacterized LOC111133102,5414
NC_035784.1,11345757,11352344,11345757,11351846,111133102,XM_022481199.1,uncharacterized LOC111133102,6089
NC_035784.1,11345757,11352344,11345757,11352344,111133102,XM_022481198.1,uncharacterized LOC111133102,6587
NC_035784.1,11416475,11425635,11416475,11425635,111133103,XM_022481201.1,uncharacterized LOC111133103,9160
NC_035784.1,11301903,11305547,11301903,11305547,111133104,XM_022481202.1,uncharacterized LOC111133104,3644
NC_035784.1,11632982,11641511,11632982,11641511,111133105,XM_022481203.1,uncharacterized LOC111133105,8529
NC_035784.1,11263156,11274231,11263156,11269643,111133106,XM_022481204.1,uncharacterized LOC111133106,6487
NC_035784.1,11371802,11372394,11371802,11372394,111133108,XM_022481205.1,uncharacterized LOC111133108,592
NC_035784.1,16949992,16957579,16949992,16957123,111133121,XM_022481215.1,uncharacterized LOC111133121,7131
NC_035784.1,16949992,16957579,16950176,16957579,111133121,XM_022481213.1,uncharacterized LOC111133121,7403
NC_035784.1,16949992,16957579,16949992,16957579,111133121,XM_022481212.1,uncharacterized LOC111133121,7587
NC_035784.1,74933403,74941274,74933403,74941267,111133122,XM_022481216.1,uncharacterized LOC111133122,7864
NC_035784.1,74933403,74941274,74933403,74941274,111133122,XM_022481217.1,uncharacterized LOC111133122,7871
NC_035784.1,27832793,27839628,27832793,27839628,111133124,XM_022481220.1,uncharacterized LOC111133124,6835
NC_035784.1,84111934,84115665,84111934,84115665,111133135,XM_022481234.1,uncharacterized LOC111133135,3731
NC_035784.1,49182646,49186768,49182895,49186768,111133137,XM_022481235.1,uncharacterized LOC111133137,3873
NC_035784.1,49182646,49186768,49182646,49186768,111133137,XM_022481236.1,uncharacterized LOC111133137,4122
NC_035784.1,40870476,40872145,40870476,40872145,111133138,XM_022481237.1,uncharacterized LOC111133138,1669
NC_035784.1,41360646,41370004,41360646,41367728,111133139,XM_022481241.1,uncharacterized LOC111133139,7082
NC_035784.1,41360646,41370004,41360646,41370004,111133139,XM_022481238.1,uncharacterized LOC111133139,9358
NC_035784.1,37905151,37909941,37905151,37909941,111133141,XM_022481243.1,uncharacterized LOC111133141,4790
NC_035784.1,13426818,13429243,13426818,13429243,111133149,XM_022481265.1,uncharacterized LOC111133149,2425
NC_035784.1,13565790,13567962,13565790,13567962,111133156,XM_022481276.1,uncharacterized LOC111133156,2172
NC_035784.1,13547437,13554611,13547437,13554611,111133158,XM_022481278.1,uncharacterized LOC111133158,7174
NC_035784.1,13408441,13411407,13408441,13411407,111133159,XM_022481279.1,uncharacterized LOC111133159,2966
NC_035784.1,61569561,61584462,61569561,61584462,111133162,XM_022481284.1,uncharacterized LOC111133162,14901
NC_035784.1,61569561,61584462,61575238,61584462,111133162,XM_022481283.1,uncharacterized LOC111133162,9224
NC_035784.1,22331428,22335599,22331428,22335599,111133169,XM_022481293.1,uncharacterized LOC111133169,4171
NC_035784.1,63340170,63392192,63340170,63392192,111133171,XM_022481295.1,uncharacterized LOC111133171,52022
NC_035784.1,22756953,22759798,22756953,22759798,111133173,XM_022481299.1,uncharacterized LOC111133173,2845
NC_035784.1,55837797,55844183,55837798,55844183,111133175,XM_022481301.1,uncharacterized LOC111133175,6385
NC_035784.1,55837797,55844183,55837797,55844183,111133175,XM_022481302.1,uncharacterized LOC111133175,6386
NC_035784.1,55348397,55351199,55348397,55351199,111133176,XM_022481303.1,uncharacterized LOC111133176,2802
NC_035780.1,21759185,21788958,21759185,21788958,111133179,XM_022481346.1,uncharacterized LOC111133179,29773
NC_035784.1,95101136,95102850,95101136,95102850,111133181,XM_022481308.1,uncharacterized LOC111133181,1714
NC_035784.1,8339313,8342586,8339400,8342586,111133183,XM_022481310.1,uncharacterized LOC111133183,3186
NC_035784.1,8339313,8342586,8339313,8342586,111133183,XM_022481311.1,uncharacterized LOC111133183,3273
NC_035784.1,85170192,85200118,85170192,85198728,111133184,XM_022481315.1,uncharacterized LOC111133184,28536
NC_035784.1,85170192,85200118,85170192,85200115,111133184,XM_022481312.1,uncharacterized LOC111133184,29923
NC_035784.1,85170192,85200118,85170192,85200118,111133184,XM_022481314.1,uncharacterized LOC111133184,29926
NC_035784.1,85209737,85226426,85209737,85226426,111133185,XM_022481317.1,uncharacterized LOC111133185,16689
NC_035784.1,81323498,81331312,81323498,81331312,111133193,XM_022481327.1,uncharacterized LOC111133193,7814
NC_035784.1,71050385,71053158,71050385,71052716,111133202,XM_022481337.1,uncharacterized LOC111133202,2331
NC_035784.1,71050385,71053158,71050385,71053158,111133202,XM_022481338.1,uncharacterized LOC111133202,2773
NC_035784.1,5981582,5986925,5981582,5986925,111133204,XM_022481340.1,uncharacterized LOC111133204,5343
NC_035784.1,3007809,3009823,3008307,3009823,111133210,XM_022481364.1,uncharacterized LOC111133210,1516
NC_035784.1,3007809,3009823,3007809,3009823,111133210,XM_022481363.1,uncharacterized LOC111133210,2014
NC_035780.1,61354800,61359361,61354800,61359361,111133212,XM_022481369.1,uncharacterized LOC111133212,4561
NC_035784.1,17063611,17064996,17063611,17064957,111133213,XM_022481365.1,uncharacterized LOC111133213,1346
NC_035784.1,17063611,17064996,17063611,17064996,111133213,XM_022481366.1,uncharacterized LOC111133213,1385
NC_035784.1,93522530,93656582,93548683,93656582,111133218,XM_022481384.1,uncharacterized LOC111133218,107899
NC_035784.1,93522530,93656582,93522530,93654327,111133218,XM_022481378.1,uncharacterized LOC111133218,131797
NC_035784.1,93522530,93656582,93522530,93654336,111133218,XM_022481376.1,uncharacterized LOC111133218,131806
NC_035784.1,93522530,93656582,93522530,93656568,111133218,XM_022481379.1,uncharacterized LOC111133218,134038
NC_035784.1,93522530,93656582,93522530,93656582,111133218,XM_022481375.1,uncharacterized LOC111133218,134052
NC_035784.1,93522530,93656582,93522530,93549271,111133218,XM_022481380.1,uncharacterized LOC111133218,26741
NC_035784.1,93522530,93656582,93522530,93567411,111133218,XM_022481381.1,uncharacterized LOC111133218,44881
NC_035784.1,93522530,93656582,93579287,93656582,111133218,XM_022481386.1,uncharacterized LOC111133218,77295
NC_035784.1,93522530,93656582,93559490,93656582,111133218,XM_022481382.1,uncharacterized LOC111133218,97092
NC_035784.1,93937123,94113508,93937123,94113508,111133220,XM_022481389.1,uncharacterized LOC111133220,176385
NC_035784.1,93673911,93692976,93673911,93692976,111133221,XM_022481390.1,uncharacterized LOC111133221,19065
NC_035784.1,93700003,93715926,93700003,93715926,111133222,XM_022481392.1,uncharacterized LOC111133222,15923
NC_035784.1,93745475,93824284,93770471,93795531,111133223,XM_022481395.1,uncharacterized LOC111133223,25060
NC_035784.1,93745475,93824284,93745475,93795531,111133223,XM_022481393.1,uncharacterized LOC111133223,50056
NC_035784.1,93745475,93824284,93745475,93824284,111133223,XM_022481394.1,uncharacterized LOC111133223,78809
NC_035784.1,93562327,93566050,93562327,93566050,111133225,XM_022481398.1,uncharacterized LOC111133225,3723
NC_035784.1,40973368,40977864,40973368,40977864,111133227,XM_022481401.1,uncharacterized LOC111133227,4496
NC_035784.1,41153679,41159108,41153679,41155551,111133231,XM_022481418.1,uncharacterized LOC111133231,1872
NC_035784.1,41153679,41159108,41153679,41155621,111133231,XM_022481420.1,uncharacterized LOC111133231,1942
NC_035784.1,41153679,41159108,41153679,41159108,111133231,XM_022481421.1,uncharacterized LOC111133231,5429
NC_035784.1,83912558,83913949,83912558,83913949,111133236,XM_022481426.1,uncharacterized LOC111133236,1391
NC_035784.1,45075403,45085487,45075403,45085437,111133243,XM_022481442.1,uncharacterized LOC111133243,10034
NC_035784.1,45075403,45085487,45075403,45085487,111133243,XM_022481443.1,uncharacterized LOC111133243,10084
NC_035784.1,58462183,58468198,58462183,58468198,111133244,XM_022481444.1,uncharacterized LOC111133244,6015
NC_035784.1,27663193,27666536,27663193,27666536,111133245,XM_022481446.1,uncharacterized LOC111133245,3343
NC_035784.1,406115,411858,406115,411858,111133248,XM_022481450.1,uncharacterized LOC111133248,5743
NC_035784.1,58808720,58813752,58808720,58813752,111133253,XM_022481455.1,uncharacterized LOC111133253,5032
NC_035784.1,74134813,74136283,74134813,74136283,111133255,XM_022481460.1,uncharacterized LOC111133255,1470
NC_035784.1,34880406,35020616,34880406,35020616,111133256,XM_022481462.1,uncharacterized LOC111133256,140210
NC_035784.1,34880406,35020616,34880406,34889857,111133256,XM_022481461.1,uncharacterized LOC111133256,9451
NC_035784.1,34917500,34927796,34917500,34927796,111133267,XM_022481477.1,uncharacterized LOC111133267,10296
NC_035784.1,35015817,35028583,35015817,35028583,111133269,XM_022481479.1,uncharacterized LOC111133269,12766
NC_035784.1,34822014,34823800,34822014,34823800,111133270,XM_022481480.1,uncharacterized LOC111133270,1786
NC_035784.1,34949154,34950949,34949154,34950949,111133271,XM_022481481.1,uncharacterized LOC111133271,1795
NC_035784.1,34941884,34944416,34941884,34944416,111133272,XM_022481483.1,uncharacterized LOC111133272,2532
NC_035784.1,98561293,98566783,98561293,98566783,111133275,XM_022481487.1,uncharacterized LOC111133275,5490
NC_035784.1,97580739,97701405,97580739,97701405,111133276,XM_022481488.1,uncharacterized LOC111133276,120666
NC_035784.1,97281982,97294688,97281982,97294688,111133277,XM_022481493.1,uncharacterized LOC111133277,12706
NC_035784.1,98519918,98616360,98532249,98596156,111133278,XM_022481502.1,uncharacterized LOC111133278,63907
NC_035784.1,98519918,98616360,98531380,98596156,111133278,XM_022481499.1,uncharacterized LOC111133278,64776
NC_035784.1,98519918,98616360,98519918,98596156,111133278,XM_022481500.1,uncharacterized LOC111133278,76238
NC_035784.1,98519918,98616360,98519918,98602891,111133278,XM_022481498.1,uncharacterized LOC111133278,82973
NC_035784.1,98519918,98616360,98519918,98602923,111133278,XM_022481496.1,uncharacterized LOC111133278,83005
NC_035784.1,98519918,98616360,98519918,98616360,111133278,XM_022481495.1,uncharacterized LOC111133278,96442
NC_035784.1,98071940,98088670,98075090,98088670,111133279,XM_022481503.1,uncharacterized LOC111133279,13580
NC_035784.1,98071940,98088670,98071940,98088670,111133279,XM_022481504.1,uncharacterized LOC111133279,16730
NC_035784.1,97478469,97545310,97478469,97496283,111133280,XM_022481505.1,uncharacterized LOC111133280,17814
NC_035784.1,97478469,97545310,97478469,97510802,111133280,XM_022481506.1,uncharacterized LOC111133280,32333
NC_035784.1,97478469,97545310,97478469,97545310,111133280,XM_022481508.1,uncharacterized LOC111133280,66841
NC_035784.1,97843725,97913728,97843725,97857585,111133281,XM_022481512.1,uncharacterized LOC111133281,13860
NC_035784.1,97843725,97913728,97843725,97860839,111133281,XM_022481516.1,uncharacterized LOC111133281,17114
NC_035784.1,97843725,97913728,97843725,97861003,111133281,XM_022481513.1,uncharacterized LOC111133281,17278
NC_035784.1,97843725,97913728,97843725,97861050,111133281,XM_022481514.1,uncharacterized LOC111133281,17325
NC_035784.1,97843725,97913728,97843725,97861377,111133281,XM_022481510.1,uncharacterized LOC111133281,17652
NC_035784.1,97843725,97913728,97843725,97861401,111133281,XM_022481515.1,uncharacterized LOC111133281,17676
NC_035784.1,97843725,97913728,97872196,97913728,111133281,XM_022481519.1,uncharacterized LOC111133281,41532
NC_035784.1,97843725,97913728,97847293,97913728,111133281,XM_022481520.1,uncharacterized LOC111133281,66435
NC_035784.1,97843725,97913728,97843725,97913728,111133281,XM_022481518.1,uncharacterized LOC111133281,70003
NC_035784.1,97981478,98088655,97981483,98088655,111133282,XM_022481525.1,uncharacterized LOC111133282,107172
NC_035784.1,97981478,98088655,97981483,97998976,111133282,XM_022481522.1,uncharacterized LOC111133282,17493
NC_035784.1,97981478,98088655,97981483,98005826,111133282,XM_022481524.1,uncharacterized LOC111133282,24343
NC_035784.1,97981478,98088655,97981483,98005832,111133282,XM_022481523.1,uncharacterized LOC111133282,24349
NC_035784.1,97981478,98088655,97981483,98044341,111133282,XM_022481528.1,uncharacterized LOC111133282,62858
NC_035784.1,97981478,98088655,97981478,98044339,111133282,XM_022481530.1,uncharacterized LOC111133282,62861
NC_035784.1,97981478,98088655,97981483,98048108,111133282,XM_022481527.1,uncharacterized LOC111133282,66625
NC_035784.1,97981478,98088655,97981478,98061848,111133282,XM_022481529.1,uncharacterized LOC111133282,80370
NC_035784.1,8707340,8708161,8707340,8708161,111133284,XM_022481531.1,uncharacterized LOC111133284,821
NC_035784.1,98432366,98451532,98440463,98451532,111133286,XM_022481532.1,uncharacterized LOC111133286,11069
NC_035784.1,98432366,98451532,98432366,98451532,111133286,XM_022481533.1,uncharacterized LOC111133286,19166
NC_035784.1,98156606,98170819,98156606,98170819,111133287,XM_022481535.1,uncharacterized LOC111133287,14213
NC_035784.1,98156606,98170819,98162474,98170819,111133287,XM_022481534.1,uncharacterized LOC111133287,8345
NC_035784.1,97383213,97416288,97383213,97398867,111133288,XM_022481539.1,uncharacterized LOC111133288,15654
NC_035784.1,97383213,97416288,97383213,97413558,111133288,XM_022481540.1,uncharacterized LOC111133288,30345
NC_035784.1,97383213,97416288,97383213,97413564,111133288,XM_022481541.1,uncharacterized LOC111133288,30351
NC_035784.1,97383213,97416288,97383213,97416288,111133288,XM_022481537.1,uncharacterized LOC111133288,33075
NC_035784.1,98192089,98239910,98192089,98239910,111133289,XM_022481542.1,uncharacterized LOC111133289,47821
NC_035784.1,97746240,97765535,97746240,97765535,111133290,XM_022481543.1,uncharacterized LOC111133290,19295
NC_035784.1,97237705,97295370,97237705,97260879,111133291,XM_022481544.1,uncharacterized LOC111133291,23174
NC_035784.1,97237705,97295370,97237705,97295370,111133291,XM_022481547.1,uncharacterized LOC111133291,57665
NC_035784.1,98479114,98514384,98479114,98493153,111133292,XM_022481551.1,uncharacterized LOC111133292,14039
NC_035784.1,98479114,98514384,98479114,98505335,111133292,XM_022481550.1,uncharacterized LOC111133292,26221
NC_035784.1,98479114,98514384,98479114,98514384,111133292,XM_022481548.1,uncharacterized LOC111133292,35270
NC_035784.1,98523802,98526052,98523802,98526052,111133293,XM_022481552.1,uncharacterized LOC111133293,2250
NC_035784.1,98259469,98287762,98259469,98287762,111133294,XM_022481553.1,uncharacterized LOC111133294,28293
NC_035784.1,97447803,97458287,97447803,97458287,111133295,XM_022481555.1,uncharacterized LOC111133295,10484
NC_035784.1,98298800,98420298,98298800,98420298,111133296,XM_022481556.1,uncharacterized LOC111133296,121498
NC_035784.1,98298800,98420298,98384957,98420297,111133296,XM_022481557.1,uncharacterized LOC111133296,35340
NC_035784.1,98298800,98420298,98298800,98391831,111133296,XM_022481558.1,uncharacterized LOC111133296,93031
NC_035784.1,98199648,98204339,98199648,98204339,111133297,XM_022481559.1,uncharacterized LOC111133297,4691
NC_035784.1,98115250,98131648,98115250,98131648,111133298,XM_022481560.1,uncharacterized LOC111133298,16398
NC_035784.1,97716934,97719491,97716934,97719491,111133299,XM_022481561.1,uncharacterized LOC111133299,2557
NC_035784.1,98521516,98523717,98521516,98523717,111133300,XM_022481563.1,uncharacterized LOC111133300,2201
NC_035784.1,97727546,97733188,97727547,97730889,111133302,XM_022481568.1,uncharacterized LOC111133302,3342
NC_035784.1,97727546,97733188,97727547,97733188,111133302,XM_022481570.1,uncharacterized LOC111133302,5641
NC_035784.1,97727546,97733188,97727546,97733188,111133302,XM_022481571.1,uncharacterized LOC111133302,5642
NC_035784.1,97569660,97572480,97569660,97572480,111133305,XM_022481574.1,uncharacterized LOC111133305,2820
NC_035784.1,97270668,97275088,97270668,97275088,111133306,XM_022481575.1,uncharacterized LOC111133306,4420
NC_035784.1,97777000,97787386,97777000,97787386,111133307,XM_022481576.1,uncharacterized LOC111133307,10386
NC_035784.1,97566802,97569646,97567835,97569646,111133308,XM_022481577.1,uncharacterized LOC111133308,1811
NC_035784.1,97566802,97569646,97566802,97569646,111133308,XM_022481578.1,uncharacterized LOC111133308,2844
NC_035784.1,97706723,97726581,97706723,97726581,111133309,XM_022481579.1,uncharacterized LOC111133309,19858
NC_035784.1,98213217,98221794,98213217,98221794,111133310,XM_022481581.1,uncharacterized LOC111133310,8577
NC_035784.1,98547528,98558497,98550012,98558497,111133311,XM_022481582.1,uncharacterized LOC111133311,8485
NC_035784.1,41973206,41976244,41973206,41976244,111133324,XM_022481589.1,uncharacterized LOC111133324,3038
NC_035784.1,64009937,64046997,64009937,64046996,111133325,XM_022481590.1,uncharacterized LOC111133325,37059
NC_035784.1,64009937,64046997,64009937,64046997,111133325,XM_022481592.1,uncharacterized LOC111133325,37060
NC_035780.1,48173576,48196455,48173576,48196455,111133328,XM_022481599.1,uncharacterized LOC111133328,22879
NC_035780.1,38781769,38788453,38781769,38784991,111133332,XM_022481635.1,uncharacterized LOC111133332,3222
NC_035780.1,38781769,38788453,38781769,38788453,111133332,XM_022481644.1,uncharacterized LOC111133332,6684
NC_035784.1,38267826,38280993,38267826,38280993,111133334,XM_022481633.1,uncharacterized LOC111133334,13167
NC_035784.1,29043607,29052507,29043607,29052498,111133340,XM_022481643.1,uncharacterized LOC111133340,8891
NC_035784.1,29043607,29052507,29043607,29052507,111133340,XM_022481645.1,uncharacterized LOC111133340,8900
NC_035784.1,21215895,21225212,21215895,21225212,111133343,XM_022481652.1,uncharacterized LOC111133343,9317
NC_035784.1,21213615,21215723,21213615,21215675,111133345,XM_022481654.1,uncharacterized LOC111133345,2060
NC_035784.1,21213615,21215723,21213615,21215723,111133345,XM_022481653.1,uncharacterized LOC111133345,2108
NC_035784.1,5764800,5772760,5764800,5772760,111133349,XM_022481660.1,uncharacterized LOC111133349,7960
NC_035784.1,41255585,41257067,41255585,41257067,111133351,XM_022481677.1,uncharacterized LOC111133351,1482
NC_035784.1,36442755,36449524,36442755,36446847,111133352,XM_022481679.1,uncharacterized LOC111133352,4092
NC_035784.1,36442755,36449524,36442755,36448278,111133352,XM_022481680.1,uncharacterized LOC111133352,5523
NC_035784.1,36442755,36449524,36442755,36449524,111133352,XM_022481678.1,uncharacterized LOC111133352,6769
NC_035784.1,55353197,55390427,55353197,55390427,111133354,XM_022481683.1,uncharacterized LOC111133354,37230
NC_035780.1,38763333,38766850,38763333,38766850,111133360,XM_022481697.1,uncharacterized LOC111133360,3517
NC_035784.1,74539228,74547358,74539228,74547358,111133362,XM_022481696.1,uncharacterized LOC111133362,8130
NC_035784.1,37367620,37389835,37367621,37389835,111133364,XM_022481700.1,uncharacterized LOC111133364,22214
NC_035784.1,37367620,37389835,37367620,37389835,111133364,XM_022481699.1,uncharacterized LOC111133364,22215
NC_035784.1,57115712,57122751,57115712,57122751,111133367,XM_022481704.1,uncharacterized LOC111133367,7039
NC_035780.1,938662,951816,938662,951816,111133372,XM_022481713.1,uncharacterized LOC111133372,13154
NC_035780.1,938662,951816,938662,947466,111133372,XM_022481722.1,uncharacterized LOC111133372,8804
NC_035784.1,51694,55503,51694,55503,111133373,XM_022481711.1,uncharacterized LOC111133373,3809
NC_035784.1,50592450,50595933,50592450,50595933,111133374,XM_022481712.1,uncharacterized LOC111133374,3483
NC_035784.1,42313626,42335268,42313626,42330747,111133377,XM_022481717.1,uncharacterized LOC111133377,17121
NC_035784.1,42313626,42335268,42313626,42335268,111133377,XM_022481716.1,uncharacterized LOC111133377,21642
NC_035784.1,43961049,43963463,43961049,43963463,111133380,XM_022481731.1,uncharacterized LOC111133380,2414
NC_035784.1,89784509,89828204,89784509,89828204,111133393,XM_022481751.1,uncharacterized LOC111133393,43695
NC_035784.1,58436686,58447145,58436706,58447145,111133394,XM_022481754.1,uncharacterized LOC111133394,10439
NC_035784.1,58436686,58447145,58436690,58444668,111133394,XM_022481753.1,uncharacterized LOC111133394,7978
NC_035784.1,58436686,58447145,58436686,58444668,111133394,XM_022481752.1,uncharacterized LOC111133394,7982
NC_035784.1,37910205,37913814,37910205,37913814,111133396,XM_022481757.1,uncharacterized LOC111133396,3609
NC_035784.1,47094725,47103963,47094725,47102481,111133397,XM_022481760.1,uncharacterized LOC111133397,7756
NC_035784.1,47094725,47103963,47094725,47103963,111133397,XM_022481759.1,uncharacterized LOC111133397,9238
NC_035784.1,23561789,23566312,23561789,23566312,111133401,XM_022481790.1,uncharacterized LOC111133401,4523
NC_035784.1,35398976,35406855,35398976,35406855,111133405,XM_022481810.1,uncharacterized LOC111133405,7879
NC_035784.1,37952303,37955201,37952303,37955201,111133408,XM_022481813.1,uncharacterized LOC111133408,2898
NC_035784.1,59040076,59041892,59040100,59041892,111133409,XM_022481814.1,uncharacterized LOC111133409,1792
NC_035784.1,59040076,59041892,59040076,59041892,111133409,XM_022481815.1,uncharacterized LOC111133409,1816
NC_035784.1,24378947,24382616,24378947,24382616,111133410,XM_022481816.1,uncharacterized LOC111133410,3669
NC_035784.1,44559998,44569412,44560985,44569412,111133415,XM_022481825.1,uncharacterized LOC111133415,8427
NC_035784.1,44559998,44569412,44559998,44569412,111133415,XM_022481824.1,uncharacterized LOC111133415,9414
NC_035784.1,77200926,77209757,77200926,77209757,111133419,XM_022481829.1,uncharacterized LOC111133419,8831
NC_035784.1,86949371,86955470,86949371,86955470,111133424,XM_022481846.1,uncharacterized LOC111133424,6099
NC_035784.1,32367196,32375387,32367196,32375387,111133437,XM_022481865.1,uncharacterized LOC111133437,8191
NC_035784.1,14311610,14321522,14315464,14321522,111133442,XM_022481874.1,uncharacterized LOC111133442,6058
NC_035784.1,14311610,14321522,14314957,14321522,111133442,XM_022481875.1,uncharacterized LOC111133442,6565
NC_035784.1,14311610,14321522,14311610,14321522,111133442,XM_022481876.1,uncharacterized LOC111133442,9912
NC_035780.1,52225582,52232886,52225582,52230443,111133443,XM_022481880.1,uncharacterized LOC111133443,4861
NC_035780.1,52225582,52232886,52225589,52230466,111133443,XM_022481909.1,uncharacterized LOC111133443,4877
NC_035780.1,52225582,52232886,52225582,52231760,111133443,XM_022481886.1,uncharacterized LOC111133443,6178
NC_035780.1,52225582,52232886,52225582,52231763,111133443,XM_022481893.1,uncharacterized LOC111133443,6181
NC_035780.1,52225582,52232886,52225582,52232886,111133443,XM_022481901.1,uncharacterized LOC111133443,7304
NC_035784.1,22710265,22724335,22710265,22724335,111133446,XM_022481879.1,uncharacterized LOC111133446,14070
NC_035784.1,67403668,67405337,67403668,67405337,111133448,XM_022481881.1,uncharacterized LOC111133448,1669
NC_035784.1,84164949,84191989,84164949,84191073,111133461,XM_022481894.1,uncharacterized LOC111133461,26124
NC_035784.1,84164949,84191989,84164949,84191989,111133461,XM_022481892.1,uncharacterized LOC111133461,27040
NC_035784.1,84164949,84191989,84182453,84191988,111133461,XM_022481895.1,uncharacterized LOC111133461,9535
NC_035784.1,16999526,17002800,16999526,17002800,111133462,XM_022481896.1,uncharacterized LOC111133462,3274
NC_035784.1,44120840,44125667,44120840,44125666,111133469,XM_022481907.1,uncharacterized LOC111133469,4826
NC_035784.1,74108247,74110330,74108262,74110330,111133470,XM_022481911.1,uncharacterized LOC111133470,2068
NC_035784.1,74108247,74110330,74108247,74110330,111133470,XM_022481908.1,uncharacterized LOC111133470,2083
NC_035784.1,37083607,37101298,37083607,37101298,111133476,XM_022481916.1,uncharacterized LOC111133476,17691
NC_035780.1,24793776,24796562,24793776,24796562,111133478,XM_022481922.1,uncharacterized LOC111133478,2786
NC_035784.1,22357177,22364534,22357177,22364534,111133479,XM_022481924.1,uncharacterized LOC111133479,7357
NC_035784.1,87135885,87161408,87135885,87161408,111133481,XM_022481925.1,uncharacterized LOC111133481,25523
NC_035784.1,37686755,37705139,37693531,37705139,111133485,XM_022481932.1,uncharacterized LOC111133485,11608
NC_035784.1,37686755,37705139,37693043,37705139,111133485,XM_022481933.1,uncharacterized LOC111133485,12096
NC_035784.1,37686755,37705139,37691575,37705139,111133485,XM_022481931.1,uncharacterized LOC111133485,13564
NC_035784.1,37686755,37705139,37686935,37705139,111133485,XM_022481930.1,uncharacterized LOC111133485,18204
NC_035784.1,37686755,37705139,37686755,37705139,111133485,XM_022481929.1,uncharacterized LOC111133485,18384
NC_035780.1,24778372,24793095,24778372,24793095,111133486,XM_022481934.1,uncharacterized LOC111133486,14723
NC_035784.1,37707964,37715195,37710273,37713112,111133487,XM_022481938.1,uncharacterized LOC111133487,2839
NC_035784.1,37707964,37715195,37710938,37715195,111133487,XM_022481935.1,uncharacterized LOC111133487,4257
NC_035784.1,37707964,37715195,37708237,37713112,111133487,XM_022481936.1,uncharacterized LOC111133487,4875
NC_035784.1,37707964,37715195,37707964,37713112,111133487,XM_022481937.1,uncharacterized LOC111133487,5148
NC_035784.1,80464196,80471986,80464196,80471986,111133493,XM_022481943.1,uncharacterized LOC111133493,7790
NC_035784.1,89388998,89393602,89389115,89393602,111133494,XM_022481946.1,uncharacterized LOC111133494,4487
NC_035784.1,89388998,89393602,89388998,89393602,111133494,XM_022481944.1,uncharacterized LOC111133494,4604
NC_035784.1,24494356,24496846,24494356,24496846,111133496,XM_022481948.1,uncharacterized LOC111133496,2490
NC_035784.1,40867675,40870197,40867675,40870197,111133498,XM_022481950.1,uncharacterized LOC111133498,2522
NC_035784.1,62925947,62930761,62925947,62930574,111133499,XM_022481951.1,uncharacterized LOC111133499,4627
NC_035784.1,62925947,62930761,62925947,62930761,111133499,XM_022481953.1,uncharacterized LOC111133499,4814
NC_035784.1,11951353,11960617,11954206,11960617,111133506,XM_022481959.1,uncharacterized LOC111133506,6411
NC_035784.1,11951353,11960617,11954205,11960617,111133506,XM_022481963.1,uncharacterized LOC111133506,6412
NC_035784.1,11951353,11960617,11951354,11960617,111133506,XM_022481964.1,uncharacterized LOC111133506,9263
NC_035784.1,11951353,11960617,11951353,11960617,111133506,XM_022481962.1,uncharacterized LOC111133506,9264
NC_035784.1,74866108,74878997,74866108,74878997,111133508,XM_022481969.1,uncharacterized LOC111133508,12889
NC_035784.1,74881507,74888050,74881507,74888050,111133510,XM_022481972.1,uncharacterized LOC111133510,6543
NC_035784.1,9573730,9600745,9573730,9597653,111133512,XM_022481974.1,uncharacterized LOC111133512,23923
NC_035784.1,9573730,9600745,9573730,9600745,111133512,XM_022481973.1,uncharacterized LOC111133512,27015
NC_035784.1,15280208,15289523,15280208,15289523,111133518,XM_022481982.1,uncharacterized LOC111133518,9315
NC_035784.1,25769192,25771771,25769192,25771771,111133523,XM_022481989.1,uncharacterized LOC111133523,2579
NC_035784.1,39910132,39917133,39915017,39917133,111133535,XM_022482003.1,uncharacterized LOC111133535,2116
NC_035784.1,39910132,39917133,39910132,39917133,111133535,XM_022482004.1,uncharacterized LOC111133535,7001
NC_035784.1,28191712,28194027,28191712,28194027,111133536,XM_022482005.1,uncharacterized LOC111133536,2315
NC_035784.1,72092569,72098203,72096134,72098203,111133537,XM_022482006.1,uncharacterized LOC111133537,2069
NC_035784.1,72092569,72098203,72092569,72098203,111133537,XM_022482007.1,uncharacterized LOC111133537,5634
NC_035784.1,51743519,51746458,51743519,51746458,111133539,XM_022482011.1,uncharacterized LOC111133539,2939
NC_035784.1,51762892,51765211,51762892,51765211,111133540,XM_022482012.1,uncharacterized LOC111133540,2319
NC_035784.1,51785854,51788484,51785854,51788484,111133541,XM_022482013.1,uncharacterized LOC111133541,2630
NC_035784.1,51771675,51773154,51771675,51773154,111133543,XM_022482015.1,uncharacterized LOC111133543,1479
NC_035784.1,37259722,37265444,37259722,37265444,111133548,XM_022482021.1,uncharacterized LOC111133548,5722
NC_035784.1,95112978,95115946,95112978,95115946,111133549,XM_022482022.1,uncharacterized LOC111133549,2968
NC_035784.1,71433299,71442428,71433299,71442428,111133550,XM_022482023.1,uncharacterized LOC111133550,9129
NC_035784.1,1171021,1172901,1171021,1172901,111133552,XM_022482026.1,uncharacterized LOC111133552,1880
NC_035784.1,48665738,48673749,48665739,48673749,111133553,XM_022482029.1,uncharacterized LOC111133553,8010
NC_035784.1,48665738,48673749,48665738,48673749,111133553,XM_022482027.1,uncharacterized LOC111133553,8011
NC_035784.1,48690656,48702044,48690656,48702044,111133555,XM_022482030.1,uncharacterized LOC111133555,11388
NC_035784.1,36676254,36684835,36676254,36684835,111133566,XM_022482046.1,uncharacterized LOC111133566,8581
NC_035784.1,26741452,26750534,26741452,26750534,111133576,XM_022482073.1,uncharacterized LOC111133576,9082
NC_035784.1,26909939,26914141,26909939,26914141,111133580,XM_022482082.1,uncharacterized LOC111133580,4202
NC_035784.1,26879508,26888202,26879508,26888202,111133585,XM_022482089.1,uncharacterized LOC111133585,8694
NC_035784.1,26523933,26532633,26523935,26532633,111133587,XM_022482094.1,uncharacterized LOC111133587,8698
NC_035784.1,26523933,26532633,26523933,26532633,111133587,XM_022482095.1,uncharacterized LOC111133587,8700
NC_035784.1,26765821,26769344,26765821,26769324,111133603,XM_022482116.1,uncharacterized LOC111133603,3503
NC_035784.1,26765821,26769344,26765821,26769344,111133603,XM_022482117.1,uncharacterized LOC111133603,3523
NC_035784.1,26598133,26599535,26598133,26599535,111133612,XM_022482136.1,uncharacterized LOC111133612,1402
NC_035784.1,26981562,26984018,26982248,26984018,111133613,XM_022482137.1,uncharacterized LOC111133613,1770
NC_035784.1,26905570,26907865,26905570,26907865,111133614,XM_022482138.1,uncharacterized LOC111133614,2295
NC_035784.1,26677071,26685701,26677071,26685701,111133615,XM_022482139.1,uncharacterized LOC111133615,8630
NC_035784.1,27062107,27066112,27062107,27066112,111133616,XM_022482140.1,uncharacterized LOC111133616,4005
NC_035780.1,39712344,39749268,39712344,39722500,111133618,XM_022482151.1,uncharacterized LOC111133618,10156
NC_035780.1,39712344,39749268,39712344,39723726,111133618,XM_022482145.1,uncharacterized LOC111133618,11382
NC_035784.1,27353999,27356156,27353999,27356156,111133628,XM_022482150.1,uncharacterized LOC111133628,2157
NC_035784.1,87389021,87400578,87389021,87400578,111133630,XM_022482152.1,uncharacterized LOC111133630,11557
NC_035784.1,24629445,24649040,24629445,24649040,111133633,XM_022482157.1,uncharacterized LOC111133633,19595
NC_035784.1,12832683,12844390,12832683,12844390,111133637,XM_022482163.1,uncharacterized LOC111133637,11707
NC_035784.1,1278042,1282924,1278042,1282919,111133643,XM_022482169.1,uncharacterized LOC111133643,4877
NC_035784.1,1278042,1282924,1278042,1282924,111133643,XM_022482168.1,uncharacterized LOC111133643,4882
NC_035780.1,39729622,39731109,39729622,39731109,111133644,XM_022482174.1,uncharacterized LOC111133644,1487
NC_035784.1,1211936,1219249,1211936,1216312,111133645,XM_022482170.1,uncharacterized LOC111133645,4376
NC_035784.1,1211936,1219249,1211936,1217061,111133645,XM_022482171.1,uncharacterized LOC111133645,5125
NC_035784.1,1211936,1219249,1211936,1219249,111133645,XM_022482172.1,uncharacterized LOC111133645,7313
NC_035784.1,1196300,1246352,1196300,1246352,111133646,XM_022482176.1,uncharacterized LOC111133646,50052
NC_035784.1,1196300,1246352,1196300,1204310,111133646,XM_022482175.1,uncharacterized LOC111133646,8010
NC_035784.1,1259718,1266441,1259718,1266441,111133647,XM_022482178.1,uncharacterized LOC111133647,6723
NC_035784.1,1181893,1191202,1181893,1191033,111133648,XM_022482180.1,uncharacterized LOC111133648,9140
NC_035784.1,1181893,1191202,1181893,1191202,111133648,XM_022482179.1,uncharacterized LOC111133648,9309
NC_035784.1,1219288,1226044,1219288,1226044,111133649,XM_022482182.1,uncharacterized LOC111133649,6756
NC_035784.1,1306195,1307372,1306195,1307372,111133650,XM_022482183.1,uncharacterized LOC111133650,1177
NC_035784.1,73868935,73881111,73868935,73881111,111133659,XM_022482194.1,uncharacterized LOC111133659,12176
NC_035784.1,73868935,73881111,73868935,73871695,111133659,XM_022482195.1,uncharacterized LOC111133659,2760
NC_035784.1,42940096,42951625,42940096,42951625,111133660,XM_022482196.1,uncharacterized LOC111133660,11529
NC_035784.1,42940096,42951625,42946655,42951625,111133660,XM_022482197.1,uncharacterized LOC111133660,4970
NC_035784.1,18093702,18115657,18093702,18115657,111133663,XM_022482201.1,uncharacterized LOC111133663,21955
NC_035784.1,18093702,18115657,18106435,18115657,111133663,XM_022482200.1,uncharacterized LOC111133663,9222
NC_035784.1,12384977,12408040,12387035,12408039,111133666,XM_022482258.1,uncharacterized LOC111133666,21004
NC_035784.1,12384977,12408040,12387035,12408040,111133666,XM_022482250.1,uncharacterized LOC111133666,21005
NC_035784.1,12384977,12408040,12384980,12406731,111133666,XM_022482242.1,uncharacterized LOC111133666,21751
NC_035784.1,12384977,12408040,12384980,12406732,111133666,XM_022482231.1,uncharacterized LOC111133666,21752
NC_035784.1,12384977,12408040,12384979,12406733,111133666,XM_022482239.1,uncharacterized LOC111133666,21754
NC_035784.1,12384977,12408040,12384979,12406734,111133666,XM_022482215.1,uncharacterized LOC111133666,21755
NC_035784.1,12384977,12408040,12384978,12406735,111133666,XM_022482207.1,uncharacterized LOC111133666,21757
NC_035784.1,12384977,12408040,12384980,12407996,111133666,XM_022482230.1,uncharacterized LOC111133666,23016
NC_035784.1,12384977,12408040,12384980,12407997,111133666,XM_022482224.1,uncharacterized LOC111133666,23017
NC_035784.1,12384977,12408040,12384978,12407996,111133666,XM_022482206.1,uncharacterized LOC111133666,23018
NC_035784.1,12384977,12408040,12384979,12408006,111133666,XM_022482238.1,uncharacterized LOC111133666,23027
NC_035784.1,12384977,12408040,12384980,12408017,111133666,XM_022482217.1,uncharacterized LOC111133666,23037
NC_035784.1,12384977,12408040,12384980,12408019,111133666,XM_022482241.1,uncharacterized LOC111133666,23039
NC_035784.1,12384977,12408040,12384979,12408020,111133666,XM_022482214.1,uncharacterized LOC111133666,23041
NC_035784.1,12384977,12408040,12384984,12408040,111133666,XM_022482254.1,uncharacterized LOC111133666,23056
NC_035784.1,12384977,12408040,12384983,12408040,111133666,XM_022482257.1,uncharacterized LOC111133666,23057
NC_035784.1,12384977,12408040,12384982,12408040,111133666,XM_022482259.1,uncharacterized LOC111133666,23058
NC_035784.1,12384977,12408040,12384981,12408040,111133666,XM_022482252.1,uncharacterized LOC111133666,23059
NC_035784.1,12384977,12408040,12384980,12408040,111133666,XM_022482240.1,uncharacterized LOC111133666,23060
NC_035784.1,12384977,12408040,12384979,12408040,111133666,XM_022482244.1,uncharacterized LOC111133666,23061
NC_035784.1,12384977,12408040,12384978,12408040,111133666,XM_022482251.1,uncharacterized LOC111133666,23062
NC_035784.1,12384977,12408040,12384977,12408040,111133666,XM_022482246.1,uncharacterized LOC111133666,23063
NC_035784.1,74102058,74106038,74102058,74106038,111133667,XM_022482260.1,uncharacterized LOC111133667,3980
NC_035784.1,32498560,32509449,32498571,32509449,111133668,XM_022482261.1,uncharacterized LOC111133668,10878
NC_035784.1,32498560,32509449,32498560,32509449,111133668,XM_022482263.1,uncharacterized LOC111133668,10889
NC_035784.1,61500371,61508930,61500451,61508930,111133669,XM_022482264.1,uncharacterized LOC111133669,8479
NC_035784.1,61500371,61508930,61500438,61508930,111133669,XM_022482266.1,uncharacterized LOC111133669,8492
NC_035784.1,61500371,61508930,61500371,61508930,111133669,XM_022482267.1,uncharacterized LOC111133669,8559
NC_035784.1,51085795,51088427,51085795,51088427,111133675,XM_022482272.1,uncharacterized LOC111133675,2632
NC_035784.1,37870170,37876503,37870170,37876503,111133678,XM_022482277.1,uncharacterized LOC111133678,6333
NC_035784.1,55482219,55484319,55482219,55484319,111133680,XM_022482278.1,uncharacterized LOC111133680,2100
NC_035784.1,82850736,82865128,82850813,82861522,111133683,XM_022482287.1,uncharacterized LOC111133683,10709
NC_035784.1,82850736,82865128,82850736,82865128,111133683,XM_022482286.1,uncharacterized LOC111133683,14392
NC_035784.1,78038536,78047532,78038536,78047532,111133686,XM_022482289.1,uncharacterized LOC111133686,8996
NC_035784.1,30474155,30476607,30474155,30476607,111133689,XM_022482298.1,uncharacterized LOC111133689,2452
NC_035784.1,91240648,91243024,91240648,91243024,111133699,XM_022482313.1,uncharacterized LOC111133699,2376
NC_035784.1,12363297,12376400,12363297,12376400,111133702,XM_022482315.1,uncharacterized LOC111133702,13103
NC_035784.1,2138506,2150189,2138506,2150189,111133706,XM_022482320.1,uncharacterized LOC111133706,11683
NC_035784.1,19733307,19743373,19733315,19743358,111133707,XM_022482321.1,uncharacterized LOC111133707,10043
NC_035784.1,19733307,19743373,19733311,19743364,111133707,XM_022482322.1,uncharacterized LOC111133707,10053
NC_035784.1,19733307,19743373,19733307,19743373,111133707,XM_022482323.1,uncharacterized LOC111133707,10066
NC_035784.1,19766826,19778431,19766826,19778431,111133711,XM_022482331.1,uncharacterized LOC111133711,11605
NC_035784.1,19766826,19778431,19766826,19775562,111133711,XM_022482329.1,uncharacterized LOC111133711,8736
NC_035784.1,18356894,18363446,18356894,18363446,111133713,XM_022482333.1,uncharacterized LOC111133713,6552
NC_035784.1,32197372,32199821,32197372,32199821,111133721,XM_022482339.1,uncharacterized LOC111133721,2449
NC_035784.1,34237387,34242778,34237387,34242778,111133732,XM_022482354.1,uncharacterized LOC111133732,5391
NC_035780.1,38913537,38977695,38913537,38977695,111133737,XM_022484419.1,uncharacterized LOC111133737,64158
NC_035784.1,30157168,30170170,30157168,30170170,111133738,XM_022482364.1,uncharacterized LOC111133738,13002
NC_035784.1,82991368,83012948,82991368,83001939,111133741,XM_022482372.1,uncharacterized LOC111133741,10571
NC_035784.1,82991368,83012948,82991369,83007609,111133741,XM_022482368.1,uncharacterized LOC111133741,16240
NC_035784.1,82991368,83012948,82991369,83007610,111133741,XM_022482369.1,uncharacterized LOC111133741,16241
NC_035784.1,82991368,83012948,82991368,83007610,111133741,XM_022482371.1,uncharacterized LOC111133741,16242
NC_035784.1,82991368,83012948,82991368,83012948,111133741,XM_022482367.1,uncharacterized LOC111133741,21580
NC_035784.1,87022602,87035212,87023607,87035212,111133747,XM_022482379.1,uncharacterized LOC111133747,11605
NC_035784.1,87022602,87035212,87022602,87035212,111133747,XM_022482378.1,uncharacterized LOC111133747,12610
NC_035784.1,79309156,79329717,79309156,79329717,111133749,XM_022482382.1,uncharacterized LOC111133749,20561
NC_035784.1,70706498,70711745,70706498,70709622,111133752,XM_022482386.1,uncharacterized LOC111133752,3124
NC_035784.1,70706498,70711745,70706498,70711745,111133752,XM_022482387.1,uncharacterized LOC111133752,5247
NC_035784.1,6400986,6425258,6400986,6425258,111133756,XM_022482393.1,uncharacterized LOC111133756,24272
NC_035784.1,37980393,37988052,37980393,37988052,111133759,XM_022482398.1,uncharacterized LOC111133759,7659
NC_035780.1,62678936,62684142,62678936,62684142,111133762,XM_022482405.1,uncharacterized LOC111133762,5206
NC_035784.1,23034368,23038370,23034368,23038370,111133763,XM_022482402.1,uncharacterized LOC111133763,4002
NC_035784.1,8345136,8349952,8345136,8349952,111133767,XM_022482408.1,uncharacterized LOC111133767,4816
NC_035784.1,38089407,38093951,38089407,38093951,111133773,XM_022482415.1,uncharacterized LOC111133773,4544
NC_035784.1,59258810,59264703,59262589,59264703,111133775,XM_022482422.1,uncharacterized LOC111133775,2114
NC_035784.1,59258810,59264703,59258810,59264703,111133775,XM_022482421.1,uncharacterized LOC111133775,5893
NC_035784.1,34571594,34576904,34571594,34576904,111133776,XM_022482423.1,uncharacterized LOC111133776,5310
NC_035784.1,68055382,68062311,68055382,68062311,111133778,XM_022482425.1,uncharacterized LOC111133778,6929
NC_035784.1,68774045,68795860,68774052,68795860,111133779,XM_022482431.1,uncharacterized LOC111133779,21808
NC_035784.1,68774045,68795860,68774045,68795860,111133779,XM_022482440.1,uncharacterized LOC111133779,21815
NC_035780.1,56900048,56910029,56900048,56910029,111133782,XM_022482450.1,uncharacterized LOC111133782,9981
NC_035784.1,79820893,79823480,79820893,79823480,111133784,XM_022482448.1,uncharacterized LOC111133784,2587
NC_035784.1,75578573,75584084,75578573,75584084,111133787,XM_022482452.1,uncharacterized LOC111133787,5511
NC_035784.1,75371151,75380941,75371151,75379730,111133788,XM_022482454.1,uncharacterized LOC111133788,8579
NC_035784.1,7369174,7371671,7369174,7371671,111133789,XM_022482455.1,uncharacterized LOC111133789,2497
NC_035784.1,7373261,7376276,7373261,7376276,111133790,XM_022482456.1,uncharacterized LOC111133790,3015
NC_035784.1,12633998,12644627,12634278,12644627,111133795,XM_022482458.1,uncharacterized LOC111133795,10349
NC_035784.1,12633998,12644627,12633998,12644627,111133795,XM_022482459.1,uncharacterized LOC111133795,10629
NC_035784.1,1641294,1649255,1641294,1649255,111133800,XM_022482468.1,uncharacterized LOC111133800,7961
NC_035784.1,90661531,90715576,90661531,90715576,111133806,XM_022482481.1,uncharacterized LOC111133806,54045
NC_035784.1,4897104,4899021,4897104,4899021,111133808,XM_022482486.1,uncharacterized LOC111133808,1917
NC_035784.1,42572424,42579658,42572424,42579658,111133809,XM_022482487.1,uncharacterized LOC111133809,7234
NC_035784.1,28837768,28843952,28837769,28843952,111133813,XM_022482498.1,uncharacterized LOC111133813,6183
NC_035784.1,28837768,28843952,28837768,28843952,111133813,XM_022482497.1,uncharacterized LOC111133813,6184
NC_035784.1,77489664,77493921,77489664,77493921,111133814,XM_022482499.1,uncharacterized LOC111133814,4257
NC_035784.1,77487060,77488580,77487060,77488580,111133816,XM_022482500.1,uncharacterized LOC111133816,1520
NC_035784.1,77487060,77488580,77487060,77487660,111133816,XM_022482501.1,uncharacterized LOC111133816,600
NC_035784.1,6893308,6899527,6893308,6899527,111133819,XM_022482504.1,uncharacterized LOC111133819,6219
NC_035784.1,53576125,53578919,53576125,53578919,111133820,XM_022482505.1,uncharacterized LOC111133820,2794
NC_035784.1,7898140,7903475,7898140,7903475,111133821,XM_022482506.1,uncharacterized LOC111133821,5335
NC_035780.1,15094004,15133694,15094004,15133694,111133824,XM_022482515.1,uncharacterized LOC111133824,39690
NC_035784.1,19916357,19925057,19920860,19925057,111133825,XM_022482513.1,uncharacterized LOC111133825,4197
NC_035784.1,19916357,19925057,19916357,19925057,111133825,XM_022482512.1,uncharacterized LOC111133825,8700
NC_035784.1,42583306,42589015,42583306,42589015,111133826,XM_022482514.1,uncharacterized LOC111133826,5709
NC_035784.1,59872803,59881233,59872803,59881233,111133831,XM_022482522.1,uncharacterized LOC111133831,8430
NC_035780.1,14706549,14726599,14706549,14726599,111133832,XM_022482526.1,uncharacterized LOC111133832,20050
NC_035784.1,28824518,28830957,28828459,28830957,111133833,XM_022482523.1,uncharacterized LOC111133833,2498
NC_035784.1,28824518,28830957,28824518,28830957,111133833,XM_022482524.1,uncharacterized LOC111133833,6439
NC_035780.1,14946689,14965286,14946689,14965286,111133841,XM_022482545.1,uncharacterized LOC111133841,18597
NC_035784.1,50017576,50024516,50017576,50024516,111133843,XM_022482535.1,uncharacterized LOC111133843,6940
NC_035780.1,14785204,14806819,14785204,14806819,111133852,XM_022482559.1,uncharacterized LOC111133852,21615
NC_035784.1,76197451,76200757,76197451,76200757,111133854,XM_022482557.1,uncharacterized LOC111133854,3306
NC_035784.1,56382747,56386993,56382747,56386993,111133857,XM_022482563.1,uncharacterized LOC111133857,4246
NC_035780.1,15110974,15114021,15110974,15112981,111133861,XM_022482578.1,uncharacterized LOC111133861,2007
NC_035780.1,15110974,15114021,15110974,15114021,111133861,XM_022482571.1,uncharacterized LOC111133861,3047
NC_035784.1,18857578,18865524,18857578,18865524,111133865,XM_022482572.1,uncharacterized LOC111133865,7946
NC_035784.1,58333676,58336027,58333679,58336027,111133867,XM_022482573.1,uncharacterized LOC111133867,2348
NC_035784.1,58333676,58336027,58333676,58336027,111133867,XM_022482574.1,uncharacterized LOC111133867,2351
NC_035784.1,4207382,4219734,4207382,4219734,111133869,XM_022482576.1,uncharacterized LOC111133869,12352
NC_035784.1,13648457,13651563,13648463,13651563,111133875,XM_022482581.1,uncharacterized LOC111133875,3100
NC_035784.1,13648457,13651563,13648457,13651563,111133875,XM_022482582.1,uncharacterized LOC111133875,3106
NC_035780.1,14696795,14943530,14696795,14698182,111133877,XM_022482604.1,uncharacterized LOC111133877,1387
NC_035780.1,14696795,14943530,14696795,14943530,111133877,XM_022482614.1,uncharacterized LOC111133877,246735
NC_035780.1,14696795,14943530,14696796,14699583,111133877,XM_022482587.1,uncharacterized LOC111133877,2787
NC_035780.1,14696795,14943530,14696796,14701327,111133877,XM_022482596.1,uncharacterized LOC111133877,4531
NC_035784.1,41527498,41532882,41527498,41532882,111133879,XM_022482586.1,uncharacterized LOC111133879,5384
NC_035784.1,41521076,41524863,41521076,41524863,111133880,XM_022482588.1,uncharacterized LOC111133880,3787
NC_035784.1,41535517,41539859,41535517,41539859,111133881,XM_022482589.1,uncharacterized LOC111133881,4342
NC_035784.1,63418719,63419901,63418719,63419901,111133882,XM_022482590.1,uncharacterized LOC111133882,1182
NC_035784.1,1159814,1166285,1159814,1166285,111133883,XM_022482592.1,uncharacterized LOC111133883,6471
NC_035784.1,85811878,85826221,85811878,85826221,111133884,XM_022482594.1,uncharacterized LOC111133884,14343
NC_035784.1,85811878,85826221,85811878,85821241,111133884,XM_022482593.1,uncharacterized LOC111133884,9363
NC_035784.1,68047987,68055156,68047987,68055156,111133885,XM_022482595.1,uncharacterized LOC111133885,7169
NC_035784.1,40248254,40250194,40248254,40250194,111133888,XM_022482599.1,uncharacterized LOC111133888,1940
NC_035780.1,15235538,15245587,15235538,15245587,111133897,XM_022482627.1,uncharacterized LOC111133897,10049
NC_035784.1,85378124,85394808,85378124,85394808,111133898,XM_022482624.1,uncharacterized LOC111133898,16684
NC_035784.1,3875659,3891305,3875659,3891305,111133900,XM_022482630.1,uncharacterized LOC111133900,15646
NC_035784.1,3875659,3891305,3885191,3891305,111133900,XM_022482629.1,uncharacterized LOC111133900,6114
NC_035780.1,14703075,14706538,14703316,14706534,111133904,XM_022482640.1,uncharacterized LOC111133904,3218
NC_035784.1,42343187,42373044,42343187,42373043,111133907,XM_022482638.1,uncharacterized LOC111133907,29856
NC_035784.1,42343187,42373044,42343187,42373044,111133907,XM_022482639.1,uncharacterized LOC111133907,29857
NC_035784.1,61709836,61714014,61709836,61714014,111133908,XM_022482641.1,uncharacterized LOC111133908,4178
NC_035784.1,14047998,14062839,14047998,14062839,111133910,XM_022482643.1,uncharacterized LOC111133910,14841
NC_035784.1,31342093,31351308,31342093,31351308,111133914,XM_022482651.1,uncharacterized LOC111133914,9215
NC_035784.1,31337191,31340765,31337191,31340765,111133915,XM_022482652.1,uncharacterized LOC111133915,3574
NC_035780.1,14943770,14946638,14944204,14946638,111133916,XM_022482655.1,uncharacterized LOC111133916,2434
NC_035784.1,9976244,9979899,9976244,9979899,111133918,XM_022482653.1,uncharacterized LOC111133918,3655
NC_035784.1,82930171,82939087,82930171,82939087,111133923,XM_022482663.1,uncharacterized LOC111133923,8916
NC_035784.1,82939106,82942410,82939106,82942410,111133924,XM_022482664.1,uncharacterized LOC111133924,3304
NC_035780.1,14905751,14906253,14905751,14906253,111133927,XM_022482672.1,uncharacterized LOC111133927,502
NC_035784.1,5945503,5952263,5945503,5952263,111133933,XM_022482676.1,uncharacterized LOC111133933,6760
NC_035784.1,23566848,23581180,23566848,23581180,111133934,XM_022482677.1,uncharacterized LOC111133934,14332
NC_035784.1,23566848,23581180,23566848,23574340,111133934,XM_022482680.1,uncharacterized LOC111133934,7492
NC_035784.1,23566848,23581180,23566848,23575094,111133934,XM_022482678.1,uncharacterized LOC111133934,8246
NC_035784.1,23566848,23581180,23566848,23576108,111133934,XM_022482679.1,uncharacterized LOC111133934,9260
NC_035780.1,14839825,14840400,14839825,14840400,111133935,XM_022482683.1,uncharacterized LOC111133935,575
NC_035784.1,42743069,42744729,42743069,42744729,111133940,XM_022482685.1,uncharacterized LOC111133940,1660
NC_035784.1,42734360,42736607,42734360,42736607,111133941,XM_022482686.1,uncharacterized LOC111133941,2247
NC_035784.1,42725249,42726838,42725249,42726838,111133942,XM_022482687.1,uncharacterized LOC111133942,1589
NC_035784.1,85837041,85858222,85837041,85858222,111133945,XM_022482690.1,uncharacterized LOC111133945,21181
NC_035784.1,3556491,3568832,3556491,3568832,111133947,XM_022482691.1,uncharacterized LOC111133947,12341
NC_035784.1,63045894,63048345,63045894,63048345,111133952,XM_022482698.1,uncharacterized LOC111133952,2451
NC_035784.1,35178617,35189055,35178617,35189055,111133957,XM_022482702.1,uncharacterized LOC111133957,10438
NC_035784.1,60129947,60138306,60129947,60138306,111133971,XM_022482718.1,uncharacterized LOC111133971,8359
NC_035784.1,19036826,19043479,19036826,19043479,111133972,XM_022482719.1,uncharacterized LOC111133972,6653
NC_035784.1,55090533,55093149,55090533,55093149,111133974,XM_022482721.1,uncharacterized LOC111133974,2616
NC_035784.1,1114569,1115885,1114569,1115885,111133975,XM_022482722.1,uncharacterized LOC111133975,1316
NC_035784.1,41499646,41504021,41499646,41504021,111133980,XM_022482724.1,uncharacterized LOC111133980,4375
NC_035784.1,55457721,55461209,55457721,55461209,111133981,XM_022482725.1,uncharacterized LOC111133981,3488
NC_035784.1,6517295,6523371,6517295,6523371,111133984,XM_022482728.1,uncharacterized LOC111133984,6076
NC_035784.1,90502589,90505362,90502589,90505362,111133990,XM_022482735.1,uncharacterized LOC111133990,2773
NC_035780.1,18954797,18960631,18954797,18960631,111133993,XM_022482741.1,uncharacterized LOC111133993,5834
NC_035784.1,9043259,9046930,9043259,9046930,111133996,XM_022482747.1,uncharacterized LOC111133996,3671
NC_035780.1,18890851,18897164,18890851,18897164,111133999,XM_022482754.1,uncharacterized LOC111133999,6313
NC_035780.1,50739789,50743719,50739789,50743719,111134001,XM_022482796.1,uncharacterized LOC111134001,3930
NC_035784.1,84073462,84079158,84073462,84078663,111134003,XM_022482764.1,uncharacterized LOC111134003,5201
NC_035784.1,84073462,84079158,84073462,84079158,111134003,XM_022482765.1,uncharacterized LOC111134003,5696
NC_035784.1,34100414,34107614,34100415,34107613,111134005,XM_022482767.1,uncharacterized LOC111134005,7198
NC_035784.1,34100414,34107614,34100414,34107614,111134005,XM_022482766.1,uncharacterized LOC111134005,7200
NC_035784.1,40550127,40557286,40554375,40557285,111134006,XM_022482768.1,uncharacterized LOC111134006,2910
NC_035784.1,40550127,40557286,40554375,40557286,111134006,XM_022482769.1,uncharacterized LOC111134006,2911
NC_035784.1,40550127,40557286,40550127,40557286,111134006,XM_022482770.1,uncharacterized LOC111134006,7159
NC_035784.1,84988883,84989665,84988883,84989665,111134013,XM_022482778.1,uncharacterized LOC111134013,782
NC_035784.1,21147190,21150088,21147190,21150088,111134016,XM_022482781.1,uncharacterized LOC111134016,2898
NC_035784.1,57677265,57680470,57677265,57680470,111134020,XM_022482784.1,uncharacterized LOC111134020,3205
NC_035784.1,57669334,57671907,57669334,57671907,111134021,XM_022482786.1,uncharacterized LOC111134021,2573
NC_035784.1,57648864,57652096,57648864,57652096,111134022,XM_022482787.1,uncharacterized LOC111134022,3232
NC_035784.1,5664513,5668625,5664513,5668625,111134026,XM_022482791.1,uncharacterized LOC111134026,4112
NC_035784.1,65514886,65535156,65515689,65535156,111134027,XM_022482793.1,uncharacterized LOC111134027,19467
NC_035784.1,40865253,40867338,40865253,40867338,111134029,XM_022482795.1,uncharacterized LOC111134029,2085
NC_035784.1,23484759,23502038,23491969,23502038,111134030,XM_022482801.1,uncharacterized LOC111134030,10069
NC_035784.1,23484759,23502038,23491633,23502038,111134030,XM_022482800.1,uncharacterized LOC111134030,10405
NC_035784.1,23484759,23502038,23490292,23502038,111134030,XM_022482797.1,uncharacterized LOC111134030,11746
NC_035784.1,23484759,23502038,23484759,23502038,111134030,XM_022482799.1,uncharacterized LOC111134030,17279
NC_035784.1,40860790,40862912,40860790,40862912,111134032,XM_022482802.1,uncharacterized LOC111134032,2122
NC_035784.1,9464642,9470832,9464642,9470832,111134033,XM_022482803.1,uncharacterized LOC111134033,6190
NC_035784.1,685460,688091,685460,688091,111134034,XM_022482804.1,uncharacterized LOC111134034,2631
NC_035784.1,74564939,74642470,74564939,74642470,111134035,XM_022482806.1,uncharacterized LOC111134035,77531
NC_035784.1,71190016,71209128,71190328,71209128,111134038,XM_022482809.1,uncharacterized LOC111134038,18800
NC_035784.1,71190016,71209128,71190016,71209128,111134038,XM_022482808.1,uncharacterized LOC111134038,19112
NC_035784.1,60975465,60976792,60975465,60976792,111134040,XM_022482812.1,uncharacterized LOC111134040,1327
NC_035784.1,60962920,60964217,60962920,60964217,111134041,XM_022482813.1,uncharacterized LOC111134041,1297
NC_035784.1,43119969,43122337,43119969,43122175,111134048,XM_022482836.1,uncharacterized LOC111134048,2206
NC_035784.1,43119969,43122337,43119969,43122337,111134048,XM_022482837.1,uncharacterized LOC111134048,2368
NC_035784.1,11084266,11090289,11084266,11090289,111134051,XM_022482840.1,uncharacterized LOC111134051,6023
NC_035784.1,1797831,1801912,1797831,1801912,111134052,XM_022482841.1,uncharacterized LOC111134052,4081
NC_035784.1,16327939,16334925,16327939,16334925,111134053,XM_022482844.1,uncharacterized LOC111134053,6986
NC_035780.1,40905364,40909634,40905906,40909634,111134055,XM_022482858.1,uncharacterized LOC111134055,3728
NC_035780.1,40905364,40909634,40905364,40909609,111134055,XM_022482848.1,uncharacterized LOC111134055,4245
NC_035784.1,14170975,14208412,14170975,14208412,111134056,XM_022482845.1,uncharacterized LOC111134056,37437
NC_035784.1,14257287,14271513,14257287,14271513,111134057,XM_022482846.1,uncharacterized LOC111134057,14226
NC_035784.1,14218676,14257154,14218676,14257154,111134058,XM_022482847.1,uncharacterized LOC111134058,38478
NC_035784.1,55447732,55449156,55447732,55449156,111134061,XM_022482859.1,uncharacterized LOC111134061,1424
NC_035784.1,9271116,9278235,9271116,9278235,111134062,XM_022482860.1,uncharacterized LOC111134062,7119
NC_035784.1,62590788,62593616,62590788,62593616,111134069,XM_022482866.1,uncharacterized LOC111134069,2828
NC_035784.1,14480831,14489118,14480831,14489118,111134075,XM_022482874.1,uncharacterized LOC111134075,8287
NC_035780.1,40941753,41024218,40941753,41024218,111134078,XM_022482880.1,uncharacterized LOC111134078,82465
NC_035784.1,34700843,34705137,34700843,34705137,111134080,XM_022482881.1,uncharacterized LOC111134080,4294
NC_035784.1,67796820,67814830,67796826,67814830,111134081,XM_022482883.1,uncharacterized LOC111134081,18004
NC_035784.1,67796820,67814830,67796820,67814830,111134081,XM_022482882.1,uncharacterized LOC111134081,18010
NC_035784.1,62248241,62259164,62248241,62259164,111134082,XM_022482885.1,uncharacterized LOC111134082,10923
NC_035784.1,62259776,62276776,62259776,62276776,111134084,XM_022482887.1,uncharacterized LOC111134084,17000
NC_035784.1,34141825,34165362,34155163,34165362,111134089,XM_022482897.1,uncharacterized LOC111134089,10199
NC_035784.1,34141825,34165362,34147565,34165362,111134089,XM_022482900.1,uncharacterized LOC111134089,17797
NC_035784.1,34141825,34165362,34144057,34165362,111134089,XM_022482899.1,uncharacterized LOC111134089,21305
NC_035784.1,34141825,34165362,34141850,34165362,111134089,XM_022482893.1,uncharacterized LOC111134089,23512
NC_035784.1,34141825,34165362,34141825,34165362,111134089,XM_022482896.1,uncharacterized LOC111134089,23537
NC_035784.1,34141825,34165362,34155460,34165362,111134089,XM_022482898.1,uncharacterized LOC111134089,9902
NC_035784.1,34128479,34130700,34128479,34130700,111134091,XM_022482901.1,uncharacterized LOC111134091,2221
NC_035784.1,34108384,34114206,34108384,34114206,111134092,XM_022482902.1,uncharacterized LOC111134092,5822
NC_035784.1,89453567,89456121,89453567,89456121,111134099,XM_022482905.1,uncharacterized LOC111134099,2554
NC_035784.1,49409823,49416702,49409824,49413419,111134100,XM_022482907.1,uncharacterized LOC111134100,3595
NC_035784.1,49409823,49416702,49409823,49416702,111134100,XM_022482906.1,uncharacterized LOC111134100,6879
NC_035784.1,75903181,75913074,75903181,75913074,111134101,XM_022482908.1,uncharacterized LOC111134101,9893
NC_035784.1,1565839,1572378,1565839,1572378,111134105,XM_022482912.1,uncharacterized LOC111134105,6539
NC_035784.1,63298500,63301571,63299083,63301571,111134110,XM_022482923.1,uncharacterized LOC111134110,2488
NC_035784.1,63298500,63301571,63298500,63301571,111134110,XM_022482924.1,uncharacterized LOC111134110,3071
NC_035784.1,81195378,81198391,81195378,81198391,111134116,XM_022482935.1,uncharacterized LOC111134116,3013
NC_035784.1,23505095,23516641,23505095,23516338,111134120,XM_022482940.1,uncharacterized LOC111134120,11243
NC_035784.1,23505095,23516641,23505095,23516641,111134120,XM_022482939.1,uncharacterized LOC111134120,11546
NC_035784.1,25052569,25061928,25052569,25061928,111134124,XM_022482947.1,uncharacterized LOC111134124,9359
NC_035784.1,9759430,9813903,9760294,9791843,111134125,XM_022482949.1,uncharacterized LOC111134125,31549
NC_035784.1,9759430,9813903,9759430,9813903,111134125,XM_022482948.1,uncharacterized LOC111134125,54473
NC_035784.1,76845519,76874981,76845519,76874981,111134126,XM_022482950.1,uncharacterized LOC111134126,29462
NC_035784.1,74690133,74694164,74690133,74694164,111134127,XM_022482951.1,uncharacterized LOC111134127,4031
NC_035784.1,84767701,84770199,84767701,84770199,111134130,XM_022482952.1,uncharacterized LOC111134130,2498
NC_035784.1,85351914,85359644,85351914,85359644,111134131,XM_022482953.1,uncharacterized LOC111134131,7730
NC_035784.1,42251094,42268363,42252584,42268363,111134132,XM_022482958.1,uncharacterized LOC111134132,15779
NC_035784.1,42251094,42268363,42251094,42267799,111134132,XM_022482956.1,uncharacterized LOC111134132,16705
NC_035784.1,42251094,42268363,42251094,42268341,111134132,XM_022482954.1,uncharacterized LOC111134132,17247
NC_035784.1,42251094,42268363,42251094,42253364,111134132,XM_022482957.1,uncharacterized LOC111134132,2270
NC_035784.1,57067867,57094094,57067867,57094094,111134133,XM_022482960.1,uncharacterized LOC111134133,26227
NC_035780.1,30327883,30339732,30327883,30339732,111134137,XM_022482966.1,uncharacterized LOC111134137,11849
NC_035784.1,5145160,5160649,5145509,5160649,111134140,XM_022482969.1,uncharacterized LOC111134140,15140
NC_035784.1,5145160,5160649,5145160,5160649,111134140,XM_022482970.1,uncharacterized LOC111134140,15489
NC_035784.1,38284373,38298522,38284373,38298522,111134142,XM_022482971.1,uncharacterized LOC111134142,14149
NC_035784.1,80627313,80631368,80627835,80631368,111134143,XM_022482974.1,uncharacterized LOC111134143,3533
NC_035784.1,80627313,80631368,80627313,80631368,111134143,XM_022482973.1,uncharacterized LOC111134143,4055
NC_035784.1,40077726,40094276,40077726,40094269,111134145,XM_022482978.1,uncharacterized LOC111134145,16543
NC_035784.1,40077726,40094276,40077726,40094276,111134145,XM_022482977.1,uncharacterized LOC111134145,16550
NC_035784.1,20152041,20154682,20152041,20154682,111134158,XM_022482993.1,uncharacterized LOC111134158,2641
NC_035784.1,20194540,20214226,20194540,20213686,111134159,XM_022482995.1,uncharacterized LOC111134159,19146
NC_035784.1,20194540,20214226,20194540,20214226,111134159,XM_022482994.1,uncharacterized LOC111134159,19686
NC_035784.1,20158406,20161463,20158406,20161463,111134160,XM_022482996.1,uncharacterized LOC111134160,3057
NC_035784.1,20149575,20152171,20149575,20152171,111134165,XM_022483000.1,uncharacterized LOC111134165,2596
NC_035784.1,20261196,20263175,20261196,20263175,111134170,XM_022483009.1,uncharacterized LOC111134170,1979
NC_035784.1,20587419,20594022,20587419,20594022,111134172,XM_022483010.1,uncharacterized LOC111134172,6603
NC_035784.1,63638635,63641704,63638635,63641704,111134183,XM_022483021.1,uncharacterized LOC111134183,3069
NC_035784.1,63569745,63579207,63569745,63579207,111134184,XM_022483022.1,uncharacterized LOC111134184,9462
NC_035784.1,63643164,63645254,63643164,63645254,111134185,XM_022483024.1,uncharacterized LOC111134185,2090
NC_035784.1,77918028,77929273,77918028,77929273,111134190,XM_022483028.1,uncharacterized LOC111134190,11245
NC_035784.1,80221833,80228572,80221833,80228572,111134191,XM_022483031.1,uncharacterized LOC111134191,6739
NC_035784.1,32723460,32732201,32723460,32732161,111134192,XM_022483032.1,uncharacterized LOC111134192,8701
NC_035784.1,75680178,75688463,75680178,75688463,111134212,XM_022483063.1,uncharacterized LOC111134212,8285
NC_035784.1,93301538,93309686,93301538,93309686,111134215,XM_022483066.1,uncharacterized LOC111134215,8148
NC_035780.1,14020762,14066106,14064707,14066106,111134218,XM_022483100.1,uncharacterized LOC111134218,1399
NC_035780.1,14020762,14066106,14063312,14066105,111134218,XM_022483075.1,uncharacterized LOC111134218,2793
NC_035780.1,14020762,14066106,14020762,14066106,111134218,XM_022483083.1,uncharacterized LOC111134218,45344
NC_035780.1,14020762,14066106,14061559,14066105,111134218,XM_022483091.1,uncharacterized LOC111134218,4546
NC_035784.1,93138477,93186030,93152566,93186030,111134219,XM_022483072.1,uncharacterized LOC111134219,33464
NC_035784.1,93138477,93186030,93138477,93186030,111134219,XM_022483073.1,uncharacterized LOC111134219,47553
NC_035784.1,93095005,93097277,93095005,93097277,111134224,XM_022483080.1,uncharacterized LOC111134224,2272
NC_035784.1,93116120,93118230,93116123,93118230,111134225,XM_022483081.1,uncharacterized LOC111134225,2107
NC_035784.1,93116120,93118230,93116120,93118230,111134225,XM_022483082.1,uncharacterized LOC111134225,2110
NC_035784.1,45682060,45699864,45689665,45699864,111134230,XM_022483093.1,uncharacterized LOC111134230,10199
NC_035784.1,45682060,45699864,45685385,45699863,111134230,XM_022483094.1,uncharacterized LOC111134230,14478
NC_035784.1,45682060,45699864,45683699,45699861,111134230,XM_022483097.1,uncharacterized LOC111134230,16162
NC_035784.1,45682060,45699864,45682060,45699861,111134230,XM_022483096.1,uncharacterized LOC111134230,17801
NC_035784.1,45682060,45699864,45689959,45699863,111134230,XM_022483095.1,uncharacterized LOC111134230,9904
NC_035784.1,22213653,22226999,22213653,22226999,111134233,XM_022483101.1,uncharacterized LOC111134233,13346
NC_035784.1,22215524,22241146,22215524,22241146,111134234,XM_022483102.1,uncharacterized LOC111134234,25622
NC_035784.1,10630354,10638802,10630354,10638802,111134236,XM_022483108.1,uncharacterized LOC111134236,8448
NC_035780.1,14017674,14061247,14017674,14020125,111134237,XM_022483114.1,uncharacterized LOC111134237,2451
NC_035780.1,14017674,14061247,14017674,14061084,111134237,XM_022483124.1,uncharacterized LOC111134237,43410
NC_035784.1,1126993,1132637,1126993,1132637,111134241,XM_022483122.1,uncharacterized LOC111134241,5644
NC_035784.1,245880,257808,245880,257808,111134245,XM_022483134.1,uncharacterized LOC111134245,11928
NC_035784.1,84604018,84638255,84604018,84638255,111134251,XM_022483139.1,uncharacterized LOC111134251,34237
NC_035784.1,28803360,28822480,28807865,28820546,111134253,XM_022483142.1,uncharacterized LOC111134253,12681
NC_035784.1,28803360,28822480,28807865,28822480,111134253,XM_022483143.1,uncharacterized LOC111134253,14615
NC_035784.1,28813541,28821173,28813541,28820564,111134255,XM_022483145.1,uncharacterized LOC111134255,7023
NC_035784.1,28813541,28821173,28813541,28821173,111134255,XM_022483144.1,uncharacterized LOC111134255,7632
NC_035784.1,5361470,5372654,5361470,5372654,111134257,XM_022483146.1,uncharacterized LOC111134257,11184
NC_035784.1,49525993,49534442,49525993,49530894,111134258,XM_022483148.1,uncharacterized LOC111134258,4901
NC_035784.1,49525993,49534442,49525993,49531045,111134258,XM_022483149.1,uncharacterized LOC111134258,5052
NC_035784.1,49525993,49534442,49525993,49534442,111134258,XM_022483147.1,uncharacterized LOC111134258,8449
NC_035780.1,52493489,52499176,52493489,52499176,111134259,XM_022483152.1,uncharacterized LOC111134259,5687
NC_035784.1,65679442,65683040,65679442,65683040,111134261,XM_022483151.1,uncharacterized LOC111134261,3598
NC_035784.1,41325739,41334554,41325739,41333475,111134262,XM_022483153.1,uncharacterized LOC111134262,7736
NC_035784.1,41325739,41334554,41325739,41334554,111134262,XM_022483154.1,uncharacterized LOC111134262,8815
NC_035784.1,87173624,87192157,87173624,87192157,111134264,XM_022483155.1,uncharacterized LOC111134264,18533
NC_035784.1,59415199,59448104,59420430,59448104,111134265,XM_022483157.1,uncharacterized LOC111134265,27674
NC_035784.1,59415199,59448104,59415199,59448104,111134265,XM_022483156.1,uncharacterized LOC111134265,32905
NC_035784.1,59448123,59458773,59448123,59458773,111134267,XM_022483162.1,uncharacterized LOC111134267,10650
NC_035784.1,59448123,59458773,59448123,59450967,111134267,XM_022483164.1,uncharacterized LOC111134267,2844
NC_035784.1,59448123,59458773,59448123,59451902,111134267,XM_022483166.1,uncharacterized LOC111134267,3779
NC_035784.1,59448123,59458773,59448123,59452913,111134267,XM_022483165.1,uncharacterized LOC111134267,4790
NC_035784.1,59455745,59458276,59455745,59458276,111134268,XM_022483167.1,uncharacterized LOC111134268,2531
NC_035784.1,89284526,89287701,89284526,89287701,111134271,XM_022483169.1,uncharacterized LOC111134271,3175
NC_035784.1,89281341,89313073,89311146,89313073,111134272,XM_022483171.1,uncharacterized LOC111134272,1927
NC_035784.1,89281341,89313073,89281341,89313073,111134272,XM_022483172.1,uncharacterized LOC111134272,31732
NC_035784.1,95316125,95318351,95316125,95318351,111134274,XM_022483174.1,uncharacterized LOC111134274,2226
NC_035784.1,55793245,55799320,55793245,55799320,111134277,XM_022483177.1,uncharacterized LOC111134277,6075
NC_035784.1,68397543,68410773,68397543,68410771,111134279,XM_022483180.1,uncharacterized LOC111134279,13228
NC_035784.1,68397543,68410773,68397543,68410773,111134279,XM_022483181.1,uncharacterized LOC111134279,13230
NC_035784.1,68352039,68365237,68352039,68365237,111134280,XM_022483183.1,uncharacterized LOC111134280,13198
NC_035784.1,68418956,68423682,68418956,68423682,111134282,XM_022483184.1,uncharacterized LOC111134282,4726
NC_035784.1,74682759,74689871,74682759,74689871,111134287,XM_022483187.1,uncharacterized LOC111134287,7112
NC_035784.1,49127231,49157724,49127231,49155294,111134288,XM_022483190.1,uncharacterized LOC111134288,28063
NC_035784.1,49127231,49157724,49127231,49157724,111134288,XM_022483189.1,uncharacterized LOC111134288,30493
NC_035784.1,56837842,56839681,56837842,56839681,111134295,XM_022483196.1,uncharacterized LOC111134295,1839
NC_035784.1,56868718,56869523,56868718,56869523,111134297,XM_022483198.1,uncharacterized LOC111134297,805
NC_035784.1,77612181,77615667,77612181,77615667,111134299,XM_022483199.1,uncharacterized LOC111134299,3486
NC_035784.1,28403587,28405958,28403884,28405958,111134302,XM_022483209.1,uncharacterized LOC111134302,2074
NC_035784.1,28403587,28405958,28403587,28405958,111134302,XM_022483207.1,uncharacterized LOC111134302,2371
NC_035784.1,84193501,84197896,84193501,84197896,111134310,XM_022483221.1,uncharacterized LOC111134310,4395
NC_035784.1,58205356,58233746,58205356,58230978,111134311,XM_022483224.1,uncharacterized LOC111134311,25622
NC_035784.1,58205356,58233746,58205356,58231470,111134311,XM_022483223.1,uncharacterized LOC111134311,26114
NC_035784.1,58205356,58233746,58205356,58232010,111134311,XM_022483226.1,uncharacterized LOC111134311,26654
NC_035784.1,58205356,58233746,58205356,58233746,111134311,XM_022483225.1,uncharacterized LOC111134311,28390
NC_035780.1,28618866,28659036,28642082,28659036,111134313,XM_022483268.1,uncharacterized LOC111134313,16954
NC_035780.1,28618866,28659036,28636775,28659036,111134313,XM_022483241.1,uncharacterized LOC111134313,22261
NC_035780.1,28618866,28659036,28618866,28659036,111134313,XM_022483232.1,uncharacterized LOC111134313,40170
NC_035784.1,1408773,1425492,1408773,1425492,111134316,XM_022483234.1,uncharacterized LOC111134316,16719
NC_035784.1,29474466,29480587,29474466,29480587,111134320,XM_022483243.1,uncharacterized LOC111134320,6121
NC_035784.1,56279662,56282766,56279662,56282766,111134323,XM_022483245.1,uncharacterized LOC111134323,3104
NC_035784.1,33731412,33736047,33731412,33736047,111134330,XM_022483267.1,uncharacterized LOC111134330,4635
NC_035784.1,33752437,33753826,33752437,33753826,111134332,XM_022483271.1,uncharacterized LOC111134332,1389
NC_035784.1,2982744,2987873,2982746,2987721,111134338,XM_022483278.1,uncharacterized LOC111134338,4975
NC_035784.1,2982744,2987873,2982887,2987873,111134338,XM_022483277.1,uncharacterized LOC111134338,4986
NC_035784.1,2982744,2987873,2982744,2987873,111134338,XM_022483276.1,uncharacterized LOC111134338,5129
NC_035784.1,80325504,80328213,80325504,80328213,111134345,XM_022483284.1,uncharacterized LOC111134345,2709
NC_035784.1,59609212,59617842,59609212,59617842,111134346,XM_022483286.1,uncharacterized LOC111134346,8630
NC_035784.1,59602551,59638843,59602563,59638843,111134348,XM_022483291.1,uncharacterized LOC111134348,36280
NC_035784.1,59602551,59638843,59602551,59638842,111134348,XM_022483290.1,uncharacterized LOC111134348,36291
NC_035784.1,92306650,92336684,92306650,92318083,111134349,XM_022483293.1,uncharacterized LOC111134349,11433
NC_035784.1,92306650,92336684,92306650,92336684,111134349,XM_022483292.1,uncharacterized LOC111134349,30034
NC_035780.1,25171831,25174702,25173060,25174701,111134351,XM_022483307.1,uncharacterized LOC111134351,1641
NC_035780.1,25171831,25174702,25171831,25174702,111134351,XM_022483299.1,uncharacterized LOC111134351,2871
NC_035784.1,45443622,45475823,45443622,45475823,111134352,XM_022483298.1,uncharacterized LOC111134352,32201
NC_035784.1,15606715,15637526,15606715,15637526,111134354,XM_022483302.1,uncharacterized LOC111134354,30811
NC_035784.1,15919070,15949942,15919070,15949942,111134355,XM_022483303.1,uncharacterized LOC111134355,30872
NC_035784.1,16159304,16167559,16159482,16167559,111134359,XM_022483312.1,uncharacterized LOC111134359,8077
NC_035784.1,16159304,16167559,16159304,16167559,111134359,XM_022483311.1,uncharacterized LOC111134359,8255
NC_035780.1,49853312,49863664,49853312,49863664,111134363,XM_022483320.1,uncharacterized LOC111134363,10352
NC_035784.1,15706044,15719335,15708906,15719335,111134367,XM_022483326.1,uncharacterized LOC111134367,10429
NC_035784.1,15706044,15719335,15706044,15719221,111134367,XM_022483324.1,uncharacterized LOC111134367,13177
NC_035784.1,15706044,15719335,15706044,15719254,111134367,XM_022483323.1,uncharacterized LOC111134367,13210
NC_035784.1,15706044,15719335,15706044,15719335,111134367,XM_022483325.1,uncharacterized LOC111134367,13291
NC_035784.1,16020259,16030835,16020259,16030835,111134368,XM_022483327.1,uncharacterized LOC111134368,10576
NC_035780.1,44912669,44916538,44912669,44916538,111134370,XM_022483332.1,uncharacterized LOC111134370,3869
NC_035784.1,16094430,16102618,16094430,16102618,111134374,XM_022483336.1,uncharacterized LOC111134374,8188
NC_035784.1,15652104,15687845,15652104,15687845,111134386,XM_022483351.1,uncharacterized LOC111134386,35741
NC_035780.1,44879291,44885153,44879291,44885153,111134396,XM_022483368.1,uncharacterized LOC111134396,5862
NC_035784.1,21076347,21083859,21076347,21083859,111134402,XM_022483371.1,uncharacterized LOC111134402,7512
NC_035784.1,54083952,54090600,54083954,54090599,111134403,XM_022483372.1,uncharacterized LOC111134403,6645
NC_035784.1,54083952,54090600,54083952,54090600,111134403,XM_022483375.1,uncharacterized LOC111134403,6648
NC_035784.1,44619024,44647777,44619024,44641420,111134409,XM_022483385.1,uncharacterized LOC111134409,22396
NC_035784.1,44619024,44647777,44619024,44643263,111134409,XM_022483384.1,uncharacterized LOC111134409,24239
NC_035784.1,44619024,44647777,44619024,44644009,111134409,XM_022483381.1,uncharacterized LOC111134409,24985
NC_035784.1,44619024,44647777,44619024,44646368,111134409,XM_022483386.1,uncharacterized LOC111134409,27344
NC_035784.1,44619024,44647777,44619024,44647777,111134409,XM_022483383.1,uncharacterized LOC111134409,28753
NC_035784.1,44619024,44647777,44619024,44628130,111134409,XM_022483382.1,uncharacterized LOC111134409,9106
NC_035780.1,42944338,42948878,42944338,42948878,111134416,XM_022483398.1,uncharacterized LOC111134416,4540
NC_035784.1,71011412,71020272,71011412,71020272,111134422,XM_022483409.1,uncharacterized LOC111134422,8860
NC_035784.1,54019943,54032110,54019943,54032110,111134427,XM_022483428.1,uncharacterized LOC111134427,12167
NC_035784.1,54013755,54015386,54013756,54015386,111134429,XM_022483429.1,uncharacterized LOC111134429,1630
NC_035784.1,54013755,54015386,54013755,54015386,111134429,XM_022483430.1,uncharacterized LOC111134429,1631
NC_035784.1,13088369,13092994,13088369,13092994,111134432,XM_022483434.1,uncharacterized LOC111134432,4625
NC_035780.1,56175446,56179978,56175446,56179673,111134433,XM_022483439.1,uncharacterized LOC111134433,4227
NC_035780.1,56175446,56179978,56175446,56179978,111134433,XM_022483448.1,uncharacterized LOC111134433,4532
NC_035784.1,29944450,29966501,29944450,29966501,111134441,XM_022483449.1,uncharacterized LOC111134441,22051
NC_035784.1,69720348,69741567,69723083,69741567,111134442,XM_022483450.1,uncharacterized LOC111134442,18484
NC_035784.1,69720348,69741567,69720348,69741567,111134442,XM_022483452.1,uncharacterized LOC111134442,21219
NC_035780.1,56182511,56189083,56182511,56188928,111134445,XM_022483466.1,uncharacterized LOC111134445,6417
NC_035780.1,56182511,56189083,56182511,56188932,111134445,XM_022483458.1,uncharacterized LOC111134445,6421
NC_035780.1,56182511,56189083,56182511,56188933,111134445,XM_022483492.1,uncharacterized LOC111134445,6422
NC_035780.1,56182511,56189083,56182511,56188934,111134445,XM_022483501.1,uncharacterized LOC111134445,6423
NC_035780.1,56182511,56189083,56182511,56188942,111134445,XM_022483482.1,uncharacterized LOC111134445,6431
NC_035780.1,56182511,56189083,56182511,56189083,111134445,XM_022483474.1,uncharacterized LOC111134445,6572
NC_035784.1,41458257,41461975,41458257,41461974,111134453,XM_022483468.1,uncharacterized LOC111134453,3717
NC_035784.1,41458257,41461975,41458257,41461975,111134453,XM_022483467.1,uncharacterized LOC111134453,3718
NC_035784.1,41475045,41482646,41475045,41482646,111134454,XM_022483469.1,uncharacterized LOC111134454,7601
NC_035784.1,41484164,41486559,41484164,41486559,111134456,XM_022483473.1,uncharacterized LOC111134456,2395
NC_035784.1,48883765,48888245,48883765,48888245,111134463,XM_022483484.1,uncharacterized LOC111134463,4480
NC_035784.1,83766769,83783152,83766769,83782868,111134466,XM_022483499.1,uncharacterized LOC111134466,16099
NC_035784.1,83766769,83783152,83766769,83783141,111134466,XM_022483498.1,uncharacterized LOC111134466,16372
NC_035784.1,83766769,83783152,83766769,83783152,111134466,XM_022483497.1,uncharacterized LOC111134466,16383
NC_035784.1,83678335,83722762,83678335,83722762,111134467,XM_022483500.1,uncharacterized LOC111134467,44427
NC_035784.1,83827162,83839122,83827162,83839122,111134469,XM_022483504.1,uncharacterized LOC111134469,11960
NC_035784.1,59064775,59066434,59064775,59066434,111134477,XM_022483525.1,uncharacterized LOC111134477,1659
NC_035784.1,24082906,24087823,24083049,24087823,111134480,XM_022483535.1,uncharacterized LOC111134480,4774
NC_035784.1,24082906,24087823,24082906,24087823,111134480,XM_022483534.1,uncharacterized LOC111134480,4917
NC_035784.1,35794085,35798911,35794085,35798911,111134485,XM_022483543.1,uncharacterized LOC111134485,4826
NC_035784.1,100356,106390,100356,106389,111134487,XM_022483546.1,uncharacterized LOC111134487,6033
NC_035784.1,100356,106390,100356,106390,111134487,XM_022483548.1,uncharacterized LOC111134487,6034
NC_035784.1,117789,123263,117789,123263,111134488,XM_022483550.1,uncharacterized LOC111134488,5474
NC_035784.1,160795,169031,162609,169031,111134489,XM_022483552.1,uncharacterized LOC111134489,6422
NC_035784.1,150851,159289,151211,159289,111134491,XM_022483555.1,uncharacterized LOC111134491,8078
NC_035784.1,150851,159289,150851,159289,111134491,XM_022483557.1,uncharacterized LOC111134491,8438
NC_035784.1,129411,141071,129411,139954,111134493,XM_022483561.1,uncharacterized LOC111134493,10543
NC_035784.1,129411,141071,129413,141071,111134493,XM_022483559.1,uncharacterized LOC111134493,11658
NC_035784.1,145564,148870,145564,147652,111134494,XM_022483562.1,uncharacterized LOC111134494,2088
NC_035784.1,145564,148870,145564,148870,111134494,XM_022483563.1,uncharacterized LOC111134494,3306
NC_035784.1,70965,73442,70998,73442,111134495,XM_022483567.1,uncharacterized LOC111134495,2444
NC_035784.1,70965,73442,70965,73442,111134495,XM_022483566.1,uncharacterized LOC111134495,2477
NC_035784.1,92002,94229,92002,94229,111134496,XM_022483568.1,uncharacterized LOC111134496,2227
NC_035784.1,62422310,62449845,62434478,62449644,111134497,XM_022483576.1,uncharacterized LOC111134497,15166
NC_035784.1,62422310,62449845,62434478,62449822,111134497,XM_022483574.1,uncharacterized LOC111134497,15344
NC_035784.1,62422310,62449845,62422310,62449615,111134497,XM_022483571.1,uncharacterized LOC111134497,27305
NC_035784.1,62422310,62449845,62422310,62449845,111134497,XM_022483570.1,uncharacterized LOC111134497,27535
NC_035784.1,62422310,62449845,62422310,62426740,111134497,XM_022483573.1,uncharacterized LOC111134497,4430
NC_035784.1,62422310,62449845,62434478,62440864,111134497,XM_022483575.1,uncharacterized LOC111134497,6386
NC_035784.1,62422310,62449845,62422310,62431713,111134497,XM_022483572.1,uncharacterized LOC111134497,9403
NC_035784.1,29660590,29676224,29660590,29676224,111134502,XM_022483584.1,uncharacterized LOC111134502,15634
NC_035784.1,50808051,50892199,50808051,50892199,111134504,XM_022483587.1,uncharacterized LOC111134504,84148
NC_035784.1,68022068,68025776,68022068,68025776,111134516,XM_022483619.1,uncharacterized LOC111134516,3708
NC_035784.1,67998831,68001212,67998831,68001212,111134517,XM_022483620.1,uncharacterized LOC111134517,2381
NC_035784.1,68003059,68016078,68003059,68016078,111134519,XM_022483621.1,uncharacterized LOC111134519,13019
NC_035784.1,79176831,79199962,79176831,79191109,111134521,XM_022483630.1,uncharacterized LOC111134521,14278
NC_035784.1,79176831,79199962,79176831,79199633,111134521,XM_022483632.1,uncharacterized LOC111134521,22802
NC_035784.1,79176831,79199962,79176831,79199962,111134521,XM_022483633.1,uncharacterized LOC111134521,23131
NC_035784.1,67130650,67149377,67130864,67149377,111134527,XM_022483645.1,uncharacterized LOC111134527,18513
NC_035784.1,67130650,67149377,67130650,67149377,111134527,XM_022483640.1,uncharacterized LOC111134527,18727
NC_035784.1,66843797,66924244,66846075,66924244,111134534,XM_022483657.1,uncharacterized LOC111134534,78169
NC_035784.1,66843797,66924244,66843797,66924235,111134534,XM_022483656.1,uncharacterized LOC111134534,80438
NC_035784.1,66843797,66924244,66843797,66924236,111134534,XM_022483654.1,uncharacterized LOC111134534,80439
NC_035784.1,66776016,66830702,66776016,66830702,111134538,XM_022483663.1,uncharacterized LOC111134538,54686
NC_035784.1,66733522,66744512,66733522,66744512,111134541,XM_022483666.1,uncharacterized LOC111134541,10990
NC_035784.1,66679225,66692507,66679225,66692507,111134542,XM_022483667.1,uncharacterized LOC111134542,13282
NC_035784.1,12660368,12694936,12678086,12694936,111134564,XM_022483695.1,uncharacterized LOC111134564,16850
NC_035784.1,12660368,12694936,12660368,12694936,111134564,XM_022483694.1,uncharacterized LOC111134564,34568
NC_035780.1,1995230,1997350,1995230,1997344,111134573,XM_022483734.1,uncharacterized LOC111134573,2114
NC_035780.1,1995230,1997350,1995230,1997350,111134573,XM_022483725.1,uncharacterized LOC111134573,2120
NC_035784.1,67996055,67998011,67996055,67998011,111134576,XM_022483726.1,uncharacterized LOC111134576,1956
NC_035784.1,30798491,30812011,30798491,30812011,111134582,XM_022483737.1,uncharacterized LOC111134582,13520
NC_035784.1,85687970,85749861,85687970,85749861,111134583,XM_022483739.1,uncharacterized LOC111134583,61891
NC_035784.1,96359265,96360534,96359265,96360534,111134593,XM_022483755.1,uncharacterized LOC111134593,1269
NC_035784.1,9105092,9106854,9105092,9106854,111134600,XM_022483769.1,uncharacterized LOC111134600,1762
NC_035784.1,49826080,49900032,49826080,49900032,111134602,XM_022483770.1,uncharacterized LOC111134602,73952
NC_035784.1,49826080,49900032,49826085,49835807,111134602,XM_022483771.1,uncharacterized LOC111134602,9722
NC_035784.1,92364019,92377533,92364020,92375833,111134604,XM_022483773.1,uncharacterized LOC111134604,11813
NC_035784.1,92364019,92377533,92364019,92377533,111134604,XM_022483772.1,uncharacterized LOC111134604,13514
NC_035784.1,18701349,18710993,18701349,18710993,111134606,XM_022483777.1,uncharacterized LOC111134606,9644
NC_035784.1,23588172,23594336,23588172,23594336,111134611,XM_022483788.1,uncharacterized LOC111134611,6164
NC_035780.1,49922530,49948141,49922530,49948140,111134614,XM_022483805.1,uncharacterized LOC111134614,25610
NC_035780.1,49922530,49948141,49922530,49948141,111134614,XM_022483796.1,uncharacterized LOC111134614,25611
NC_035784.1,2227062,2236616,2228417,2232130,111134618,XM_022483799.1,uncharacterized LOC111134618,3713
NC_035784.1,2227062,2236616,2228417,2232491,111134618,XM_022483802.1,uncharacterized LOC111134618,4074
NC_035784.1,2227062,2236616,2228417,2232856,111134618,XM_022483801.1,uncharacterized LOC111134618,4439
NC_035784.1,2227062,2236616,2227062,2232113,111134618,XM_022483803.1,uncharacterized LOC111134618,5051
NC_035784.1,2227062,2236616,2228417,2236616,111134618,XM_022483800.1,uncharacterized LOC111134618,8199
NC_035784.1,2214106,2221333,2214106,2221316,111134619,XM_022483807.1,uncharacterized LOC111134619,7210
NC_035784.1,2214106,2221333,2214106,2221323,111134619,XM_022483804.1,uncharacterized LOC111134619,7217
NC_035784.1,2214106,2221333,2214106,2221333,111134619,XM_022483806.1,uncharacterized LOC111134619,7227
NC_035784.1,2239111,2243321,2239111,2242539,111134620,XM_022483809.1,uncharacterized LOC111134620,3428
NC_035784.1,2239111,2243321,2239111,2243126,111134620,XM_022483810.1,uncharacterized LOC111134620,4015
NC_035784.1,2239111,2243321,2239111,2243321,111134620,XM_022483808.1,uncharacterized LOC111134620,4210
NC_035784.1,8268255,8304192,8268255,8304192,111134622,XM_022483813.1,uncharacterized LOC111134622,35937
NC_035784.1,605043,615870,605043,615866,111134623,XM_022483815.1,uncharacterized LOC111134623,10823
NC_035784.1,605043,615870,605043,613724,111134623,XM_022483817.1,uncharacterized LOC111134623,8681
NC_035784.1,605043,615870,606651,615870,111134623,XM_022483818.1,uncharacterized LOC111134623,9219
NC_035784.1,621921,637913,625370,637908,111134624,XM_022483820.1,uncharacterized LOC111134624,12538
NC_035784.1,621921,637913,625370,637913,111134624,XM_022483824.1,uncharacterized LOC111134624,12543
NC_035784.1,621921,637913,621924,637913,111134624,XM_022483821.1,uncharacterized LOC111134624,15989
NC_035784.1,621921,637913,621921,637913,111134624,XM_022483823.1,uncharacterized LOC111134624,15992
NC_035784.1,621921,637913,625370,634954,111134624,XM_022483822.1,uncharacterized LOC111134624,9584
NC_035784.1,29142471,29147659,29142471,29147652,111134643,XM_022483873.1,uncharacterized LOC111134643,5181
NC_035784.1,29142471,29147659,29142471,29147659,111134643,XM_022483871.1,uncharacterized LOC111134643,5188
NC_035784.1,29147742,29149260,29147742,29149099,111134644,XM_022483875.1,uncharacterized LOC111134644,1357
NC_035784.1,29147742,29149260,29147742,29149250,111134644,XM_022483874.1,uncharacterized LOC111134644,1508
NC_035784.1,29147742,29149260,29147742,29149260,111134644,XM_022483876.1,uncharacterized LOC111134644,1518
NC_035784.1,75269145,75335182,75278462,75335182,111134646,XM_022483878.1,uncharacterized LOC111134646,56720
NC_035784.1,75269145,75335182,75269145,75335182,111134646,XM_022483877.1,uncharacterized LOC111134646,66037
NC_035780.1,56204688,56207140,56204688,56207140,111134652,XM_022483932.1,uncharacterized LOC111134652,2452
NC_035784.1,33962430,33963739,33962430,33963739,111134657,XM_022483906.1,uncharacterized LOC111134657,1309
NC_035780.1,12269678,12272222,12269678,12272222,111134671,XM_022483923.1,uncharacterized LOC111134671,2544
NC_035784.1,16507105,16509225,16507105,16509022,111134675,XM_022483929.1,uncharacterized LOC111134675,1917
NC_035784.1,16507105,16509225,16507106,16509225,111134675,XM_022483928.1,uncharacterized LOC111134675,2119
NC_035780.1,12276717,12284282,12276717,12280566,111134677,XM_022483955.1,uncharacterized LOC111134677,3849
NC_035780.1,12276717,12284282,12276717,12284264,111134677,XM_022483946.1,uncharacterized LOC111134677,7547
NC_035780.1,12276717,12284282,12276717,12284282,111134677,XM_022483938.1,uncharacterized LOC111134677,7565
NC_035784.1,31881710,31894889,31881710,31894889,111134683,XM_022483948.1,uncharacterized LOC111134683,13179
NC_035784.1,51668636,51672702,51668636,51672702,111134687,XM_022483963.1,uncharacterized LOC111134687,4066
NC_035780.1,12296004,12301573,12298385,12301573,111134689,XM_022483968.1,uncharacterized LOC111134689,3188
NC_035780.1,12296004,12301573,12296004,12301573,111134689,XM_022483978.1,uncharacterized LOC111134689,5569
NC_035784.1,31973526,31979283,31974008,31979283,111134693,XM_022483971.1,uncharacterized LOC111134693,5275
NC_035784.1,31973526,31979283,31973526,31979283,111134693,XM_022483972.1,uncharacterized LOC111134693,5757
NC_035784.1,31980540,31985776,31980540,31985776,111134695,XM_022483980.1,uncharacterized LOC111134695,5236
NC_035784.1,12145638,12157833,12145639,12157833,111134697,XM_022483986.1,uncharacterized LOC111134697,12194
NC_035784.1,12145638,12157833,12145638,12157833,111134697,XM_022483985.1,uncharacterized LOC111134697,12195
NC_035780.1,12289494,12292916,12289529,12291983,111134698,XM_022484001.1,uncharacterized LOC111134698,2454
NC_035780.1,12289494,12292916,12289494,12291983,111134698,XM_022483991.1,uncharacterized LOC111134698,2489
NC_035780.1,12289494,12292916,12289494,12292916,111134698,XM_022484011.1,uncharacterized LOC111134698,3422
NC_035784.1,492856,506173,492856,506173,111134701,XM_022483993.1,uncharacterized LOC111134701,13317
NC_035784.1,63673342,63679893,63673342,63679893,111134703,XM_022484006.1,uncharacterized LOC111134703,6551
NC_035784.1,63648037,63654853,63648037,63654853,111134705,XM_022484010.1,uncharacterized LOC111134705,6816
NC_035784.1,12601465,12604461,12601483,12604461,111134710,XM_022484019.1,uncharacterized LOC111134710,2978
NC_035784.1,12601465,12604461,12601465,12604459,111134710,XM_022484018.1,uncharacterized LOC111134710,2994
NC_035780.1,43965240,43968421,43965240,43968421,111134714,XM_022484065.1,uncharacterized LOC111134714,3181
NC_035784.1,53301328,53307314,53301328,53307314,111134717,XM_022484029.1,uncharacterized LOC111134717,5986
NC_035784.1,60555384,60572581,60555384,60572581,111134729,XM_022484053.1,uncharacterized LOC111134729,17197
NC_035784.1,60555384,60572581,60555384,60559525,111134729,XM_022484052.1,uncharacterized LOC111134729,4141
NC_035780.1,12240165,12240883,12240165,12240883,111134738,XM_022484078.1,uncharacterized LOC111134738,718
NC_035784.1,8713129,8714233,8713129,8714233,111134746,XM_022484085.1,uncharacterized LOC111134746,1104
NC_035780.1,22684435,22689166,22684435,22689166,111134747,XM_022484089.1,uncharacterized LOC111134747,4731
NC_035784.1,65141206,65155788,65141206,65155787,111134752,XM_022484094.1,uncharacterized LOC111134752,14581
NC_035784.1,65141206,65155788,65141206,65155788,111134752,XM_022484093.1,uncharacterized LOC111134752,14582
NC_035784.1,65072463,65075273,65072463,65075273,111134755,XM_022484097.1,uncharacterized LOC111134755,2810
NC_035784.1,65046994,65048561,65046994,65048561,111134763,XM_022484105.1,uncharacterized LOC111134763,1567
NC_035784.1,95323436,95347804,95323437,95347800,111134781,XM_022484143.1,uncharacterized LOC111134781,24363
NC_035784.1,95323436,95347804,95323436,95347803,111134781,XM_022484141.1,uncharacterized LOC111134781,24367
NC_035784.1,95323436,95347804,95337936,95347804,111134781,XM_022484142.1,uncharacterized LOC111134781,9868
NC_035784.1,95386930,95388846,95386930,95388846,111134782,XM_022484144.1,uncharacterized LOC111134782,1916
NC_035780.1,1940413,1952761,1940413,1952761,111134791,XM_022484176.1,uncharacterized LOC111134791,12348
NC_035784.1,82033148,82118417,82033148,82117988,111134793,XM_022484186.1,uncharacterized LOC111134793,84840
NC_035784.1,82033148,82118417,82033149,82118417,111134793,XM_022484188.1,uncharacterized LOC111134793,85268
NC_035784.1,81648416,81650785,81648416,81650785,111134797,XM_022484194.1,uncharacterized LOC111134797,2369
NC_035784.1,81675199,81677698,81675199,81677678,111134801,XM_022484205.1,uncharacterized LOC111134801,2479
NC_035784.1,81675199,81677698,81675199,81677698,111134801,XM_022484204.1,uncharacterized LOC111134801,2499
NC_035784.1,81689849,81702920,81689849,81702002,111134809,XM_022484225.1,uncharacterized LOC111134809,12153
NC_035784.1,81689849,81702920,81689849,81702920,111134809,XM_022484226.1,uncharacterized LOC111134809,13071
NC_035784.1,82013890,82017006,82013900,82017006,111134813,XM_022484233.1,uncharacterized LOC111134813,3106
NC_035784.1,82013890,82017006,82013890,82017006,111134813,XM_022484234.1,uncharacterized LOC111134813,3116
NC_035784.1,34634186,34658200,34634186,34644302,111134825,XM_022484258.1,uncharacterized LOC111134825,10116
NC_035784.1,34634186,34658200,34634186,34652020,111134825,XM_022484254.1,uncharacterized LOC111134825,17834
NC_035784.1,34634186,34658200,34634186,34653046,111134825,XM_022484255.1,uncharacterized LOC111134825,18860
NC_035784.1,34634186,34658200,34634186,34655419,111134825,XM_022484260.1,uncharacterized LOC111134825,21233
NC_035784.1,34634186,34658200,34634186,34657373,111134825,XM_022484251.1,uncharacterized LOC111134825,23187
NC_035784.1,34634186,34658200,34634186,34657725,111134825,XM_022484250.1,uncharacterized LOC111134825,23539
NC_035784.1,34634186,34658200,34634186,34658200,111134825,XM_022484257.1,uncharacterized LOC111134825,24014
NC_035784.1,34634186,34658200,34634186,34643987,111134825,XM_022484259.1,uncharacterized LOC111134825,9801
NC_035784.1,34664951,34672245,34664952,34672245,111134827,XM_022484262.1,uncharacterized LOC111134827,7293
NC_035784.1,34664951,34672245,34664951,34672245,111134827,XM_022484261.1,uncharacterized LOC111134827,7294
NC_035784.1,40265762,40270632,40265762,40270632,111134851,XM_022484312.1,uncharacterized LOC111134851,4870
NC_035784.1,40262371,40263633,40262371,40263633,111134853,XM_022484314.1,uncharacterized LOC111134853,1262
NC_035784.1,53519769,53541585,53531052,53541584,111134855,XM_022484325.1,uncharacterized LOC111134855,10532
NC_035784.1,53519769,53541585,53528598,53541584,111134855,XM_022484323.1,uncharacterized LOC111134855,12986
NC_035784.1,53519769,53541585,53525800,53541581,111134855,XM_022484322.1,uncharacterized LOC111134855,15781
NC_035784.1,53519769,53541585,53525798,53541582,111134855,XM_022484319.1,uncharacterized LOC111134855,15784
NC_035784.1,53519769,53541585,53525795,53541584,111134855,XM_022484317.1,uncharacterized LOC111134855,15789
NC_035784.1,53519769,53541585,53525793,53541585,111134855,XM_022484316.1,uncharacterized LOC111134855,15792
NC_035784.1,53519769,53541585,53521913,53541584,111134855,XM_022484324.1,uncharacterized LOC111134855,19671
NC_035784.1,53519769,53541585,53520816,53541585,111134855,XM_022484320.1,uncharacterized LOC111134855,20769
NC_035784.1,53519769,53541585,53519769,53541585,111134855,XM_022484318.1,uncharacterized LOC111134855,21816
NC_035780.1,34909530,34924236,34909530,34924235,111134856,XM_022484331.1,uncharacterized LOC111134856,14705
NC_035780.1,34909530,34924236,34909530,34924236,111134856,XM_022484321.1,uncharacterized LOC111134856,14706
NC_035784.1,54981948,54984739,54981948,54984739,111134870,XM_022484356.1,uncharacterized LOC111134870,2791
NC_035784.1,54970646,54973205,54970646,54973205,111134871,XM_022484357.1,uncharacterized LOC111134871,2559
NC_035784.1,29899894,29904193,29899894,29903651,111134874,XM_022484368.1,uncharacterized LOC111134874,3757
NC_035784.1,29899894,29904193,29899894,29904193,111134874,XM_022484367.1,uncharacterized LOC111134874,4299
NC_035784.1,29875397,29889653,29875499,29876815,111134876,XM_022484372.1,uncharacterized LOC111134876,1316
NC_035784.1,29875397,29889653,29875499,29889606,111134876,XM_022484373.1,uncharacterized LOC111134876,14107
NC_035784.1,29875397,29889653,29875397,29889652,111134876,XM_022484375.1,uncharacterized LOC111134876,14255
NC_035784.1,29875397,29889653,29888198,29889653,111134876,XM_022484374.1,uncharacterized LOC111134876,1455
NC_035784.1,29909885,29911275,29909885,29911275,111134877,XM_022484376.1,uncharacterized LOC111134877,1390
NC_035784.1,29894931,29896295,29894931,29896295,111134878,XM_022484377.1,uncharacterized LOC111134878,1364
NC_035784.1,62772906,62778951,62772914,62777971,111134881,XM_022484384.1,uncharacterized LOC111134881,5057
NC_035784.1,62772906,62778951,62772907,62778018,111134881,XM_022484385.1,uncharacterized LOC111134881,5111
NC_035784.1,62772906,62778951,62772906,62778951,111134881,XM_022484386.1,uncharacterized LOC111134881,6045
NC_035784.1,28940123,28940762,28940123,28940762,111134883,XM_022484392.1,uncharacterized LOC111134883,639
NC_035784.1,25933931,25942303,25933931,25942303,111134896,XM_022484429.1,uncharacterized LOC111134896,8372
NC_035784.1,30458461,30469730,30458461,30469730,111134897,XM_022484430.1,uncharacterized LOC111134897,11269
NC_035784.1,30432645,30435312,30432650,30434533,111134901,XM_022484438.1,uncharacterized LOC111134901,1883
NC_035784.1,77258853,77267118,77258853,77267118,111134906,XM_022484444.1,uncharacterized LOC111134906,8265
NC_035784.1,7205951,7220681,7205951,7220681,111134908,XM_022484452.1,uncharacterized LOC111134908,14730
NC_035784.1,7205951,7220681,7205951,7209821,111134908,XM_022484455.1,uncharacterized LOC111134908,3870
NC_035784.1,7205951,7220681,7205951,7210239,111134908,XM_022484454.1,uncharacterized LOC111134908,4288
NC_035784.1,7205951,7220681,7205951,7211130,111134908,XM_022484453.1,uncharacterized LOC111134908,5179
NC_035784.1,7205951,7220681,7205951,7211131,111134908,XM_022484457.1,uncharacterized LOC111134908,5180
NC_035784.1,7205951,7220681,7205951,7211401,111134908,XM_022484456.1,uncharacterized LOC111134908,5450
NC_035784.1,7205951,7220681,7205951,7212941,111134908,XM_022484451.1,uncharacterized LOC111134908,6990
NC_035784.1,7240601,7246413,7240601,7246379,111134909,XM_022484460.1,uncharacterized LOC111134909,5778
NC_035784.1,7240601,7246413,7240601,7246413,111134909,XM_022484459.1,uncharacterized LOC111134909,5812
NC_035784.1,76495419,76506048,76495419,76506048,111134910,XM_022484464.1,uncharacterized LOC111134910,10629
NC_035784.1,76495419,76506048,76496297,76506048,111134910,XM_022484462.1,uncharacterized LOC111134910,9751
NC_035784.1,76441202,76452622,76441202,76452622,111134915,XM_022484471.1,uncharacterized LOC111134915,11420
NC_035784.1,76489455,76495016,76489455,76495016,111134919,XM_022484475.1,uncharacterized LOC111134919,5561
NC_035780.1,37798626,37808290,37798626,37804484,111134920,XM_022484479.1,uncharacterized LOC111134920,5858
NC_035780.1,37798626,37808290,37798627,37808290,111134920,XM_022484487.1,uncharacterized LOC111134920,9663
NC_035784.1,76401057,76419573,76401057,76419573,111134923,XM_022484478.1,uncharacterized LOC111134923,18516
NC_035784.1,35213423,35238143,35214066,35238139,111134927,XM_022484489.1,uncharacterized LOC111134927,24073
NC_035784.1,35213423,35238143,35214066,35238143,111134927,XM_022484486.1,uncharacterized LOC111134927,24077
NC_035784.1,35213423,35238143,35213423,35238139,111134927,XM_022484488.1,uncharacterized LOC111134927,24716
NC_035784.1,92071849,92075136,92072147,92075136,111134931,XM_022484523.1,uncharacterized LOC111134931,2989
NC_035784.1,92071849,92075136,92071849,92075136,111134931,XM_022484524.1,uncharacterized LOC111134931,3287
NC_035780.1,53485419,53492745,53487964,53492745,111134935,XM_022484530.1,uncharacterized LOC111134935,4781
NC_035780.1,53485419,53492745,53487953,53492745,111134935,XM_022484574.1,uncharacterized LOC111134935,4792
NC_035780.1,53485419,53492745,53487951,53492745,111134935,XM_022484538.1,uncharacterized LOC111134935,4794
NC_035780.1,53485419,53492745,53486596,53492745,111134935,XM_022484546.1,uncharacterized LOC111134935,6149
NC_035780.1,53485419,53492745,53486592,53492745,111134935,XM_022484556.1,uncharacterized LOC111134935,6153
NC_035780.1,53485419,53492745,53485419,53492745,111134935,XM_022484565.1,uncharacterized LOC111134935,7326
NC_035784.1,83482113,83488743,83484366,83488743,111134936,XM_022484528.1,uncharacterized LOC111134936,4377
NC_035784.1,83482113,83488743,83482113,83488743,111134936,XM_022484527.1,uncharacterized LOC111134936,6630
NC_035784.1,83488928,83498912,83488928,83498912,111134938,XM_022484532.1,uncharacterized LOC111134938,9984
NC_035784.1,56810344,56812260,56810344,56812260,111134957,XM_022484568.1,uncharacterized LOC111134957,1916
NC_035784.1,56719174,56721026,56719174,56721024,111134958,XM_022484571.1,uncharacterized LOC111134958,1850
NC_035784.1,56719174,56721026,56719174,56721026,111134958,XM_022484572.1,uncharacterized LOC111134958,1852
NC_035784.1,56737858,56741564,56737858,56741564,111134959,XM_022484573.1,uncharacterized LOC111134959,3706
NC_035784.1,21548308,21550670,21548308,21550670,111134960,XM_022484575.1,uncharacterized LOC111134960,2362
NC_035784.1,33165017,33166166,33165017,33166166,111134964,XM_022484580.1,uncharacterized LOC111134964,1149
NC_035780.1,886637,897738,886637,897738,111134965,XM_022484587.1,uncharacterized LOC111134965,11101
NC_035784.1,76614581,76617042,76614581,76617042,111134968,XM_022484593.1,uncharacterized LOC111134968,2461
NC_035784.1,94832014,94833535,94832014,94833535,111134975,XM_022484609.1,uncharacterized LOC111134975,1521
NC_035784.1,94887962,94894515,94887962,94894515,111134978,XM_022484615.1,uncharacterized LOC111134978,6553
NC_035784.1,94898107,94906214,94898107,94902704,111134979,XM_022484617.1,uncharacterized LOC111134979,4597
NC_035784.1,94898107,94906214,94898107,94906214,111134979,XM_022484616.1,uncharacterized LOC111134979,8107
NC_035784.1,94771829,94773561,94771829,94773561,111134981,XM_022484618.1,uncharacterized LOC111134981,1732
NC_035784.1,94734863,94736912,94734863,94736912,111134983,XM_022484620.1,uncharacterized LOC111134983,2049
NC_035784.1,94826844,94837971,94826844,94837971,111134984,XM_022484622.1,uncharacterized LOC111134984,11127
NC_035784.1,94826844,94837971,94828199,94837971,111134984,XM_022484623.1,uncharacterized LOC111134984,9772
NC_035784.1,94740020,94742082,94740020,94742082,111134985,XM_022484624.1,uncharacterized LOC111134985,2062
NC_035784.1,94858988,94873741,94863338,94873741,111134986,XM_022484626.1,uncharacterized LOC111134986,10403
NC_035784.1,94858988,94873741,94858988,94873741,111134986,XM_022484625.1,uncharacterized LOC111134986,14753
NC_035784.1,94858988,94873741,94865014,94873741,111134986,XM_022484627.1,uncharacterized LOC111134986,8727
NC_035784.1,94744768,94746161,94744768,94746161,111134987,XM_022484628.1,uncharacterized LOC111134987,1393
NC_035784.1,94852469,94857463,94852469,94857463,111134988,XM_022484630.1,uncharacterized LOC111134988,4994
NC_035784.1,94846918,94851054,94846918,94851054,111134990,XM_022484631.1,uncharacterized LOC111134990,4136
NC_035784.1,94845420,94848971,94845420,94848971,111134991,XM_022484632.1,uncharacterized LOC111134991,3551
NC_035784.1,3471685,3476365,3471686,3476365,111135004,XM_022484669.1,uncharacterized LOC111135004,4679
NC_035784.1,3471685,3476365,3471685,3476365,111135004,XM_022484670.1,uncharacterized LOC111135004,4680
NC_035784.1,47570622,47667864,47576260,47667864,111135008,XM_022484676.1,uncharacterized LOC111135008,91604
NC_035784.1,47570622,47667864,47570622,47667864,111135008,XM_022484677.1,uncharacterized LOC111135008,97242
NC_035784.1,11993131,12007145,11993131,12007145,111135010,XM_022484683.1,uncharacterized LOC111135010,14014
NC_035784.1,11993131,12007145,12000156,12007145,111135010,XM_022484680.1,uncharacterized LOC111135010,6989
NC_035784.1,12016936,12022332,12016936,12022332,111135011,XM_022484685.1,uncharacterized LOC111135011,5396
NC_035784.1,12010890,12016042,12012489,12016042,111135012,XM_022484687.1,uncharacterized LOC111135012,3553
NC_035784.1,12010890,12016042,12010890,12016042,111135012,XM_022484686.1,uncharacterized LOC111135012,5152
NC_035784.1,11970969,11974821,11970969,11974821,111135013,XM_022484689.1,uncharacterized LOC111135013,3852
NC_035784.1,79958757,79960975,79958757,79960975,111135017,XM_022484693.1,uncharacterized LOC111135017,2218
NC_035784.1,79946304,80004836,80002512,80004825,111135019,XM_022484696.1,uncharacterized LOC111135019,2313
NC_035784.1,79946304,80004836,79946304,80004836,111135019,XM_022484697.1,uncharacterized LOC111135019,58532
NC_035784.1,79930853,79948571,79930854,79948571,111135021,XM_022484702.1,uncharacterized LOC111135021,17717
NC_035784.1,79930853,79948571,79930853,79933216,111135021,XM_022484700.1,uncharacterized LOC111135021,2363
NC_035784.1,79930853,79948571,79930854,79933416,111135021,XM_022484701.1,uncharacterized LOC111135021,2562
NC_035784.1,79920636,79923026,79920636,79923026,111135023,XM_022484707.1,uncharacterized LOC111135023,2390
NC_035784.1,79972040,79973877,79972040,79973877,111135024,XM_022484708.1,uncharacterized LOC111135024,1837
NC_035784.1,79892052,79893885,79892052,79893885,111135025,XM_022484709.1,uncharacterized LOC111135025,1833
NC_035784.1,80048658,80052018,80048658,80052018,111135026,XM_022484710.1,uncharacterized LOC111135026,3360
NC_035784.1,6656899,6666282,6656899,6666282,111135042,XM_022484731.1,uncharacterized LOC111135042,9383
NC_035784.1,6787446,6797640,6787451,6797640,111135043,XM_022484732.1,uncharacterized LOC111135043,10189
NC_035780.1,25888233,25890858,25888233,25890858,111135056,XM_022484762.1,uncharacterized LOC111135056,2625
NC_035784.1,63458401,63461622,63458401,63461622,111135062,XM_022484768.1,uncharacterized LOC111135062,3221
NC_035784.1,63160005,63167526,63160005,63167526,111135063,XM_022484770.1,uncharacterized LOC111135063,7521
NC_035784.1,63151508,63171764,63151508,63171764,111135066,XM_022484774.1,uncharacterized LOC111135066,20256
NC_035784.1,63151508,63171764,63151508,63156424,111135066,XM_022484773.1,uncharacterized LOC111135066,4916
NC_035784.1,51299236,51302382,51299236,51302300,111135076,XM_022484789.1,uncharacterized LOC111135076,3064
NC_035784.1,51299236,51302382,51299236,51302382,111135076,XM_022484788.1,uncharacterized LOC111135076,3146
NC_035784.1,51289327,51292467,51289327,51292467,111135078,XM_022484790.1,uncharacterized LOC111135078,3140
NC_035784.1,51147283,51197079,51147283,51159222,111135083,XM_022484806.1,uncharacterized LOC111135083,11939
NC_035784.1,51147283,51197079,51147283,51159242,111135083,XM_022484796.1,uncharacterized LOC111135083,11959
NC_035784.1,51147283,51197079,51147283,51159749,111135083,XM_022484799.1,uncharacterized LOC111135083,12466
NC_035784.1,51147283,51197079,51147283,51163585,111135083,XM_022484804.1,uncharacterized LOC111135083,16302
NC_035784.1,51147283,51197079,51147283,51168667,111135083,XM_022484805.1,uncharacterized LOC111135083,21384
NC_035784.1,51147283,51197079,51147283,51179820,111135083,XM_022484803.1,uncharacterized LOC111135083,32537
NC_035784.1,51147283,51197079,51147283,51185778,111135083,XM_022484801.1,uncharacterized LOC111135083,38495
NC_035784.1,51147283,51197079,51147283,51197079,111135083,XM_022484798.1,uncharacterized LOC111135083,49796
NC_035784.1,51147283,51197079,51147283,51156339,111135083,XM_022484797.1,uncharacterized LOC111135083,9056
NC_035784.1,51147283,51197079,51147283,51156613,111135083,XM_022484800.1,uncharacterized LOC111135083,9330
NC_035784.1,51594693,51596597,51594693,51596597,111135086,XM_022484817.1,uncharacterized LOC111135086,1904
NC_035784.1,51582492,51593969,51582492,51593110,111135096,XM_022484833.1,uncharacterized LOC111135096,10618
NC_035784.1,51582492,51593969,51582492,51593969,111135096,XM_022484834.1,uncharacterized LOC111135096,11477
NC_035784.1,51555999,51558592,51555999,51557861,111135098,XM_022484835.1,uncharacterized LOC111135098,1862
NC_035784.1,51555999,51558592,51555999,51558349,111135098,XM_022484837.1,uncharacterized LOC111135098,2350
NC_035784.1,51555999,51558592,51555999,51558592,111135098,XM_022484836.1,uncharacterized LOC111135098,2593
NC_035784.1,20820178,20841942,20820178,20841942,111135110,XM_022484849.1,uncharacterized LOC111135110,21764
NC_035784.1,30974197,31022269,30974197,31006870,111135118,XM_022484868.1,uncharacterized LOC111135118,32673
NC_035784.1,30974197,31022269,30974202,31022269,111135118,XM_022484869.1,uncharacterized LOC111135118,48067
NC_035784.1,64532737,64554128,64537244,64554128,111135120,XM_022484872.1,uncharacterized LOC111135120,16884
NC_035784.1,64532737,64554128,64532737,64554127,111135120,XM_022484873.1,uncharacterized LOC111135120,21390
NC_035784.1,64532737,64554128,64532737,64554128,111135120,XM_022484871.1,uncharacterized LOC111135120,21391
NC_035784.1,11821133,11828229,11821156,11828229,111135122,XM_022484874.1,uncharacterized LOC111135122,7073
NC_035784.1,43487061,43492059,43487061,43492059,111135124,XM_022484878.1,uncharacterized LOC111135124,4998
NC_035780.1,37627451,37638674,37627457,37638674,111135128,XM_022484929.1,uncharacterized LOC111135128,11217
NC_035780.1,37627451,37638674,37627451,37638674,111135128,XM_022485020.1,uncharacterized LOC111135128,11223
NC_035784.1,54305195,54307902,54305195,54307902,111135131,XM_022484889.1,uncharacterized LOC111135131,2707
NC_035784.1,96849185,96901041,96849185,96901041,111135134,XM_022484893.1,uncharacterized LOC111135134,51856
NC_035784.1,54178963,54205601,54194057,54205601,111135135,XM_022484906.1,uncharacterized LOC111135135,11544
NC_035784.1,54178963,54205601,54192898,54205601,111135135,XM_022484905.1,uncharacterized LOC111135135,12703
NC_035784.1,54178963,54205601,54185925,54205601,111135135,XM_022484897.1,uncharacterized LOC111135135,19676
NC_035784.1,54178963,54205601,54185717,54205601,111135135,XM_022484894.1,uncharacterized LOC111135135,19884
NC_035784.1,54178963,54205601,54185716,54205601,111135135,XM_022484895.1,uncharacterized LOC111135135,19885
NC_035784.1,54178963,54205601,54184407,54205601,111135135,XM_022484898.1,uncharacterized LOC111135135,21194
NC_035784.1,54178963,54205601,54179907,54205601,111135135,XM_022484900.1,uncharacterized LOC111135135,25694
NC_035784.1,54178963,54205601,54179647,54205601,111135135,XM_022484896.1,uncharacterized LOC111135135,25954
NC_035784.1,54178963,54205601,54179290,54205601,111135135,XM_022484901.1,uncharacterized LOC111135135,26311
NC_035784.1,54178963,54205601,54178965,54205601,111135135,XM_022484903.1,uncharacterized LOC111135135,26636
NC_035784.1,54178963,54205601,54178963,54205601,111135135,XM_022484902.1,uncharacterized LOC111135135,26638
NC_035784.1,74455122,74473420,74455122,74473420,111135145,XM_022484919.1,uncharacterized LOC111135145,18298
NC_035784.1,74455122,74473420,74464949,74473420,111135145,XM_022484920.1,uncharacterized LOC111135145,8471
NC_035784.1,74405911,74466083,74405911,74466083,111135146,XM_022484921.1,uncharacterized LOC111135146,60172
NC_035784.1,3836880,3839121,3836880,3838931,111135158,XM_022484953.1,uncharacterized LOC111135158,2051
NC_035784.1,3836880,3839121,3836881,3839121,111135158,XM_022484952.1,uncharacterized LOC111135158,2240
NC_035784.1,3834750,3836453,3834750,3836453,111135161,XM_022484957.1,uncharacterized LOC111135161,1703
NC_035784.1,15252018,15257039,15252018,15257039,111135164,XM_022484962.1,uncharacterized LOC111135164,5021
NC_035784.1,37848339,37853937,37848339,37853937,111135170,XM_022484968.1,uncharacterized LOC111135170,5598
NC_035780.1,527850,534541,527850,534541,111135178,XM_022485012.1,uncharacterized LOC111135178,6691
NC_035784.1,37586172,37588909,37586224,37588909,111135179,XM_022485009.1,uncharacterized LOC111135179,2685
NC_035784.1,37586172,37588909,37586172,37588909,111135179,XM_022485010.1,uncharacterized LOC111135179,2737
NC_035784.1,37646052,37668974,37646052,37668974,111135180,XM_022485011.1,uncharacterized LOC111135180,22922
NC_035784.1,18898524,18904302,18898524,18904302,111135183,XM_022485017.1,uncharacterized LOC111135183,5778
NC_035784.1,70529532,70560550,70533011,70560550,111135189,XM_022485024.1,uncharacterized LOC111135189,27539
NC_035784.1,70529532,70560550,70529532,70560550,111135189,XM_022485022.1,uncharacterized LOC111135189,31018
NC_035784.1,88271871,88277294,88271871,88277294,111135191,XM_022485027.1,uncharacterized LOC111135191,5423
NC_035784.1,27212578,27218012,27212578,27218012,111135194,XM_022485030.1,uncharacterized LOC111135194,5434
NC_035784.1,36367770,36386158,36367770,36386158,111135196,XM_022485036.1,uncharacterized LOC111135196,18388
NC_035784.1,36367770,36386158,36367770,36373159,111135196,XM_022485035.1,uncharacterized LOC111135196,5389
NC_035784.1,90394004,90425691,90394004,90425691,111135206,XM_022485053.1,uncharacterized LOC111135206,31687
NC_035784.1,72843539,72848389,72843539,72848389,111135223,XM_022485088.1,uncharacterized LOC111135223,4850
NC_035780.1,30500035,30509504,30500035,30509216,111135226,XM_022485112.1,uncharacterized LOC111135226,9181
NC_035780.1,30500035,30509504,30500035,30509479,111135226,XM_022485131.1,uncharacterized LOC111135226,9444
NC_035780.1,30500035,30509504,30500035,30509493,111135226,XM_022485122.1,uncharacterized LOC111135226,9458
NC_035780.1,30500035,30509504,30500035,30509495,111135226,XM_022485104.1,uncharacterized LOC111135226,9460
NC_035780.1,30500035,30509504,30500035,30509504,111135226,XM_022485095.1,uncharacterized LOC111135226,9469
NC_035784.1,70928916,70930858,70928916,70930858,111135234,XM_022485103.1,uncharacterized LOC111135234,1942
NC_035784.1,70928916,70930858,70928916,70929796,111135234,XM_022485105.1,uncharacterized LOC111135234,880
NC_035780.1,37646635,37649048,37646635,37649048,111135235,XM_022485150.1,uncharacterized LOC111135235,2413
NC_035784.1,43260246,43273841,43260246,43273841,111135240,XM_022485118.1,uncharacterized LOC111135240,13595
NC_035784.1,430215,443487,430217,443487,111135248,XM_022485141.1,uncharacterized LOC111135248,13270
NC_035784.1,430215,443487,430215,443487,111135248,XM_022485140.1,uncharacterized LOC111135248,13272
NC_035784.1,455599,461625,455599,461625,111135250,XM_022485142.1,uncharacterized LOC111135250,6026
NC_035784.1,447992,454030,447992,454030,111135251,XM_022485143.1,uncharacterized LOC111135251,6038
NC_035784.1,58830605,58838480,58830850,58838480,111135255,XM_022485164.1,uncharacterized LOC111135255,7630
NC_035784.1,58830605,58838480,58830818,58838480,111135255,XM_022485163.1,uncharacterized LOC111135255,7662
NC_035784.1,58830605,58838480,58830605,58838480,111135255,XM_022485162.1,uncharacterized LOC111135255,7875
NC_035784.1,54596338,54599925,54596929,54599925,111135259,XM_022485175.1,uncharacterized LOC111135259,2996
NC_035784.1,54596338,54599925,54596434,54599925,111135259,XM_022485171.1,uncharacterized LOC111135259,3491
NC_035784.1,54596338,54599925,54596338,54599925,111135259,XM_022485170.1,uncharacterized LOC111135259,3587
NC_035784.1,54556517,54564292,54558220,54564292,111135261,XM_022485177.1,uncharacterized LOC111135261,6072
NC_035784.1,54556517,54564292,54556517,54564292,111135261,XM_022485176.1,uncharacterized LOC111135261,7775
NC_035784.1,54614280,54616810,54614280,54616810,111135262,XM_022485178.1,uncharacterized LOC111135262,2530
NC_035784.1,54578521,54580706,54578521,54580706,111135263,XM_022485180.1,uncharacterized LOC111135263,2185
NC_035784.1,54569115,54571692,54569115,54571692,111135264,XM_022485181.1,uncharacterized LOC111135264,2577
NC_035784.1,54547608,54553079,54547608,54553079,111135265,XM_022485182.1,uncharacterized LOC111135265,5471
NC_035784.1,54528246,54535168,54528246,54531311,111135266,XM_022485184.1,uncharacterized LOC111135266,3065
NC_035784.1,54528246,54535168,54528246,54533027,111135266,XM_022485185.1,uncharacterized LOC111135266,4781
NC_035784.1,54528246,54535168,54528246,54535168,111135266,XM_022485183.1,uncharacterized LOC111135266,6922
NC_035784.1,54443046,54514517,54512267,54514517,111135267,XM_022485186.1,uncharacterized LOC111135267,2250
NC_035784.1,54443046,54514517,54443046,54514498,111135267,XM_022485187.1,uncharacterized LOC111135267,71452
NC_035784.1,54406465,54433148,54406465,54433148,111135268,XM_022485190.1,uncharacterized LOC111135268,26683
NC_035784.1,54464805,54485044,54464805,54485044,111135269,XM_022485191.1,uncharacterized LOC111135269,20239
NC_035780.1,32106528,32118722,32106528,32118722,111135270,XM_022485195.1,uncharacterized LOC111135270,12194
NC_035784.1,54536985,54541661,54536985,54541661,111135271,XM_022485192.1,uncharacterized LOC111135271,4676
NC_035784.1,54521087,54525400,54521087,54525400,111135272,XM_022485193.1,uncharacterized LOC111135272,4313
NC_035784.1,54515784,54519683,54515784,54519683,111135273,XM_022485194.1,uncharacterized LOC111135273,3899
NC_035784.1,25407986,25417251,25407986,25417251,111135280,XM_022485210.1,uncharacterized LOC111135280,9265
NC_035784.1,96997916,97001721,96997916,97000660,111135291,XM_022485224.1,uncharacterized LOC111135291,2744
NC_035784.1,96997916,97001721,96997916,97001721,111135291,XM_022485225.1,uncharacterized LOC111135291,3805
NC_035784.1,97025589,97057463,97025589,97057463,111135292,XM_022485226.1,uncharacterized LOC111135292,31874
NC_035784.1,96986546,97013675,96986546,97013675,111135293,XM_022485229.1,uncharacterized LOC111135293,27129
NC_035784.1,97047854,97050698,97047854,97050698,111135294,XM_022485230.1,uncharacterized LOC111135294,2844
NC_035784.1,70333176,70335988,70333176,70335988,111135295,XM_022485231.1,uncharacterized LOC111135295,2812
NC_035784.1,96388250,96406056,96388250,96402621,111135299,XM_022485240.1,uncharacterized LOC111135299,14371
NC_035784.1,96388250,96406056,96388250,96406056,111135299,XM_022485238.1,uncharacterized LOC111135299,17806
NC_035780.1,60256446,60260254,60256446,60260254,111135300,XM_022485278.1,uncharacterized LOC111135300,3808
NC_035784.1,96507603,96516975,96507603,96516974,111135301,XM_022485241.1,uncharacterized LOC111135301,9371
NC_035784.1,96422637,96434546,96422637,96434546,111135302,XM_022485243.1,uncharacterized LOC111135302,11909
NC_035784.1,96446266,96458312,96446266,96458312,111135303,XM_022485245.1,uncharacterized LOC111135303,12046
NC_035784.1,96474339,96492015,96474339,96488594,111135305,XM_022485247.1,uncharacterized LOC111135305,14255
NC_035784.1,96474339,96492015,96474339,96492015,111135305,XM_022485246.1,uncharacterized LOC111135305,17676
NC_035784.1,38106894,38108279,38106894,38108279,111135309,XM_022485255.1,uncharacterized LOC111135309,1385
NC_035784.1,24999050,25006800,24999064,25006800,111135314,XM_022485263.1,uncharacterized LOC111135314,7736
NC_035784.1,24999050,25006800,24999050,25006800,111135314,XM_022485262.1,uncharacterized LOC111135314,7750
NC_035784.1,5844982,5852680,5845078,5852680,111135322,XM_022485274.1,uncharacterized LOC111135322,7602
NC_035784.1,5844982,5852680,5844982,5852680,111135322,XM_022485275.1,uncharacterized LOC111135322,7698
NC_035784.1,76885612,76911918,76885612,76911918,111135323,XM_022485281.1,uncharacterized LOC111135323,26306
NC_035784.1,90431725,90460718,90431725,90460718,111135324,XM_022485282.1,uncharacterized LOC111135324,28993
NC_035784.1,54345742,54362366,54345742,54359714,111135328,XM_022485288.1,uncharacterized LOC111135328,13972
NC_035784.1,54345742,54362366,54345742,54362311,111135328,XM_022485287.1,uncharacterized LOC111135328,16569
NC_035784.1,54345742,54362366,54345742,54362366,111135328,XM_022485286.1,uncharacterized LOC111135328,16624
NC_035784.1,54337368,54345330,54338067,54345330,111135330,XM_022485293.1,uncharacterized LOC111135330,7263
NC_035784.1,54337368,54345330,54337368,54345330,111135330,XM_022485292.1,uncharacterized LOC111135330,7962
NC_035784.1,74150792,74158251,74150792,74158251,111135332,XM_022485296.1,uncharacterized LOC111135332,7459
NC_035784.1,24122863,24141583,24122863,24141583,111135337,XM_022485301.1,uncharacterized LOC111135337,18720
NC_035784.1,53463099,53465439,53463099,53465439,111135341,XM_022485308.1,uncharacterized LOC111135341,2340
NC_035784.1,66579175,66585497,66579394,66585497,111135344,XM_022485312.1,uncharacterized LOC111135344,6103
NC_035784.1,66579175,66585497,66579175,66585497,111135344,XM_022485311.1,uncharacterized LOC111135344,6322
NC_035784.1,66589728,66591009,66589728,66591009,111135349,XM_022485320.1,uncharacterized LOC111135349,1281
NC_035780.1,63528359,63547584,63535213,63547584,111135351,XM_022485329.1,uncharacterized LOC111135351,12371
NC_035780.1,63528359,63547584,63535109,63547584,111135351,XM_022485338.1,uncharacterized LOC111135351,12475
NC_035780.1,63528359,63547584,63528359,63547584,111135351,XM_022485347.1,uncharacterized LOC111135351,19225
NC_035784.1,4280223,4305211,4282186,4305211,111135366,XM_022485365.1,uncharacterized LOC111135366,23025
NC_035784.1,4280223,4305211,4282185,4305211,111135366,XM_022485362.1,uncharacterized LOC111135366,23026
NC_035784.1,4280223,4305211,4282184,4305211,111135366,XM_022485363.1,uncharacterized LOC111135366,23027
NC_035784.1,4280223,4305211,4282182,4305211,111135366,XM_022485368.1,uncharacterized LOC111135366,23029
NC_035784.1,4280223,4305211,4282181,4305211,111135366,XM_022485367.1,uncharacterized LOC111135366,23030
NC_035784.1,4280223,4305211,4280223,4305211,111135366,XM_022485364.1,uncharacterized LOC111135366,24988
NC_035784.1,4231233,4254264,4231233,4254264,111135368,XM_022485369.1,uncharacterized LOC111135368,23031
NC_035784.1,50566899,50576331,50566899,50576274,111135373,XM_022485381.1,uncharacterized LOC111135373,9375
NC_035784.1,50566899,50576331,50566899,50576331,111135373,XM_022485380.1,uncharacterized LOC111135373,9432
NC_035784.1,19282868,19300650,19282869,19298704,111135376,XM_022485384.1,uncharacterized LOC111135376,15835
NC_035784.1,19282868,19300650,19282870,19300650,111135376,XM_022485385.1,uncharacterized LOC111135376,17780
NC_035784.1,19282868,19300650,19282870,19287691,111135376,XM_022485386.1,uncharacterized LOC111135376,4821
NC_035784.1,19282868,19300650,19282868,19291614,111135376,XM_022485383.1,uncharacterized LOC111135376,8746
NC_035784.1,1650177,1664474,1650177,1662856,111135382,XM_022485397.1,uncharacterized LOC111135382,12679
NC_035784.1,1650177,1664474,1650177,1664474,111135382,XM_022485396.1,uncharacterized LOC111135382,14297
NC_035784.1,57361074,57372415,57361074,57372415,111135390,XM_022485409.1,uncharacterized LOC111135390,11341
NC_035784.1,46876278,46941464,46876278,46886596,111135394,XM_022485420.1,uncharacterized LOC111135394,10318
NC_035784.1,46876278,46941464,46930968,46941464,111135394,XM_022485415.1,uncharacterized LOC111135394,10496
NC_035784.1,46876278,46941464,46930672,46941464,111135394,XM_022485417.1,uncharacterized LOC111135394,10792
NC_035784.1,46876278,46941464,46876278,46887468,111135394,XM_022485421.1,uncharacterized LOC111135394,11190
NC_035784.1,28528529,28533688,28528529,28533688,111135396,XM_022485422.1,uncharacterized LOC111135396,5159
NC_035784.1,30552193,30557202,30552193,30556987,111135398,XM_022485427.1,uncharacterized LOC111135398,4794
NC_035784.1,30552193,30557202,30552193,30557202,111135398,XM_022485426.1,uncharacterized LOC111135398,5009
NC_035784.1,7581781,7597366,7581781,7591891,111135404,XM_022485437.1,uncharacterized LOC111135404,10110
NC_035784.1,7581781,7597366,7581781,7597365,111135404,XM_022485440.1,uncharacterized LOC111135404,15584
NC_035784.1,7581781,7597366,7581781,7597366,111135404,XM_022485439.1,uncharacterized LOC111135404,15585
NC_035784.1,7581781,7597366,7581781,7590800,111135404,XM_022485438.1,uncharacterized LOC111135404,9019
NC_035784.1,58698854,58724011,58698854,58723810,111135416,XM_022485460.1,uncharacterized LOC111135416,24956
NC_035784.1,58698854,58724011,58698854,58724011,111135416,XM_022485459.1,uncharacterized LOC111135416,25157
NC_035784.1,32952056,32976871,32953853,32976076,111135418,XM_022485467.1,uncharacterized LOC111135418,22223
NC_035784.1,32952056,32976871,32953853,32976871,111135418,XM_022485462.1,uncharacterized LOC111135418,23018
NC_035784.1,32952056,32976871,32952056,32976871,111135418,XM_022485465.1,uncharacterized LOC111135418,24815
NC_035784.1,32952056,32976871,32967658,32976871,111135418,XM_022485464.1,uncharacterized LOC111135418,9213
NC_035784.1,32952056,32976871,32967278,32976871,111135418,XM_022485466.1,uncharacterized LOC111135418,9593
NC_035784.1,27320807,27323235,27320807,27323235,111135422,XM_022485474.1,uncharacterized LOC111135422,2428
NC_035784.1,27332149,27337325,27332149,27334287,111135423,XM_022485478.1,uncharacterized LOC111135423,2138
NC_035784.1,27332149,27337325,27332149,27335041,111135423,XM_022485476.1,uncharacterized LOC111135423,2892
NC_035784.1,27332149,27337325,27332149,27335112,111135423,XM_022485479.1,uncharacterized LOC111135423,2963
NC_035784.1,27332149,27337325,27332149,27337244,111135423,XM_022485477.1,uncharacterized LOC111135423,5095
NC_035784.1,27332149,27337325,27332149,27337325,111135423,XM_022485475.1,uncharacterized LOC111135423,5176
NC_035784.1,70692327,70698406,70692327,70695445,111135426,XM_022485484.1,uncharacterized LOC111135426,3118
NC_035784.1,70692327,70698406,70692327,70695596,111135426,XM_022485482.1,uncharacterized LOC111135426,3269
NC_035784.1,70692327,70698406,70692327,70698406,111135426,XM_022485483.1,uncharacterized LOC111135426,6079
NC_035784.1,70696865,70698333,70696865,70698333,111135427,XM_022485485.1,uncharacterized LOC111135427,1468
NC_035780.1,33850397,33852798,33850397,33852798,111135430,XM_022485494.1,uncharacterized LOC111135430,2401
NC_035784.1,51092401,51109071,51092402,51109071,111135431,XM_022485491.1,uncharacterized LOC111135431,16669
NC_035784.1,51092401,51109071,51092401,51109071,111135431,XM_022485490.1,uncharacterized LOC111135431,16670
NC_035784.1,66236722,66252972,66236722,66252970,111135446,XM_022485534.1,uncharacterized LOC111135446,16248
NC_035784.1,66236722,66252972,66236722,66252972,111135446,XM_022485535.1,uncharacterized LOC111135446,16250
NC_035780.1,63885753,63887465,63885753,63887465,111135447,XM_022485539.1,uncharacterized LOC111135447,1712
NC_035784.1,66106654,66153362,66106654,66153362,111135448,XM_022485536.1,uncharacterized LOC111135448,46708
NC_035784.1,66175957,66223871,66175957,66223871,111135449,XM_022485537.1,uncharacterized LOC111135449,47914
NC_035784.1,66203139,66207641,66203139,66207641,111135450,XM_022485538.1,uncharacterized LOC111135450,4502
NC_035784.1,86371597,86439541,86371597,86439541,111135472,XM_022485577.1,uncharacterized LOC111135472,67944
NC_035784.1,75186156,75195274,75186156,75195274,111135473,XM_022485578.1,uncharacterized LOC111135473,9118
NC_035784.1,2504428,2517674,2504428,2517674,111135479,XM_022485592.1,uncharacterized LOC111135479,13246
NC_035784.1,84820778,84868970,84820778,84868508,111135481,XM_022485593.1,uncharacterized LOC111135481,47730
NC_035784.1,84820778,84868970,84820778,84868970,111135481,XM_022485594.1,uncharacterized LOC111135481,48192
NC_035784.1,84900268,84909862,84903774,84909862,111135482,XM_022485595.1,uncharacterized LOC111135482,6088
NC_035784.1,36823209,36834493,36823209,36834493,111135484,XM_022485597.1,uncharacterized LOC111135484,11284
NC_035784.1,11912561,11915901,11912561,11915567,111135486,XM_022485601.1,uncharacterized LOC111135486,3006
NC_035784.1,11912561,11915901,11912561,11915901,111135486,XM_022485600.1,uncharacterized LOC111135486,3340
NC_035784.1,11915924,11918405,11915930,11918405,111135488,XM_022485603.1,uncharacterized LOC111135488,2475
NC_035784.1,11915924,11918405,11915928,11918405,111135488,XM_022485604.1,uncharacterized LOC111135488,2477
NC_035784.1,11915924,11918405,11915924,11918405,111135488,XM_022485606.1,uncharacterized LOC111135488,2481
NC_035784.1,91321222,91326748,91321222,91326748,111135496,XM_022485617.1,uncharacterized LOC111135496,5526
NC_035780.1,59000611,59009576,59000611,59009576,111135498,XM_022485666.1,uncharacterized LOC111135498,8965
NC_035784.1,91801578,91831310,91801578,91803812,111135500,XM_022485626.1,uncharacterized LOC111135500,2234
NC_035784.1,91801578,91831310,91828585,91831309,111135500,XM_022485628.1,uncharacterized LOC111135500,2724
NC_035784.1,91801578,91831310,91801658,91831310,111135500,XM_022485629.1,uncharacterized LOC111135500,29652
NC_035784.1,91734968,91761585,91735019,91747352,111135501,XM_022485631.1,uncharacterized LOC111135501,12333
NC_035784.1,91734968,91761585,91734992,91747352,111135501,XM_022485630.1,uncharacterized LOC111135501,12360
NC_035784.1,91734968,91761585,91734968,91761585,111135501,XM_022485633.1,uncharacterized LOC111135501,26617
NC_035784.1,91734968,91761585,91752975,91761585,111135501,XM_022485632.1,uncharacterized LOC111135501,8610
NC_035784.1,91629398,91632090,91629398,91632090,111135508,XM_022485642.1,uncharacterized LOC111135508,2692
NC_035784.1,91671744,91718168,91714316,91718168,111135510,XM_022485645.1,uncharacterized LOC111135510,3852
NC_035784.1,91671744,91718168,91671775,91718168,111135510,XM_022485646.1,uncharacterized LOC111135510,46393
NC_035784.1,91671744,91718168,91671744,91678740,111135510,XM_022485644.1,uncharacterized LOC111135510,6996
NC_035784.1,91682719,91703168,91682719,91703168,111135511,XM_022485648.1,uncharacterized LOC111135511,20449
NC_035784.1,91682719,91703168,91700540,91703168,111135511,XM_022485647.1,uncharacterized LOC111135511,2628
NC_035784.1,91682719,91703168,91700230,91703168,111135511,XM_022485650.1,uncharacterized LOC111135511,2938
NC_035784.1,91727210,91729769,91727210,91729769,111135512,XM_022485651.1,uncharacterized LOC111135512,2559
NC_035784.1,91264462,91266580,91264462,91266580,111135513,XM_022485652.1,uncharacterized LOC111135513,2118
NC_035784.1,91870546,91875126,91870546,91875126,111135517,XM_022485658.1,uncharacterized LOC111135517,4580
NC_035784.1,91386554,91413976,91389363,91401450,111135518,XM_022485661.1,uncharacterized LOC111135518,12087
NC_035784.1,91386554,91413976,91386554,91401450,111135518,XM_022485662.1,uncharacterized LOC111135518,14896
NC_035784.1,91386554,91413976,91390375,91413976,111135518,XM_022485663.1,uncharacterized LOC111135518,23601
NC_035784.1,91386554,91413976,91406610,91413972,111135518,XM_022485660.1,uncharacterized LOC111135518,7362
NC_035784.1,91386554,91413976,91406492,91413971,111135518,XM_022485659.1,uncharacterized LOC111135518,7479
NC_035784.1,91458643,91470222,91458643,91470222,111135520,XM_022485665.1,uncharacterized LOC111135520,11579
NC_035784.1,91420996,91431307,91420996,91431307,111135521,XM_022485668.1,uncharacterized LOC111135521,10311
NC_035784.1,91511384,91514204,91511384,91514204,111135525,XM_022485673.1,uncharacterized LOC111135525,2820
NC_035784.1,91516076,91518843,91516076,91518843,111135527,XM_022485677.1,uncharacterized LOC111135527,2767
NC_035784.1,91268570,91272413,91268570,91272413,111135528,XM_022485678.1,uncharacterized LOC111135528,3843
NC_035784.1,28103137,28105577,28103137,28105577,111135539,XM_022485684.1,uncharacterized LOC111135539,2440
NC_035784.1,14932814,14941562,14933009,14941562,111135559,XM_022485720.1,uncharacterized LOC111135559,8553
NC_035784.1,33005125,33011627,33005125,33011627,111135562,XM_022485723.1,uncharacterized LOC111135562,6502
NC_035784.1,88688788,88693338,88688792,88693332,111135566,XM_022485741.1,uncharacterized LOC111135566,4540
NC_035784.1,88688788,88693338,88688791,88693334,111135566,XM_022485738.1,uncharacterized LOC111135566,4543
NC_035784.1,88688788,88693338,88688788,88693338,111135566,XM_022485739.1,uncharacterized LOC111135566,4550
NC_035784.1,88675386,88687798,88680542,88687798,111135568,XM_022485742.1,uncharacterized LOC111135568,7256
NC_035784.1,88675386,88687798,88675386,88684390,111135568,XM_022485743.1,uncharacterized LOC111135568,9004
NC_035784.1,77951156,77958575,77951156,77958575,111135573,XM_022485762.1,uncharacterized LOC111135573,7419
NC_035784.1,10436855,10455170,10436855,10455163,111135576,XM_022485764.1,uncharacterized LOC111135576,18308
NC_035784.1,10436855,10455170,10436855,10455170,111135576,XM_022485765.1,uncharacterized LOC111135576,18315
NC_035784.1,10423531,10435357,10423531,10435357,111135577,XM_022485769.1,uncharacterized LOC111135577,11826
NC_035784.1,10423531,10435357,10423531,10425548,111135577,XM_022485768.1,uncharacterized LOC111135577,2017
NC_035784.1,10423531,10435357,10429841,10435357,111135577,XM_022485766.1,uncharacterized LOC111135577,5516
NC_035784.1,57711002,57716531,57711002,57716531,111135579,XM_022485775.1,uncharacterized LOC111135579,5529
NC_035784.1,69408598,69430588,69408598,69430587,111135590,XM_022485799.1,uncharacterized LOC111135590,21989
NC_035784.1,69408598,69430588,69408598,69430588,111135590,XM_022485798.1,uncharacterized LOC111135590,21990
NC_035784.1,69300026,69312916,69300026,69312916,111135592,XM_022485804.1,uncharacterized LOC111135592,12890
NC_035784.1,69522168,69538873,69535094,69538873,111135599,XM_022485820.1,uncharacterized LOC111135599,3779
NC_035784.1,69530324,69532445,69530324,69532445,111135604,XM_022485829.1,uncharacterized LOC111135604,2121
NC_035780.1,58094031,58102490,58094031,58102490,111135605,XM_022485833.1,uncharacterized LOC111135605,8459
NC_035784.1,69506884,69512821,69506884,69512821,111135608,XM_022485834.1,uncharacterized LOC111135608,5937
NC_035784.1,69440079,69463204,69440079,69463204,111135611,XM_022485837.1,uncharacterized LOC111135611,23125
NC_035784.1,2533362,2561243,2533362,2561243,111135614,XM_022485839.1,uncharacterized LOC111135614,27881
NC_035784.1,33598672,33607431,33598672,33605298,111135617,XM_022485843.1,uncharacterized LOC111135617,6626
NC_035784.1,33598672,33607431,33598672,33607431,111135617,XM_022485842.1,uncharacterized LOC111135617,8759
NC_035780.1,57787503,57790873,57787503,57790873,111135622,XM_022485856.1,uncharacterized LOC111135622,3370
NC_035784.1,92519319,92521412,92519319,92521412,111135624,XM_022485854.1,uncharacterized LOC111135624,2093
NC_035784.1,92541681,92543885,92541681,92543885,111135625,XM_022485855.1,uncharacterized LOC111135625,2204
NC_035784.1,37356646,37360447,37356646,37360447,111135628,XM_022485858.1,uncharacterized LOC111135628,3801
NC_035784.1,10158256,10164092,10158555,10164092,111135631,XM_022485863.1,uncharacterized LOC111135631,5537
NC_035784.1,10158256,10164092,10158256,10164092,111135631,XM_022485862.1,uncharacterized LOC111135631,5836
NC_035784.1,10165663,10172054,10171324,10172054,111135633,XM_022485865.1,uncharacterized LOC111135633,730
NC_035784.1,10165663,10172054,10171313,10172054,111135633,XM_022485864.1,uncharacterized LOC111135633,741
NC_035784.1,1730460,1751394,1730460,1751290,111135647,XM_022485911.1,uncharacterized LOC111135647,20830
NC_035784.1,1730460,1751394,1730460,1751317,111135647,XM_022485910.1,uncharacterized LOC111135647,20857
NC_035784.1,1730460,1751394,1730460,1751359,111135647,XM_022485912.1,uncharacterized LOC111135647,20899
NC_035784.1,1730460,1751394,1730460,1751394,111135647,XM_022485909.1,uncharacterized LOC111135647,20934
NC_035784.1,1755039,1769439,1755039,1769439,111135648,XM_022485913.1,uncharacterized LOC111135648,14400
NC_035784.1,88320016,88322787,88320016,88322787,111135651,XM_022485915.1,uncharacterized LOC111135651,2771
NC_035784.1,28603404,28609260,28603404,28609260,111135653,XM_022485917.1,uncharacterized LOC111135653,5856
NC_035784.1,88832584,88835508,88832584,88835508,111135659,XM_022485925.1,uncharacterized LOC111135659,2924
NC_035784.1,88962261,88964828,88962261,88964828,111135664,XM_022485931.1,uncharacterized LOC111135664,2567
NC_035784.1,88810390,88813091,88810390,88813091,111135665,XM_022485932.1,uncharacterized LOC111135665,2701
NC_035784.1,27732918,27736950,27732924,27734558,111135673,XM_022485942.1,uncharacterized LOC111135673,1634
NC_035784.1,27732918,27736950,27732918,27736950,111135673,XM_022485943.1,uncharacterized LOC111135673,4032
NC_035784.1,90927610,90930145,90927610,90930145,111135675,XM_022485944.1,uncharacterized LOC111135675,2535
NC_035780.1,46031916,46035058,46031916,46035058,111135678,XM_022485992.1,uncharacterized LOC111135678,3142
NC_035780.1,58115821,58118226,58115821,58118226,111135683,XM_022485959.1,uncharacterized LOC111135683,2405
NC_035784.1,87207483,87240007,87207483,87229678,111135687,XM_022485961.1,uncharacterized LOC111135687,22195
NC_035784.1,87207483,87240007,87208771,87240007,111135687,XM_022485962.1,uncharacterized LOC111135687,31236
NC_035784.1,34786920,34796011,34786920,34796011,111135688,XM_022485963.1,uncharacterized LOC111135688,9091
NC_035784.1,67821477,67834875,67821477,67834874,111135689,XM_022485967.1,uncharacterized LOC111135689,13397
NC_035784.1,67821477,67834875,67821477,67834875,111135689,XM_022485966.1,uncharacterized LOC111135689,13398
NC_035780.1,58119439,58134019,58119439,58134019,111135690,XM_022485971.1,uncharacterized LOC111135690,14580
NC_035784.1,67835545,67837629,67835545,67837629,111135691,XM_022485969.1,uncharacterized LOC111135691,2084
NC_035784.1,10177784,10181778,10177784,10181778,111135707,XM_022486000.1,uncharacterized LOC111135707,3994
NC_035784.1,88133689,88136721,88133689,88136721,111135708,XM_022486001.1,uncharacterized LOC111135708,3032
NC_035784.1,78020358,78034780,78022499,78034780,111135709,XM_022486003.1,uncharacterized LOC111135709,12281
NC_035784.1,78020358,78034780,78020360,78034780,111135709,XM_022486004.1,uncharacterized LOC111135709,14420
NC_035784.1,78020358,78034780,78020358,78034780,111135709,XM_022486002.1,uncharacterized LOC111135709,14422
NC_035784.1,78009215,78017130,78009296,78017130,111135710,XM_022486005.1,uncharacterized LOC111135710,7834
NC_035784.1,78009215,78017130,78009215,78017130,111135710,XM_022486007.1,uncharacterized LOC111135710,7915
NC_035784.1,40310012,40327992,40310012,40327992,111135712,XM_022486012.1,uncharacterized LOC111135712,17980
NC_035784.1,40310012,40327992,40325003,40327967,111135712,XM_022486011.1,uncharacterized LOC111135712,2964
NC_035784.1,40310012,40327992,40325003,40327968,111135712,XM_022486010.1,uncharacterized LOC111135712,2965
NC_035784.1,71407460,71409869,71407460,71409869,111135716,XM_022486015.1,uncharacterized LOC111135716,2409
NC_035784.1,71404450,71407338,71404450,71407338,111135717,XM_022486016.1,uncharacterized LOC111135717,2888
NC_035780.1,58194381,58197052,58194381,58197052,111135722,XM_022486030.1,uncharacterized LOC111135722,2671
NC_035784.1,18561054,18576933,18561054,18576932,111135729,XM_022486039.1,uncharacterized LOC111135729,15878
NC_035784.1,18561054,18576933,18572064,18576932,111135729,XM_022486040.1,uncharacterized LOC111135729,4868
NC_035784.1,18561054,18576933,18567944,18576933,111135729,XM_022486038.1,uncharacterized LOC111135729,8989
NC_035784.1,36275223,36358189,36275223,36358189,111135734,XM_022486045.1,uncharacterized LOC111135734,82966
NC_035780.1,36842191,36846585,36842191,36846585,111135743,XM_022486064.1,uncharacterized LOC111135743,4394
NC_035784.1,36181263,36186740,36181263,36183873,111135744,XM_022486063.1,uncharacterized LOC111135744,2610
NC_035784.1,36181263,36186740,36181263,36184128,111135744,XM_022486066.1,uncharacterized LOC111135744,2865
NC_035784.1,36181263,36186740,36181263,36185417,111135744,XM_022486067.1,uncharacterized LOC111135744,4154
NC_035784.1,36181263,36186740,36181263,36186740,111135744,XM_022486065.1,uncharacterized LOC111135744,5477
NC_035784.1,36266183,36269021,36266183,36269021,111135745,XM_022486068.1,uncharacterized LOC111135745,2838
NC_035784.1,36192164,36193314,36192164,36193314,111135749,XM_022486075.1,uncharacterized LOC111135749,1150
NC_035784.1,36200060,36201269,36200060,36201269,111135750,XM_022486076.1,uncharacterized LOC111135750,1209
NC_035784.1,36100833,36106929,36100833,36106929,111135751,XM_022486077.1,uncharacterized LOC111135751,6096
NC_035780.1,11645301,11650688,11645301,11650122,111135752,XM_022486198.1,uncharacterized LOC111135752,4821
NC_035780.1,11645301,11650688,11645301,11650688,111135752,XM_022486119.1,uncharacterized LOC111135752,5387
NC_035784.1,35994345,36090779,35994345,36090779,111135753,XM_022486078.1,uncharacterized LOC111135753,96434
NC_035784.1,26093426,26107806,26093429,26107806,111135755,XM_022486080.1,uncharacterized LOC111135755,14377
NC_035784.1,26093426,26107806,26093426,26107806,111135755,XM_022486081.1,uncharacterized LOC111135755,14380
NC_035780.1,36801924,36813753,36801924,36813753,111135756,XM_022486084.1,uncharacterized LOC111135756,11829
NC_035784.1,69190677,69201181,69190677,69201181,111135757,XM_022486082.1,uncharacterized LOC111135757,10504
NC_035784.1,69209284,69213203,69209284,69213203,111135758,XM_022486083.1,uncharacterized LOC111135758,3919
NC_035784.1,308413,323736,308413,323736,111135760,XM_022486086.1,uncharacterized LOC111135760,15323
NC_035784.1,462499,475282,462499,475282,111135762,XM_022486088.1,uncharacterized LOC111135762,12783
NC_035780.1,36879517,36889386,36879517,36889386,111135766,XM_022486096.1,uncharacterized LOC111135766,9869
NC_035784.1,45259247,45362870,45259247,45362862,111135768,XM_022486098.1,uncharacterized LOC111135768,103615
NC_035784.1,45259247,45362870,45259247,45362870,111135768,XM_022486095.1,uncharacterized LOC111135768,103623
NC_035784.1,45259247,45362870,45288292,45362862,111135768,XM_022486100.1,uncharacterized LOC111135768,74570
NC_035784.1,6526362,6530853,6526362,6530526,111135769,XM_022486103.1,uncharacterized LOC111135769,4164
NC_035784.1,6526362,6530853,6526362,6530853,111135769,XM_022486104.1,uncharacterized LOC111135769,4491
NC_035784.1,89111004,89114175,89111004,89114175,111135775,XM_022486111.1,uncharacterized LOC111135775,3171
NC_035784.1,83322203,83385807,83322203,83363017,111135779,XM_022486120.1,uncharacterized LOC111135779,40814
NC_035784.1,83322203,83385807,83322203,83363283,111135779,XM_022486116.1,uncharacterized LOC111135779,41080
NC_035784.1,83322203,83385807,83322203,83385807,111135779,XM_022486117.1,uncharacterized LOC111135779,63604
NC_035784.1,83363355,83414702,83385228,83414701,111135780,XM_022486122.1,uncharacterized LOC111135780,29473
NC_035784.1,83363355,83414702,83384712,83414701,111135780,XM_022486123.1,uncharacterized LOC111135780,29989
NC_035784.1,83363355,83414702,83363355,83414702,111135780,XM_022486121.1,uncharacterized LOC111135780,51347
NC_035784.1,83332094,83334489,83332094,83334489,111135782,XM_022486124.1,uncharacterized LOC111135782,2395
NC_035784.1,743006,745115,743006,745115,111135785,XM_022486141.1,uncharacterized LOC111135785,2109
NC_035784.1,753552,758035,753552,758035,111135794,XM_022486171.1,uncharacterized LOC111135794,4483
NC_035784.1,768081,778991,768081,778991,111135804,XM_022486184.1,uncharacterized LOC111135804,10910
NC_035784.1,44403819,44408204,44403885,44407238,111135805,XM_022486186.1,uncharacterized LOC111135805,3353
NC_035784.1,44403819,44408204,44403819,44408204,111135805,XM_022486185.1,uncharacterized LOC111135805,4385
NC_035780.1,11548066,11556328,11548066,11556328,111135806,XM_022486195.1,uncharacterized LOC111135806,8262
NC_035784.1,44369389,44372098,44369389,44372098,111135807,XM_022486187.1,uncharacterized LOC111135807,2709
NC_035784.1,44372206,44378816,44372206,44378816,111135809,XM_022486191.1,uncharacterized LOC111135809,6610
NC_035784.1,44396709,44399735,44396709,44399735,111135811,XM_022486194.1,uncharacterized LOC111135811,3026
NC_035780.1,62550930,62561884,62550935,62561884,111135821,XM_022486213.1,uncharacterized LOC111135821,10949
NC_035780.1,62550930,62561884,62550930,62561884,111135821,XM_022486202.1,uncharacterized LOC111135821,10954
NC_035780.1,62550930,62561884,62553983,62561884,111135821,XM_022486222.1,uncharacterized LOC111135821,7901
NC_035784.1,68898111,68957546,68898111,68957546,111135822,XM_022486199.1,uncharacterized LOC111135822,59435
NC_035784.1,68909651,68913178,68909651,68913178,111135823,XM_022486201.1,uncharacterized LOC111135823,3527
NC_035784.1,54241747,54254023,54241747,54254023,111135824,XM_022486207.1,uncharacterized LOC111135824,12276
NC_035784.1,54241747,54254023,54248061,54254023,111135824,XM_022486203.1,uncharacterized LOC111135824,5962
NC_035784.1,54241747,54254023,54247961,54254023,111135824,XM_022486206.1,uncharacterized LOC111135824,6062
NC_035784.1,54241747,54254023,54247479,54254023,111135824,XM_022486205.1,uncharacterized LOC111135824,6544
NC_035784.1,70994871,71007361,70994956,71007361,111135827,XM_022486219.1,uncharacterized LOC111135827,12405
NC_035784.1,70994871,71007361,70994871,71007359,111135827,XM_022486218.1,uncharacterized LOC111135827,12488
NC_035784.1,25078746,25082178,25078746,25082178,111135829,XM_022486221.1,uncharacterized LOC111135829,3432
NC_035784.1,96639697,96689330,96639697,96689330,111135836,XM_022486230.1,uncharacterized LOC111135836,49633
NC_035784.1,96740274,96797318,96740274,96797318,111135837,XM_022486231.1,uncharacterized LOC111135837,57044
NC_035780.1,62494269,62549414,62494272,62511717,111135842,XM_022486273.1,uncharacterized LOC111135842,17445
NC_035780.1,62494269,62549414,62494273,62526129,111135842,XM_022486264.1,uncharacterized LOC111135842,31856
NC_035780.1,62494269,62549414,62494270,62527477,111135842,XM_022486257.1,uncharacterized LOC111135842,33207
NC_035780.1,62494269,62549414,62494269,62527477,111135842,XM_022486247.1,uncharacterized LOC111135842,33208
NC_035780.1,62494269,62549414,62494273,62502213,111135842,XM_022486294.1,uncharacterized LOC111135842,7940
NC_035784.1,28546589,28565398,28552219,28565398,111135846,XM_022486256.1,uncharacterized LOC111135846,13179
NC_035784.1,28546589,28565398,28546589,28565398,111135846,XM_022486258.1,uncharacterized LOC111135846,18809
NC_035784.1,28546589,28565398,28562041,28565398,111135846,XM_022486259.1,uncharacterized LOC111135846,3357
NC_035784.1,94422720,94552157,94422720,94552156,111135853,XM_022486274.1,uncharacterized LOC111135853,129436
NC_035784.1,94422720,94552157,94422720,94552157,111135853,XM_022486275.1,uncharacterized LOC111135853,129437
NC_035784.1,35308352,35323930,35308352,35323930,111135861,XM_022486284.1,uncharacterized LOC111135861,15578
NC_035784.1,35308352,35323930,35308352,35314945,111135861,XM_022486286.1,uncharacterized LOC111135861,6593
NC_035784.1,35308352,35323930,35308352,35315941,111135861,XM_022486285.1,uncharacterized LOC111135861,7589
NC_035784.1,35308352,35323930,35308352,35316478,111135861,XM_022486287.1,uncharacterized LOC111135861,8126
NC_035780.1,11652615,11654174,11652615,11654174,111135862,XM_022486323.1,uncharacterized LOC111135862,1559
NC_035784.1,43250518,43254606,43250518,43254606,111135864,XM_022486290.1,uncharacterized LOC111135864,4088
NC_035780.1,62486222,62488192,62486222,62488192,111135871,XM_022486307.1,uncharacterized LOC111135871,1970
NC_035784.1,94174506,94277988,94174506,94277970,111135873,XM_022486306.1,uncharacterized LOC111135873,103464
NC_035784.1,94174506,94277988,94174506,94277988,111135873,XM_022486308.1,uncharacterized LOC111135873,103482
NC_035784.1,94334420,94394828,94334420,94394828,111135874,XM_022486310.1,uncharacterized LOC111135874,60408
NC_035784.1,94303960,94307294,94303960,94307294,111135876,XM_022486314.1,uncharacterized LOC111135876,3334
NC_035784.1,94351067,94354510,94351067,94354510,111135877,XM_022486315.1,uncharacterized LOC111135877,3443
NC_035784.1,94354505,94356936,94354505,94356936,111135879,XM_022486316.1,uncharacterized LOC111135879,2431
NC_035784.1,47693213,47696930,47693213,47696907,111135882,XM_022486321.1,uncharacterized LOC111135882,3694
NC_035784.1,47693213,47696930,47693213,47696930,111135882,XM_022486320.1,uncharacterized LOC111135882,3717
NC_035784.1,7314090,7323866,7314090,7323866,111135887,XM_022486326.1,uncharacterized LOC111135887,9776
NC_035784.1,63465976,63482187,63465976,63482187,111135893,XM_022486344.1,uncharacterized LOC111135893,16211
NC_035784.1,1015900,1016973,1015900,1016973,111135898,XM_022486351.1,uncharacterized LOC111135898,1073
NC_035784.1,10286327,10289782,10287863,10289782,111135902,XM_022486359.1,uncharacterized LOC111135902,1919
NC_035784.1,10286327,10289782,10287850,10289782,111135902,XM_022486360.1,uncharacterized LOC111135902,1932
NC_035784.1,10286327,10289782,10286327,10289782,111135902,XM_022486361.1,uncharacterized LOC111135902,3455
NC_035784.1,84274601,84276062,84274601,84276062,111135905,XM_022486364.1,uncharacterized LOC111135905,1461
NC_035784.1,84227112,84235475,84227112,84235475,111135906,XM_022486365.1,uncharacterized LOC111135906,8363
NC_035784.1,77676846,77692210,77676846,77692210,111135909,XM_022486367.1,uncharacterized LOC111135909,15364
NC_035784.1,52620248,52625987,52620248,52625987,111135913,XM_022486391.1,uncharacterized LOC111135913,5739
NC_035784.1,18798276,18804935,18798276,18804935,111135920,XM_022486400.1,uncharacterized LOC111135920,6659
NC_035784.1,18811810,18835520,18811810,18827655,111135921,XM_022486401.1,uncharacterized LOC111135921,15845
NC_035784.1,18811810,18835520,18811810,18835520,111135921,XM_022486405.1,uncharacterized LOC111135921,23710
NC_035784.1,18811810,18835520,18811810,18819196,111135921,XM_022486404.1,uncharacterized LOC111135921,7386
NC_035784.1,18811810,18835520,18811810,18821073,111135921,XM_022486402.1,uncharacterized LOC111135921,9263
NC_035784.1,1135130,1135921,1135130,1135921,111135923,XM_022486406.1,uncharacterized LOC111135923,791
NC_035784.1,1176128,1179020,1176128,1179020,111135934,XM_022486418.1,uncharacterized LOC111135934,2892
NC_035784.1,21610409,21627442,21610409,21627442,111135951,XM_022486442.1,uncharacterized LOC111135951,17033
NC_035784.1,91990047,92018412,91990047,92018412,111135952,XM_022486443.1,uncharacterized LOC111135952,28365
NC_035784.1,42858117,42876054,42858117,42876054,111135955,XM_022486446.1,uncharacterized LOC111135955,17937
NC_035784.1,42858117,42876054,42870822,42876054,111135955,XM_022486448.1,uncharacterized LOC111135955,5232
NC_035784.1,42837088,42843530,42837088,42843530,111135956,XM_022486450.1,uncharacterized LOC111135956,6442
NC_035784.1,42880676,42886112,42880676,42886112,111135957,XM_022486451.1,uncharacterized LOC111135957,5436
NC_035784.1,5671653,5676155,5671654,5675810,111135958,XM_022486452.1,uncharacterized LOC111135958,4156
NC_035784.1,5671653,5676155,5671653,5676155,111135958,XM_022486453.1,uncharacterized LOC111135958,4502
NC_035784.1,26355851,26366276,26355851,26366276,111135960,XM_022486461.1,uncharacterized LOC111135960,10425
NC_035784.1,26355851,26366276,26359529,26366276,111135960,XM_022486462.1,uncharacterized LOC111135960,6747
NC_035784.1,1445204,1464117,1445204,1464117,111135965,XM_022486469.1,uncharacterized LOC111135965,18913
NC_035784.1,1477512,1492750,1477512,1492750,111135973,XM_022486484.1,uncharacterized LOC111135973,15238
NC_035784.1,50960094,50975788,50960094,50975788,111135977,XM_022486493.1,uncharacterized LOC111135977,15694
NC_035784.1,1594317,1628620,1594317,1628620,111135981,XM_022486508.1,uncharacterized LOC111135981,34303
NC_035784.1,80099181,80101644,80099181,80101644,111135983,XM_022486515.1,uncharacterized LOC111135983,2463
NC_035784.1,80077557,80079894,80077557,80079894,111135985,XM_022486517.1,uncharacterized LOC111135985,2337
NC_035780.1,14326392,14328261,14326392,14328261,111135990,XM_022486563.1,uncharacterized LOC111135990,1869
NC_035784.1,35113430,35119024,35115595,35119024,111135993,XM_022486525.1,uncharacterized LOC111135993,3429
NC_035784.1,35113430,35119024,35114521,35119023,111135993,XM_022486527.1,uncharacterized LOC111135993,4502
NC_035784.1,35113430,35119024,35113430,35119023,111135993,XM_022486526.1,uncharacterized LOC111135993,5593
NC_035784.1,38569467,38586514,38569697,38586514,111135995,XM_022486533.1,uncharacterized LOC111135995,16817
NC_035784.1,38569467,38586514,38569590,38586514,111135995,XM_022486534.1,uncharacterized LOC111135995,16924
NC_035784.1,38569467,38586514,38569467,38586514,111135995,XM_022486532.1,uncharacterized LOC111135995,17047
NC_035784.1,24875851,24902603,24875852,24902603,111136001,XM_022486543.1,uncharacterized LOC111136001,26751
NC_035784.1,24875851,24902603,24875851,24902603,111136001,XM_022486540.1,uncharacterized LOC111136001,26752
NC_035784.1,24926141,24938535,24926141,24938535,111136004,XM_022486549.1,uncharacterized LOC111136004,12394
NC_035784.1,24926141,24938535,24935542,24938534,111136004,XM_022486548.1,uncharacterized LOC111136004,2992
NC_035784.1,1782571,1786989,1782571,1786989,111136007,XM_022486553.1,uncharacterized LOC111136007,4418
NC_035780.1,41990642,41995891,41990642,41995891,111136018,XM_022486583.1,uncharacterized LOC111136018,5249
NC_035784.1,52074318,52079254,52074318,52079254,111136022,XM_022486590.1,uncharacterized LOC111136022,4936
NC_035784.1,52060988,52070015,52060991,52070013,111136023,XM_022486591.1,uncharacterized LOC111136023,9022
NC_035784.1,52050203,52058619,52050203,52058605,111136025,XM_022486593.1,uncharacterized LOC111136025,8402
NC_035784.1,52050203,52058619,52050203,52058619,111136025,XM_022486592.1,uncharacterized LOC111136025,8416
NC_035784.1,70804626,70845527,70804626,70845527,111136029,XM_022486597.1,uncharacterized LOC111136029,40901
NC_035784.1,70793824,70804624,70793824,70804624,111136030,XM_022486598.1,uncharacterized LOC111136030,10800
NC_035784.1,70793824,70804624,70793824,70803638,111136030,XM_022486599.1,uncharacterized LOC111136030,9814
NC_035784.1,70785489,70791796,70785489,70791796,111136031,XM_022486600.1,uncharacterized LOC111136031,6307
NC_035784.1,70773926,70782626,70773926,70782626,111136032,XM_022486602.1,uncharacterized LOC111136032,8700
NC_035784.1,36687568,36694700,36687568,36694700,111136036,XM_022486612.1,uncharacterized LOC111136036,7132
NC_035784.1,2220762,2224600,2220762,2224600,111136041,XM_022486616.1,uncharacterized LOC111136041,3838
NC_035784.1,92268581,92284406,92268581,92284406,111136045,XM_022486620.1,uncharacterized LOC111136045,15825
NC_035784.1,59568800,59573517,59568800,59570380,111136049,XM_022486625.1,uncharacterized LOC111136049,1580
NC_035784.1,59568800,59573517,59568800,59570593,111136049,XM_022486624.1,uncharacterized LOC111136049,1793
NC_035784.1,59568800,59573517,59568800,59573517,111136049,XM_022486623.1,uncharacterized LOC111136049,4717
NC_035784.1,4860246,4885018,4871977,4884349,111136052,XM_022486628.1,uncharacterized LOC111136052,12372
NC_035784.1,4860246,4885018,4871977,4885011,111136052,XM_022486630.1,uncharacterized LOC111136052,13034
NC_035784.1,4860246,4885018,4871977,4885018,111136052,XM_022486631.1,uncharacterized LOC111136052,13041
NC_035784.1,4860246,4885018,4860246,4884349,111136052,XM_022486629.1,uncharacterized LOC111136052,24103
NC_035784.1,4860246,4885018,4876714,4884349,111136052,XM_022486633.1,uncharacterized LOC111136052,7635
NC_035784.1,4860345,4864775,4860345,4864775,111136053,XM_022486634.1,uncharacterized LOC111136053,4430
NC_035780.1,35433582,35437425,35433582,35437425,111136059,XM_022486684.1,uncharacterized LOC111136059,3843
NC_035784.1,73077015,73101638,73077015,73101637,111136061,XM_022486647.1,uncharacterized LOC111136061,24622
NC_035784.1,73077015,73101638,73077015,73101638,111136061,XM_022486649.1,uncharacterized LOC111136061,24623
NC_035784.1,87350869,87362486,87350869,87362486,111136062,XM_022486650.1,uncharacterized LOC111136062,11617
NC_035784.1,64593793,64606082,64593793,64606082,111136063,XM_022486651.1,uncharacterized LOC111136063,12289
NC_035784.1,35773,40738,35773,40738,111136068,XM_022486656.1,uncharacterized LOC111136068,4965
NC_035784.1,42709,44447,42709,44447,111136069,XM_022486657.1,uncharacterized LOC111136069,1738
NC_035780.1,20909975,20917875,20914192,20917875,111136076,XM_022486671.1,uncharacterized LOC111136076,3683
NC_035784.1,17842496,17855189,17842496,17855189,111136077,XM_022486667.1,uncharacterized LOC111136077,12693
NC_035784.1,17832464,17844010,17832464,17844010,111136078,XM_022486672.1,uncharacterized LOC111136078,11546
NC_035784.1,17832464,17844010,17832464,17841134,111136078,XM_022486669.1,uncharacterized LOC111136078,8670
NC_035784.1,17832464,17844010,17832464,17841605,111136078,XM_022486673.1,uncharacterized LOC111136078,9141
NC_035784.1,17832464,17844010,17832464,17842377,111136078,XM_022486670.1,uncharacterized LOC111136078,9913
NC_035784.1,52479047,52516955,52479047,52516955,111136086,XM_022486687.1,uncharacterized LOC111136086,37908
NC_035784.1,2454339,2462925,2454339,2462925,111136088,XM_022486690.1,uncharacterized LOC111136088,8586
NC_035784.1,2500136,2502958,2500136,2502958,111136096,XM_022486701.1,uncharacterized LOC111136096,2822
NC_035784.1,61369180,61375288,61369180,61375288,111136100,XM_022486706.1,uncharacterized LOC111136100,6108
NC_035784.1,48591662,48601280,48591662,48601280,111136103,XM_022486709.1,uncharacterized LOC111136103,9618
NC_035784.1,9027309,9029919,9027311,9029894,111136107,XM_022486714.1,uncharacterized LOC111136107,2583
NC_035784.1,9027309,9029919,9027309,9029895,111136107,XM_022486712.1,uncharacterized LOC111136107,2586
NC_035784.1,9027309,9029919,9027312,9029919,111136107,XM_022486713.1,uncharacterized LOC111136107,2607
NC_035784.1,9017948,9020526,9017948,9020526,111136108,XM_022486716.1,uncharacterized LOC111136108,2578
NC_035784.1,48192251,48197011,48192251,48197011,111136114,XM_022486735.1,uncharacterized LOC111136114,4760
NC_035784.1,48139033,48148875,48139033,48148875,111136116,XM_022486737.1,uncharacterized LOC111136116,9842
NC_035784.1,48403774,48416461,48403774,48416461,111136117,XM_022486738.1,uncharacterized LOC111136117,12687
NC_035784.1,48471985,48490298,48471985,48490298,111136127,XM_022486760.1,uncharacterized LOC111136127,18313
NC_035784.1,48332598,48341496,48332598,48341496,111136128,XM_022486762.1,uncharacterized LOC111136128,8898
NC_035784.1,48531487,48543856,48531487,48543856,111136129,XM_022486763.1,uncharacterized LOC111136129,12369
NC_035784.1,48211799,48219432,48212320,48219432,111136130,XM_022486766.1,uncharacterized LOC111136130,7112
NC_035784.1,48211799,48219432,48211799,48219432,111136130,XM_022486765.1,uncharacterized LOC111136130,7633
NC_035784.1,48056893,48067669,48056893,48067669,111136131,XM_022486767.1,uncharacterized LOC111136131,10776
NC_035784.1,48372044,48381699,48372044,48381699,111136132,XM_022486768.1,uncharacterized LOC111136132,9655
NC_035784.1,79484094,79486525,79484094,79486525,111136143,XM_022486780.1,uncharacterized LOC111136143,2431
NC_035784.1,79460384,79462746,79460384,79462746,111136144,XM_022486781.1,uncharacterized LOC111136144,2362
NC_035784.1,29152887,29165109,29152887,29165109,111136150,XM_022486795.1,uncharacterized LOC111136150,12222
NC_035784.1,14814265,14814845,14814265,14814845,111136154,XM_022486803.1,uncharacterized LOC111136154,580
NC_035784.1,32462001,32467726,32462001,32467726,111136157,XM_022486806.1,uncharacterized LOC111136157,5725
NC_035784.1,12614053,12629112,12614053,12629112,111136163,XM_022486814.1,uncharacterized LOC111136163,15059
NC_035784.1,87813380,87815611,87813380,87815611,111136165,XM_022486816.1,uncharacterized LOC111136165,2231
NC_035784.1,87751584,87753861,87751584,87753861,111136166,XM_022486817.1,uncharacterized LOC111136166,2277
NC_035784.1,87832974,87835428,87832974,87835428,111136168,XM_022486818.1,uncharacterized LOC111136168,2454
NC_035784.1,87778639,87781023,87778639,87781023,111136169,XM_022486819.1,uncharacterized LOC111136169,2384
NC_035784.1,87794848,87797458,87794848,87797458,111136170,XM_022486820.1,uncharacterized LOC111136170,2610
NC_035784.1,64643435,64651605,64643435,64651605,111136176,XM_022486829.1,uncharacterized LOC111136176,8170
NC_035780.1,61692565,61697793,61692565,61697793,111136182,XM_022486841.1,uncharacterized LOC111136182,5228
NC_035784.1,2747732,2749306,2747732,2749306,111136184,XM_022486844.1,uncharacterized LOC111136184,1574
NC_035784.1,58506106,58510169,58506106,58510169,111136187,XM_022486848.1,uncharacterized LOC111136187,4063
NC_035784.1,58482502,58488650,58482514,58488650,111136188,XM_022486849.1,uncharacterized LOC111136188,6136
NC_035784.1,58482502,58488650,58482502,58488650,111136188,XM_022486850.1,uncharacterized LOC111136188,6148
NC_035784.1,39270120,39283249,39270120,39283249,111136190,XM_022486851.1,uncharacterized LOC111136190,13129
NC_035784.1,39205000,39207781,39205000,39207781,111136192,XM_022486854.1,uncharacterized LOC111136192,2781
NC_035784.1,39236699,39238238,39236699,39238238,111136193,XM_022486855.1,uncharacterized LOC111136193,1539
NC_035784.1,35487088,35491394,35487088,35491394,111136195,XM_022486856.1,uncharacterized LOC111136195,4306
NC_035784.1,37477650,37490671,37477650,37490671,111136203,XM_022486877.1,uncharacterized LOC111136203,13021
NC_035784.1,29459302,29464484,29459302,29464472,111136217,XM_022486907.1,uncharacterized LOC111136217,5170
NC_035784.1,29459302,29464484,29459302,29464484,111136217,XM_022486908.1,uncharacterized LOC111136217,5182
NC_035784.1,55493371,55495342,55493371,55495342,111136231,XM_022486935.1,uncharacterized LOC111136231,1971
NC_035784.1,17917726,17938389,17917726,17938389,111136233,XM_022486938.1,uncharacterized LOC111136233,20663
NC_035784.1,7306280,7311071,7307312,7311071,111136246,XM_022486956.1,uncharacterized LOC111136246,3759
NC_035784.1,7306280,7311071,7306280,7311071,111136246,XM_022486955.1,uncharacterized LOC111136246,4791
NC_035784.1,15425761,15427386,15425761,15427386,111136257,XM_022486969.1,uncharacterized LOC111136257,1625
NC_035780.1,38179134,38185274,38179134,38185274,111136259,XM_022487019.1,uncharacterized LOC111136259,6140
NC_035784.1,90244825,90385962,90254920,90385962,111136263,XM_022487000.1,uncharacterized LOC111136263,131042
NC_035784.1,90244825,90385962,90253862,90385962,111136263,XM_022486999.1,uncharacterized LOC111136263,132100
NC_035784.1,90244825,90385962,90244825,90385962,111136263,XM_022487001.1,uncharacterized LOC111136263,141137
NC_035784.1,90244825,90385962,90298063,90385938,111136263,XM_022486998.1,uncharacterized LOC111136263,87875
NC_035784.1,90244825,90385962,90298063,90385958,111136263,XM_022486997.1,uncharacterized LOC111136263,87895
NC_035784.1,90244825,90385962,90298063,90385962,111136263,XM_022486995.1,uncharacterized LOC111136263,87899
NC_035784.1,90249846,90253846,90249857,90253239,111136264,XM_022487003.1,uncharacterized LOC111136264,3382
NC_035784.1,90249846,90253846,90249846,90253846,111136264,XM_022487002.1,uncharacterized LOC111136264,4000
NC_035784.1,90095038,90097679,90095038,90097679,111136272,XM_022487013.1,uncharacterized LOC111136272,2641
NC_035784.1,90011410,90044438,90011411,90013712,111136273,XM_022487015.1,uncharacterized LOC111136273,2301
NC_035784.1,90011410,90044438,90011410,90044438,111136273,XM_022487016.1,uncharacterized LOC111136273,33028
NC_035784.1,90031251,90033687,90031251,90033687,111136274,XM_022487017.1,uncharacterized LOC111136274,2436
NC_035784.1,89876974,89880188,89876974,89880188,111136275,XM_022487018.1,uncharacterized LOC111136275,3214
NC_035784.1,90047694,90052015,90047694,90052015,111136277,XM_022487021.1,uncharacterized LOC111136277,4321
NC_035784.1,90284123,90287307,90284123,90287307,111136279,XM_022487024.1,uncharacterized LOC111136279,3184
NC_035784.1,89981756,89987048,89981756,89987048,111136280,XM_022487025.1,uncharacterized LOC111136280,5292
NC_035784.1,90042062,90043764,90042062,90043764,111136281,XM_022487026.1,uncharacterized LOC111136281,1702
NC_035784.1,89862094,89959446,89955164,89959446,111136282,XM_022487027.1,uncharacterized LOC111136282,4282
NC_035784.1,89862094,89959446,89955162,89959446,111136282,XM_022487029.1,uncharacterized LOC111136282,4284
NC_035784.1,89862094,89959446,89862099,89959446,111136282,XM_022487028.1,uncharacterized LOC111136282,97347
NC_035784.1,89862094,89959446,89862094,89959446,111136282,XM_022487030.1,uncharacterized LOC111136282,97352
NC_035784.1,89968983,89974752,89968983,89974752,111136285,XM_022487032.1,uncharacterized LOC111136285,5769
NC_035784.1,89862395,89866294,89862395,89866294,111136286,XM_022487033.1,uncharacterized LOC111136286,3899
NC_035784.1,89964485,89967972,89964485,89967972,111136288,XM_022487036.1,uncharacterized LOC111136288,3487
NC_035784.1,29690465,29698017,29690465,29698017,111136293,XM_022487042.1,uncharacterized LOC111136293,7552
NC_035784.1,1986516,1999533,1986516,1999533,111136295,XM_022487046.1,uncharacterized LOC111136295,13017
NC_035784.1,83118503,83125499,83118504,83125499,111136300,XM_022487055.1,uncharacterized LOC111136300,6995
NC_035784.1,83118503,83125499,83118503,83125499,111136300,XM_022487054.1,uncharacterized LOC111136300,6996
NC_035784.1,3335086,3366008,3335086,3366008,111136303,XM_022487059.1,uncharacterized LOC111136303,30922
NC_035784.1,78125880,78128097,78125880,78128096,111136307,XM_022487063.1,uncharacterized LOC111136307,2216
NC_035784.1,78125880,78128097,78125880,78128097,111136307,XM_022487065.1,uncharacterized LOC111136307,2217
NC_035784.1,42390189,42423005,42397902,42423005,111136309,XM_022487068.1,uncharacterized LOC111136309,25103
NC_035784.1,42390189,42423005,42390189,42423005,111136309,XM_022487067.1,uncharacterized LOC111136309,32816
NC_035784.1,73662199,73668199,73662199,73668199,111136313,XM_022487074.1,uncharacterized LOC111136313,6000
NC_035784.1,73668237,73686592,73672001,73675878,111136314,XM_022487075.1,uncharacterized LOC111136314,3877
NC_035784.1,73668237,73686592,73668237,73675809,111136314,XM_022487076.1,uncharacterized LOC111136314,7572
NC_035784.1,59946464,59981482,59946464,59981482,111136315,XM_022487078.1,uncharacterized LOC111136315,35018
NC_035784.1,59953336,59954785,59953336,59954785,111136316,XM_022487079.1,uncharacterized LOC111136316,1449
NC_035784.1,82401844,82413376,82401844,82413376,111136321,XM_022487085.1,uncharacterized LOC111136321,11532
NC_035784.1,43408238,43420577,43408239,43420575,111136326,XM_022487090.1,uncharacterized LOC111136326,12336
NC_035784.1,43408238,43420577,43408238,43420575,111136326,XM_022487091.1,uncharacterized LOC111136326,12337
NC_035784.1,43408238,43420577,43408239,43420577,111136326,XM_022487093.1,uncharacterized LOC111136326,12338
NC_035784.1,8304344,8309119,8304361,8309119,111136329,XM_022487097.1,uncharacterized LOC111136329,4758
NC_035784.1,8304344,8309119,8304344,8309119,111136329,XM_022487096.1,uncharacterized LOC111136329,4775
NC_035784.1,84353034,84385587,84359143,84385587,111136330,XM_022487100.1,uncharacterized LOC111136330,26444
NC_035784.1,84353034,84385587,84353040,84385587,111136330,XM_022487099.1,uncharacterized LOC111136330,32547
NC_035784.1,84353034,84385587,84353034,84385587,111136330,XM_022487098.1,uncharacterized LOC111136330,32553
NC_035780.1,59977957,59979489,59977957,59979489,111136332,XM_022487103.1,uncharacterized LOC111136332,1532
NC_035784.1,84432604,84440945,84432604,84440945,111136333,XM_022487101.1,uncharacterized LOC111136333,8341
NC_035784.1,38861758,38873025,38861758,38873025,111136338,XM_022487107.1,uncharacterized LOC111136338,11267
NC_035784.1,38964716,38975641,38964716,38975641,111136339,XM_022487108.1,uncharacterized LOC111136339,10925
NC_035784.1,39071901,39083166,39071901,39083166,111136344,XM_022487145.1,uncharacterized LOC111136344,11265
NC_035784.1,39035512,39057759,39035512,39057759,111136345,XM_022487146.1,uncharacterized LOC111136345,22247
NC_035784.1,39021164,39023880,39021164,39023880,111136346,XM_022487147.1,uncharacterized LOC111136346,2716
NC_035784.1,39015637,39018205,39015637,39018205,111136347,XM_022487148.1,uncharacterized LOC111136347,2568
NC_035784.1,39120795,39137049,39121025,39137049,111136348,XM_022487150.1,uncharacterized LOC111136348,16024
NC_035784.1,39120795,39137049,39120918,39137049,111136348,XM_022487151.1,uncharacterized LOC111136348,16131
NC_035784.1,39120795,39137049,39120795,39137049,111136348,XM_022487149.1,uncharacterized LOC111136348,16254
NC_035784.1,38848635,38851444,38848635,38851444,111136351,XM_022487153.1,uncharacterized LOC111136351,2809
NC_035784.1,38839174,38846355,38840807,38846355,111136358,XM_022487165.1,uncharacterized LOC111136358,5548
NC_035780.1,44559895,44570313,44559895,44570313,111136359,XM_022487169.1,uncharacterized LOC111136359,10418
NC_035780.1,44559895,44570313,44559895,44569720,111136359,XM_022487176.1,uncharacterized LOC111136359,9825
NC_035784.1,39009387,39012613,39009387,39012613,111136363,XM_022487170.1,uncharacterized LOC111136363,3226
NC_035784.1,39031424,39033053,39031424,39033053,111136369,XM_022487177.1,uncharacterized LOC111136369,1629
NC_035784.1,703272,742651,703272,742651,111136381,XM_022487185.1,uncharacterized LOC111136381,39379
NC_035784.1,63115998,63125863,63115998,63124147,111136382,XM_022487196.1,uncharacterized LOC111136382,8149
NC_035784.1,63115998,63125863,63115998,63124149,111136382,XM_022487194.1,uncharacterized LOC111136382,8151
NC_035784.1,63115998,63125863,63115998,63124211,111136382,XM_022487198.1,uncharacterized LOC111136382,8213
NC_035784.1,63115998,63125863,63115998,63125863,111136382,XM_022487197.1,uncharacterized LOC111136382,9865
NC_035784.1,63105377,63109002,63105377,63109002,111136383,XM_022487199.1,uncharacterized LOC111136383,3625
NC_035784.1,63109721,63115824,63109721,63115824,111136384,XM_022487201.1,uncharacterized LOC111136384,6103
NC_035784.1,63133999,63139204,63133999,63139204,111136385,XM_022487202.1,uncharacterized LOC111136385,5205
NC_035784.1,63128362,63133473,63128362,63133473,111136386,XM_022487203.1,uncharacterized LOC111136386,5111
NC_035784.1,40801543,40821030,40801554,40821030,111136393,XM_022487212.1,uncharacterized LOC111136393,19476
NC_035784.1,40801543,40821030,40801543,40821030,111136393,XM_022487211.1,uncharacterized LOC111136393,19487
NC_035784.1,34282010,34295776,34282010,34295373,111136396,XM_022487215.1,uncharacterized LOC111136396,13363
NC_035784.1,34282010,34295776,34282010,34295776,111136396,XM_022487216.1,uncharacterized LOC111136396,13766
NC_035784.1,29920758,29922747,29920758,29922747,111136402,XM_022487226.1,uncharacterized LOC111136402,1989
NC_035784.1,77596436,77609286,77596436,77609286,111136407,XM_022487239.1,uncharacterized LOC111136407,12850
NC_035784.1,77596436,77609286,77596436,77602234,111136407,XM_022487237.1,uncharacterized LOC111136407,5798
NC_035784.1,77596436,77609286,77596436,77604093,111136407,XM_022487240.1,uncharacterized LOC111136407,7657
NC_035784.1,77596436,77609286,77596436,77605098,111136407,XM_022487238.1,uncharacterized LOC111136407,8662
NC_035784.1,4200114,4201940,4200114,4201940,111136409,XM_022487242.1,uncharacterized LOC111136409,1826
NC_035784.1,24332653,24355696,24332663,24355696,111136422,XM_022487263.1,uncharacterized LOC111136422,23033
NC_035784.1,24332653,24355696,24332653,24355696,111136422,XM_022487262.1,uncharacterized LOC111136422,23043
NC_035784.1,19520540,19532075,19520540,19532075,111136426,XM_022487271.1,uncharacterized LOC111136426,11535
NC_035784.1,19520540,19532075,19525836,19532075,111136426,XM_022487267.1,uncharacterized LOC111136426,6239
NC_035784.1,19542156,19559172,19542156,19559172,111136428,XM_022487273.1,uncharacterized LOC111136428,17016
NC_035784.1,75199320,75208003,75199320,75208003,111136429,XM_022487274.1,uncharacterized LOC111136429,8683
NC_035784.1,76954502,76958358,76954502,76957605,111136430,XM_022487275.1,uncharacterized LOC111136430,3103
NC_035784.1,76954502,76958358,76954502,76958358,111136430,XM_022487276.1,uncharacterized LOC111136430,3856
NC_035784.1,31804130,31805665,31804130,31805665,111136435,XM_022487283.1,uncharacterized LOC111136435,1535
NC_035784.1,34562790,34566371,34562790,34566371,111136436,XM_022487284.1,uncharacterized LOC111136436,3581
NC_035784.1,1106695,1111381,1106695,1111381,111136439,XM_022487289.1,uncharacterized LOC111136439,4686
NC_035784.1,37742490,37753869,37742531,37753869,111136442,XM_022487297.1,uncharacterized LOC111136442,11338
NC_035784.1,37742490,37753869,37742490,37753869,111136442,XM_022487293.1,uncharacterized LOC111136442,11379
NC_035784.1,37742490,37753869,37748489,37753869,111136442,XM_022487294.1,uncharacterized LOC111136442,5380
NC_035784.1,37742490,37753869,37747016,37753869,111136442,XM_022487298.1,uncharacterized LOC111136442,6853
NC_035784.1,37742490,37753869,37745793,37753869,111136442,XM_022487295.1,uncharacterized LOC111136442,8076
NC_035784.1,37742490,37753869,37745715,37753869,111136442,XM_022487296.1,uncharacterized LOC111136442,8154
NC_035784.1,78112186,78114956,78112186,78114956,111136443,XM_022487299.1,uncharacterized LOC111136443,2770
NC_035784.1,21494192,21500863,21494192,21500863,111136450,XM_022487311.1,uncharacterized LOC111136450,6671
NC_035784.1,49966591,49969899,49966591,49969899,111136453,XM_022487314.1,uncharacterized LOC111136453,3308
NC_035784.1,9052433,9058505,9052433,9058505,111136454,XM_022487316.1,uncharacterized LOC111136454,6072
NC_035784.1,80229669,80231868,80229669,80231868,111136456,XM_022487318.1,uncharacterized LOC111136456,2199
NC_035784.1,36954147,36962294,36954147,36961797,111136461,XM_022487325.1,uncharacterized LOC111136461,7650
NC_035784.1,36954147,36962294,36954147,36962037,111136461,XM_022487323.1,uncharacterized LOC111136461,7890
NC_035784.1,36954147,36962294,36954147,36962294,111136461,XM_022487324.1,uncharacterized LOC111136461,8147
NC_035784.1,36930616,36939413,36936858,36939413,111136463,XM_022487333.1,uncharacterized LOC111136463,2555
NC_035784.1,36930616,36939413,36936269,36939413,111136463,XM_022487332.1,uncharacterized LOC111136463,3144
NC_035784.1,36930616,36939413,36935053,36939413,111136463,XM_022487334.1,uncharacterized LOC111136463,4360
NC_035784.1,36930616,36939413,36932637,36939413,111136463,XM_022487328.1,uncharacterized LOC111136463,6776
NC_035784.1,36930616,36939413,36930994,36939413,111136463,XM_022487330.1,uncharacterized LOC111136463,8419
NC_035784.1,36930616,36939413,36930616,36939413,111136463,XM_022487329.1,uncharacterized LOC111136463,8797
NC_035784.1,37011718,37026937,37012012,37026937,111136477,XM_022487353.1,uncharacterized LOC111136477,14925
NC_035784.1,37011718,37026937,37011719,37026937,111136477,XM_022487352.1,uncharacterized LOC111136477,15218
NC_035784.1,37011718,37026937,37011718,37026937,111136477,XM_022487354.1,uncharacterized LOC111136477,15219
NC_035784.1,16458169,16459672,16458169,16459672,111136478,XM_022487355.1,uncharacterized LOC111136478,1503
NC_035784.1,83090223,83098835,83090223,83098829,111136480,XM_022487359.1,uncharacterized LOC111136480,8606
NC_035784.1,83090223,83098835,83090223,83098835,111136480,XM_022487360.1,uncharacterized LOC111136480,8612
NC_035780.1,3141167,3150711,3141167,3150711,111136481,XM_022487363.1,uncharacterized LOC111136481,9544
NC_035780.1,10687646,10694391,10687646,10693411,111136495,XM_022487384.1,uncharacterized LOC111136495,5765
NC_035780.1,10687646,10694391,10687646,10694391,111136495,XM_022487400.1,uncharacterized LOC111136495,6745
NC_035784.1,59525038,59535484,59525038,59535484,111136496,XM_022487381.1,uncharacterized LOC111136496,10446
NC_035784.1,59525038,59535484,59531985,59535484,111136496,XM_022487382.1,uncharacterized LOC111136496,3499
NC_035784.1,5262583,5264024,5262583,5264024,111136498,XM_022487385.1,uncharacterized LOC111136498,1441
NC_035784.1,46533522,46543974,46533522,46543974,111136500,XM_022487387.1,uncharacterized LOC111136500,10452
NC_035784.1,28344548,28349142,28344548,28349142,111136518,XM_022487418.1,uncharacterized LOC111136518,4594
NC_035784.1,28739527,28751948,28739528,28751948,111136531,XM_022487446.1,uncharacterized LOC111136531,12420
NC_035784.1,28739527,28751948,28739527,28751948,111136531,XM_022487448.1,uncharacterized LOC111136531,12421
NC_035784.1,5334005,5341938,5334005,5341938,111136532,XM_022487449.1,uncharacterized LOC111136532,7933
NC_035784.1,85036651,85042096,85036651,85042096,111136534,XM_022487453.1,uncharacterized LOC111136534,5445
NC_035780.1,56282142,56301210,56282142,56301210,111136537,XM_022487459.1,uncharacterized LOC111136537,19068
NC_035784.1,5374918,5408423,5374918,5408423,111136541,XM_022487460.1,uncharacterized LOC111136541,33505
NC_035784.1,23416056,23426460,23416056,23426460,111136542,XM_022487461.1,uncharacterized LOC111136542,10404
NC_035784.1,77212535,77230635,77212535,77230634,111136546,XM_022487466.1,uncharacterized LOC111136546,18099
NC_035784.1,77212535,77230635,77212535,77230635,111136546,XM_022487465.1,uncharacterized LOC111136546,18100
NC_035784.1,41702503,41703813,41702503,41703813,111136565,XM_022487510.1,uncharacterized LOC111136565,1310
NC_035784.1,41700319,41721862,41700319,41721862,111136566,XM_022487512.1,uncharacterized LOC111136566,21543
NC_035784.1,41700319,41721862,41700320,41702614,111136566,XM_022487511.1,uncharacterized LOC111136566,2294
NC_035784.1,5446053,5449292,5446053,5449292,111136569,XM_022487514.1,uncharacterized LOC111136569,3239
NC_035784.1,35295615,35299414,35295615,35299414,111136570,XM_022487515.1,uncharacterized LOC111136570,3799
NC_035784.1,43255647,43258475,43255647,43258475,111136577,XM_022487523.1,uncharacterized LOC111136577,2828
NC_035784.1,41164448,41168510,41164448,41168510,111136582,XM_022487527.1,uncharacterized LOC111136582,4062
NC_035784.1,6638644,6651894,6640891,6651894,111136588,XM_022487534.1,uncharacterized LOC111136588,11003
NC_035784.1,6638644,6651894,6638652,6651894,111136588,XM_022487535.1,uncharacterized LOC111136588,13242
NC_035784.1,6630166,6638593,6630166,6632427,111136589,XM_022487538.1,uncharacterized LOC111136589,2261
NC_035784.1,6630166,6638593,6630166,6638593,111136589,XM_022487536.1,uncharacterized LOC111136589,8427
NC_035780.1,10301945,10312883,10301945,10312883,111136592,XM_022487550.1,uncharacterized LOC111136592,10938
NC_035780.1,43042994,43047516,43042994,43047516,111136603,XM_022487575.1,uncharacterized LOC111136603,4522
NC_035784.1,29917633,29919133,29917633,29919133,111136604,XM_022487574.1,uncharacterized LOC111136604,1500
NC_035784.1,5563356,5577801,5563356,5577801,111136608,XM_022487578.1,uncharacterized LOC111136608,14445
NC_035780.1,28133474,28163808,28133474,28148383,111136618,XM_022487601.1,uncharacterized LOC111136618,14909
NC_035780.1,28133474,28163808,28133474,28163739,111136618,XM_022487608.1,uncharacterized LOC111136618,30265
NC_035780.1,28133474,28163808,28133474,28163808,111136618,XM_022487618.1,uncharacterized LOC111136618,30334
NC_035784.1,76800076,76809433,76800076,76809433,111136619,XM_022487598.1,uncharacterized LOC111136619,9357
NC_035784.1,5708340,5710364,5708340,5710364,111136625,XM_022487605.1,uncharacterized LOC111136625,2024
NC_035784.1,33546601,33556717,33546601,33556717,111136628,XM_022487614.1,uncharacterized LOC111136628,10116
NC_035784.1,70503254,70506365,70503254,70506365,111136632,XM_022487622.1,uncharacterized LOC111136632,3111
NC_035784.1,70508791,70518212,70508791,70518212,111136633,XM_022487623.1,uncharacterized LOC111136633,9421
NC_035780.1,28147749,28163436,28149156,28163436,111136636,XM_022487630.1,uncharacterized LOC111136636,14280
NC_035780.1,28147749,28163436,28147749,28163436,111136636,XM_022487640.1,uncharacterized LOC111136636,15687
NC_035780.1,28147749,28163436,28157831,28163436,111136636,XM_022487649.1,uncharacterized LOC111136636,5605
NC_035784.1,5732878,5734323,5732878,5734323,111136637,XM_022487626.1,uncharacterized LOC111136637,1445
NC_035784.1,5734990,5744360,5734990,5744360,111136640,XM_022487635.1,uncharacterized LOC111136640,9370
NC_035784.1,16628226,16632032,16630326,16632032,111136645,XM_022487647.1,uncharacterized LOC111136645,1706
NC_035784.1,16628226,16632032,16628226,16632032,111136645,XM_022487648.1,uncharacterized LOC111136645,3806
NC_035784.1,91071467,91083875,91071467,91083875,111136647,XM_022487652.1,uncharacterized LOC111136647,12408
NC_035784.1,74096678,74100702,74096691,74100702,111136650,XM_022487657.1,uncharacterized LOC111136650,4011
NC_035784.1,74096678,74100702,74096678,74100702,111136650,XM_022487656.1,uncharacterized LOC111136650,4024
NC_035784.1,70855022,70860693,70855022,70859113,111136655,XM_022487666.1,uncharacterized LOC111136655,4091
NC_035784.1,70855022,70860693,70855022,70860693,111136655,XM_022487665.1,uncharacterized LOC111136655,5671
NC_035784.1,70877366,70880942,70877366,70880942,111136656,XM_022487667.1,uncharacterized LOC111136656,3576
NC_035784.1,70874693,70877921,70874704,70877831,111136658,XM_022487670.1,uncharacterized LOC111136658,3127
NC_035784.1,70874693,70877921,70874696,70877864,111136658,XM_022487671.1,uncharacterized LOC111136658,3168
NC_035784.1,5814409,5822147,5814409,5822147,111136659,XM_022487672.1,uncharacterized LOC111136659,7738
NC_035784.1,6005491,6014304,6005491,6014304,111136665,XM_022487678.1,uncharacterized LOC111136665,8813
NC_035784.1,6226249,6253001,6226249,6253001,111136678,XM_022487714.1,uncharacterized LOC111136678,26752
NC_035784.1,61764662,61774126,61764662,61774126,111136680,XM_022487718.1,uncharacterized LOC111136680,9464
NC_035784.1,53806715,53810144,53806715,53810144,111136687,XM_022487732.1,uncharacterized LOC111136687,3429
NC_035784.1,50693461,50697645,50693461,50697645,111136688,XM_022487733.1,uncharacterized LOC111136688,4184
NC_035784.1,89134713,89150210,89134714,89150210,111136690,XM_022487736.1,uncharacterized LOC111136690,15496
NC_035784.1,89134713,89150210,89134713,89141459,111136690,XM_022487737.1,uncharacterized LOC111136690,6746
NC_035780.1,15748182,15756288,15748185,15756288,111136692,XM_022487754.1,uncharacterized LOC111136692,8103
NC_035780.1,15748182,15756288,15748182,15756288,111136692,XM_022487763.1,uncharacterized LOC111136692,8106
NC_035784.1,6288678,6291956,6288678,6291956,111136694,XM_022487753.1,uncharacterized LOC111136694,3278
NC_035784.1,64659234,64661686,64659234,64661686,111136695,XM_022487755.1,uncharacterized LOC111136695,2452
NC_035784.1,16719866,16725340,16719866,16725340,111136697,XM_022487757.1,uncharacterized LOC111136697,5474
NC_035784.1,73594235,73598247,73594235,73598247,111136698,XM_022487758.1,uncharacterized LOC111136698,4012
NC_035784.1,30908905,30910499,30908905,30910499,111136705,XM_022487777.1,uncharacterized LOC111136705,1594
NC_035784.1,71294419,71303699,71294419,71303699,111136707,XM_022487779.1,uncharacterized LOC111136707,9280
NC_035784.1,59314564,59319705,59314564,59319096,111136708,XM_022487782.1,uncharacterized LOC111136708,4532
NC_035784.1,59314564,59319705,59314564,59319483,111136708,XM_022487781.1,uncharacterized LOC111136708,4919
NC_035784.1,59314564,59319705,59314564,59319493,111136708,XM_022487780.1,uncharacterized LOC111136708,4929
NC_035784.1,59314564,59319705,59314564,59319705,111136708,XM_022487783.1,uncharacterized LOC111136708,5141
NC_035784.1,46823461,46825703,46823461,46825703,111136711,XM_022487785.1,uncharacterized LOC111136711,2242
NC_035784.1,46825819,46827984,46825819,46827984,111136712,XM_022487786.1,uncharacterized LOC111136712,2165
NC_035784.1,46808963,46828290,46808963,46828290,111136713,XM_022487787.1,uncharacterized LOC111136713,19327
NC_035784.1,46804110,46806190,46804110,46806190,111136714,XM_022487789.1,uncharacterized LOC111136714,2080
NC_035784.1,56955309,56968215,56955309,56966806,111136715,XM_022487790.1,uncharacterized LOC111136715,11497
NC_035784.1,56955309,56968215,56955309,56968215,111136715,XM_022487791.1,uncharacterized LOC111136715,12906
NC_035784.1,56955309,56968215,56955309,56961945,111136715,XM_022487792.1,uncharacterized LOC111136715,6636
NC_035784.1,91040296,91043161,91040296,91043161,111136719,XM_022487795.1,uncharacterized LOC111136719,2865
NC_035784.1,91036672,91039172,91036672,91039172,111136720,XM_022487797.1,uncharacterized LOC111136720,2500
NC_035784.1,7554607,7564970,7554607,7564970,111136732,XM_022487819.1,uncharacterized LOC111136732,10363
NC_035780.1,28484045,28489170,28484045,28489170,111136736,XM_022487828.1,uncharacterized LOC111136736,5125
NC_035784.1,49570958,49577902,49570958,49577902,111136737,XM_022487826.1,uncharacterized LOC111136737,6944
NC_035784.1,37339076,37343416,37339076,37343416,111136738,XM_022487827.1,uncharacterized LOC111136738,4340
NC_035784.1,37333361,37339091,37333361,37339075,111136739,XM_022487829.1,uncharacterized LOC111136739,5714
NC_035784.1,37333361,37339091,37333361,37339091,111136739,XM_022487830.1,uncharacterized LOC111136739,5730
NC_035784.1,46353572,46356577,46353572,46356547,111136740,XM_022487832.1,uncharacterized LOC111136740,2975
NC_035784.1,46353572,46356577,46353574,46356577,111136740,XM_022487831.1,uncharacterized LOC111136740,3003
NC_035784.1,32661123,32667089,32661123,32667089,111136743,XM_022487835.1,uncharacterized LOC111136743,5966
NC_035784.1,74065622,74067353,74065622,74067353,111136750,XM_022487844.1,uncharacterized LOC111136750,1731
NC_035784.1,67838315,67841010,67838380,67841010,111136752,XM_022487848.1,uncharacterized LOC111136752,2630
NC_035784.1,67838315,67841010,67838315,67841010,111136752,XM_022487847.1,uncharacterized LOC111136752,2695
NC_035784.1,31673474,31675672,31673474,31675672,111136754,XM_022487849.1,uncharacterized LOC111136754,2198
NC_035784.1,9203889,9206932,9203889,9206932,111136756,XM_022487851.1,uncharacterized LOC111136756,3043
NC_035784.1,19509434,19515321,19509434,19515321,111136757,XM_022487853.1,uncharacterized LOC111136757,5887
NC_035784.1,42608695,42614812,42608695,42614812,111136759,XM_022487855.1,uncharacterized LOC111136759,6117
NC_035784.1,2408632,2410556,2408632,2410556,111136761,XM_022487859.1,uncharacterized LOC111136761,1924
NC_035784.1,13704662,13708529,13704662,13708529,111136763,XM_022487860.1,uncharacterized LOC111136763,3867
NC_035784.1,41342025,41343338,41342025,41343338,111136767,XM_022487866.1,uncharacterized LOC111136767,1313
NC_035784.1,61021056,61029069,61021056,61029069,111136768,XM_022487867.1,uncharacterized LOC111136768,8013
NC_035784.1,7507646,7511072,7507646,7511047,111136771,XM_022487871.1,uncharacterized LOC111136771,3401
NC_035784.1,7507646,7511072,7507646,7511072,111136771,XM_022487870.1,uncharacterized LOC111136771,3426
NC_035784.1,59925375,59929882,59925375,59929882,111136773,XM_022487875.1,uncharacterized LOC111136773,4507
NC_035784.1,13144645,13146177,13144645,13146177,111136774,XM_022487876.1,uncharacterized LOC111136774,1532
NC_035784.1,16181637,16186740,16181637,16186740,111136777,XM_022487879.1,uncharacterized LOC111136777,5103
NC_035784.1,50790182,50795035,50790182,50794671,111136785,XM_022487891.1,uncharacterized LOC111136785,4489
NC_035784.1,50790182,50795035,50790182,50795035,111136785,XM_022487892.1,uncharacterized LOC111136785,4853
NC_035784.1,65383233,65386476,65384530,65386476,111136789,XM_022487897.1,uncharacterized LOC111136789,1946
NC_035784.1,65383233,65386476,65383233,65386476,111136789,XM_022487896.1,uncharacterized LOC111136789,3243
NC_035784.1,93451192,93452915,93451192,93452915,111136795,XM_022487903.1,uncharacterized LOC111136795,1723
NC_035784.1,31033095,31034751,31033095,31034751,111136796,XM_022487904.1,uncharacterized LOC111136796,1656
NC_035784.1,6955585,6963849,6955585,6963849,111136797,XM_022487905.1,uncharacterized LOC111136797,8264
NC_035784.1,82793745,82813619,82803475,82813619,111136800,XM_022487913.1,uncharacterized LOC111136800,10144
NC_035784.1,82793745,82813619,82803344,82813619,111136800,XM_022487911.1,uncharacterized LOC111136800,10275
NC_035784.1,82793745,82813619,82803141,82813619,111136800,XM_022487916.1,uncharacterized LOC111136800,10478
NC_035784.1,82793745,82813619,82803139,82813619,111136800,XM_022487912.1,uncharacterized LOC111136800,10480
NC_035784.1,82793745,82813619,82801182,82813619,111136800,XM_022487915.1,uncharacterized LOC111136800,12437
NC_035784.1,82793745,82813619,82800892,82813619,111136800,XM_022487910.1,uncharacterized LOC111136800,12727
NC_035784.1,82793745,82813619,82796871,82813619,111136800,XM_022487914.1,uncharacterized LOC111136800,16748
NC_035784.1,82793745,82813619,82793745,82813619,111136800,XM_022487917.1,uncharacterized LOC111136800,19874
NC_035780.1,46683714,46692495,46683714,46691408,111136801,XM_022487919.1,uncharacterized LOC111136801,7694
NC_035780.1,46683714,46692495,46683715,46692495,111136801,XM_022487928.1,uncharacterized LOC111136801,8780
NC_035780.1,46683714,46692495,46683714,46692495,111136801,XM_022487936.1,uncharacterized LOC111136801,8781
NC_035784.1,57240465,57259188,57240465,57259188,111136803,XM_022487921.1,uncharacterized LOC111136803,18723
NC_035784.1,32134656,32139768,32134656,32139768,111136806,XM_022487924.1,uncharacterized LOC111136806,5112
NC_035784.1,14994772,14996804,14994772,14996804,111136813,XM_022487935.1,uncharacterized LOC111136813,2032
NC_035784.1,69790870,69797034,69790870,69797034,111136816,XM_022487941.1,uncharacterized LOC111136816,6164
NC_035784.1,69774575,69776430,69774575,69776430,111136817,XM_022487942.1,uncharacterized LOC111136817,1855
NC_035784.1,68188195,68192217,68188195,68192217,111136818,XM_022487943.1,uncharacterized LOC111136818,4022
NC_035784.1,7258189,7262043,7258189,7262043,111136825,XM_022487949.1,uncharacterized LOC111136825,3854
NC_035784.1,38490284,38493043,38490284,38493043,111136826,XM_022487950.1,uncharacterized LOC111136826,2759
NC_035784.1,71054425,71062050,71054425,71062050,111136831,XM_022487954.1,uncharacterized LOC111136831,7625
NC_035784.1,83245978,83256856,83246003,83256856,111136836,XM_022487963.1,uncharacterized LOC111136836,10853
NC_035784.1,83245978,83256856,83245978,83252559,111136836,XM_022487962.1,uncharacterized LOC111136836,6581
NC_035784.1,83245978,83256856,83245978,83253003,111136836,XM_022487961.1,uncharacterized LOC111136836,7025
NC_035784.1,43043965,43067959,43044179,43067959,111136837,XM_022487964.1,uncharacterized LOC111136837,23780
NC_035784.1,43043965,43067959,43043965,43067959,111136837,XM_022487965.1,uncharacterized LOC111136837,23994
NC_035784.1,43043965,43067959,43059204,43067959,111136837,XM_022487966.1,uncharacterized LOC111136837,8755
NC_035784.1,29734063,29738603,29734063,29738603,111136842,XM_022487971.1,uncharacterized LOC111136842,4540
NC_035784.1,29730658,29733196,29730658,29733196,111136843,XM_022487972.1,uncharacterized LOC111136843,2538
NC_035784.1,29729023,29730487,29729023,29730487,111136844,XM_022487973.1,uncharacterized LOC111136844,1464
NC_035784.1,2171499,2173335,2171499,2173335,111136848,XM_022487978.1,uncharacterized LOC111136848,1836
NC_035784.1,13146746,13148601,13146746,13148601,111136851,XM_022487984.1,uncharacterized LOC111136851,1855
NC_035784.1,55471477,55473228,55471477,55473228,111136852,XM_022487985.1,uncharacterized LOC111136852,1751
NC_035784.1,73141655,73156929,73141655,73155982,111136854,XM_022487987.1,uncharacterized LOC111136854,14327
NC_035784.1,73141655,73156929,73141655,73156929,111136854,XM_022487986.1,uncharacterized LOC111136854,15274
NC_035784.1,7405087,7407236,7405087,7407236,111136855,XM_022487988.1,uncharacterized LOC111136855,2149
NC_035784.1,7963740,7978052,7963773,7978052,111136857,XM_022487992.1,uncharacterized LOC111136857,14279
NC_035784.1,7963740,7978052,7963740,7978052,111136857,XM_022487991.1,uncharacterized LOC111136857,14312
NC_035784.1,26311083,26353001,26311083,26330945,111136861,XM_022487999.1,uncharacterized LOC111136861,19862
NC_035784.1,26311083,26353001,26311083,26347629,111136861,XM_022488000.1,uncharacterized LOC111136861,36546
NC_035784.1,26311083,26353001,26311083,26353001,111136861,XM_022488001.1,uncharacterized LOC111136861,41918
NC_035784.1,10323385,10329409,10323385,10329409,111136862,XM_022488002.1,uncharacterized LOC111136862,6024
NC_035784.1,55856266,55860909,55856266,55860908,111136863,XM_022488003.1,uncharacterized LOC111136863,4642
NC_035784.1,55856266,55860909,55856266,55860909,111136863,XM_022488004.1,uncharacterized LOC111136863,4643
NC_035784.1,56085341,56087699,56085341,56087699,111136869,XM_022488016.1,uncharacterized LOC111136869,2358
NC_035784.1,56068837,56072996,56068837,56072996,111136870,XM_022488017.1,uncharacterized LOC111136870,4159
NC_035784.1,56126161,56135216,56126161,56135216,111136871,XM_022488018.1,uncharacterized LOC111136871,9055
NC_035784.1,55864982,55871318,55864982,55871318,111136876,XM_022488025.1,uncharacterized LOC111136876,6336
NC_035784.1,35060931,35061648,35060931,35061648,111136880,XM_022488030.1,uncharacterized LOC111136880,717
NC_035784.1,91246091,91248390,91246091,91248390,111136884,XM_022488033.1,uncharacterized LOC111136884,2299
NC_035784.1,58197595,58199843,58197595,58199843,111136885,XM_022488034.1,uncharacterized LOC111136885,2248
NC_035784.1,7443345,7467825,7443345,7467825,111136886,XM_022488036.1,uncharacterized LOC111136886,24480
NC_035784.1,7474276,7476070,7474276,7476070,111136894,XM_022488055.1,uncharacterized LOC111136894,1794
NC_035784.1,72963069,72965110,72963069,72965110,111136895,XM_022488056.1,uncharacterized LOC111136895,2041
NC_035784.1,96196392,96203185,96196392,96203185,111136900,XM_022488062.1,uncharacterized LOC111136900,6793
NC_035784.1,60914516,60917073,60914516,60917073,111136902,XM_022488064.1,uncharacterized LOC111136902,2557
NC_035784.1,66374571,66385231,66375213,66385231,111136903,XM_022488066.1,uncharacterized LOC111136903,10018
NC_035784.1,66374571,66385231,66375210,66385231,111136903,XM_022488071.1,uncharacterized LOC111136903,10021
NC_035784.1,66374571,66385231,66375208,66385231,111136903,XM_022488065.1,uncharacterized LOC111136903,10023
NC_035784.1,66374571,66385231,66375108,66385231,111136903,XM_022488069.1,uncharacterized LOC111136903,10123
NC_035784.1,66374571,66385231,66374995,66385231,111136903,XM_022488068.1,uncharacterized LOC111136903,10236
NC_035784.1,66374571,66385231,66374700,66385231,111136903,XM_022488070.1,uncharacterized LOC111136903,10531
NC_035784.1,66374571,66385231,66374571,66385231,111136903,XM_022488067.1,uncharacterized LOC111136903,10660
NC_035784.1,72022833,72024344,72022833,72024344,111136909,XM_022488078.1,uncharacterized LOC111136909,1511
NC_035784.1,7621973,7657566,7621973,7657566,111136911,XM_022488079.1,uncharacterized LOC111136911,35593
NC_035784.1,78939807,78947235,78939807,78947235,111136923,XM_022488097.1,uncharacterized LOC111136923,7428
NC_035780.1,6858668,6873921,6858668,6873921,111136926,XM_022488108.1,uncharacterized LOC111136926,15253
NC_035784.1,87513352,87516693,87513352,87516693,111136928,XM_022488107.1,uncharacterized LOC111136928,3341
NC_035784.1,51802184,51803306,51802184,51803306,111136933,XM_022488115.1,uncharacterized LOC111136933,1122
NC_035784.1,7854431,7857367,7854431,7857367,111136936,XM_022488117.1,uncharacterized LOC111136936,2936
NC_035784.1,37783205,37787787,37783277,37787762,111136944,XM_022488127.1,uncharacterized LOC111136944,4485
NC_035784.1,37783205,37787787,37783205,37787787,111136944,XM_022488128.1,uncharacterized LOC111136944,4582
NC_035784.1,19592950,19602122,19592950,19602122,111136946,XM_022488130.1,uncharacterized LOC111136946,9172
NC_035784.1,86581763,86586342,86581763,86586342,111136951,XM_022488140.1,uncharacterized LOC111136951,4579
NC_035784.1,69750409,69758073,69750409,69756079,111136953,XM_022488143.1,uncharacterized LOC111136953,5670
NC_035784.1,69750409,69758073,69750409,69758073,111136953,XM_022488142.1,uncharacterized LOC111136953,7664
NC_035784.1,62869727,62874485,62869727,62874485,111136955,XM_022488145.1,uncharacterized LOC111136955,4758
NC_035784.1,71392707,71394361,71392707,71394361,111136978,XM_022488181.1,uncharacterized LOC111136978,1654
NC_035784.1,55468153,55469340,55468153,55469340,111136983,XM_022488189.1,uncharacterized LOC111136983,1187
NC_035784.1,81114575,81117178,81114575,81117178,111136985,XM_022488193.1,uncharacterized LOC111136985,2603
NC_035784.1,81108085,81114576,81108085,81114576,111136986,XM_022488194.1,uncharacterized LOC111136986,6491
NC_035784.1,87914484,87921538,87914484,87921538,111136989,XM_022488198.1,uncharacterized LOC111136989,7054
NC_035784.1,88158914,88201325,88158914,88201325,111136995,XM_022488210.1,uncharacterized LOC111136995,42411
NC_035784.1,88158914,88201325,88158914,88166241,111136995,XM_022488208.1,uncharacterized LOC111136995,7327
NC_035784.1,88193368,88200848,88193368,88200848,111136996,XM_022488211.1,uncharacterized LOC111136996,7480
NC_035784.1,88225734,88233219,88225734,88233219,111136997,XM_022488212.1,uncharacterized LOC111136997,7485
NC_035784.1,88050914,88063380,88050914,88063380,111136998,XM_022488213.1,uncharacterized LOC111136998,12466
NC_035784.1,87959927,87979019,87961750,87979018,111137000,XM_022488224.1,uncharacterized LOC111137000,17268
NC_035784.1,87959927,87979019,87960932,87979019,111137000,XM_022488217.1,uncharacterized LOC111137000,18087
NC_035784.1,87959927,87979019,87959927,87979019,111137000,XM_022488221.1,uncharacterized LOC111137000,19092
NC_035784.1,8138073,8139297,8138073,8139297,111137003,XM_022488225.1,uncharacterized LOC111137003,1224
NC_035784.1,28869175,28870571,28869175,28870571,111137016,XM_022488237.1,uncharacterized LOC111137016,1396
NC_035784.1,8144993,8172200,8144993,8172200,111137020,XM_022488242.1,uncharacterized LOC111137020,27207
NC_035784.1,42794468,42797500,42794468,42797500,111137021,XM_022488243.1,uncharacterized LOC111137021,3032
NC_035784.1,13135947,13137740,13135947,13137740,111137024,XM_022488250.1,uncharacterized LOC111137024,1793
NC_035784.1,54265495,54271756,54265752,54271756,111137025,XM_022488252.1,uncharacterized LOC111137025,6004
NC_035784.1,54265495,54271756,54265495,54271756,111137025,XM_022488251.1,uncharacterized LOC111137025,6261
NC_035784.1,36818799,36822026,36818799,36822026,111137028,XM_022488254.1,uncharacterized LOC111137028,3227
NC_035784.1,8350749,8372150,8350749,8372150,111137029,XM_022488256.1,uncharacterized LOC111137029,21401
NC_035784.1,50649008,50651303,50649008,50651303,111137031,XM_022488258.1,uncharacterized LOC111137031,2295
NC_035784.1,91955612,91957941,91955612,91957941,111137034,XM_022488262.1,uncharacterized LOC111137034,2329
NC_035780.1,57109539,57116100,57109539,57116100,111137035,XM_022488266.1,uncharacterized LOC111137035,6561
NC_035784.1,87312782,87324780,87312782,87324780,111137036,XM_022488263.1,uncharacterized LOC111137036,11998
NC_035784.1,50981639,50989130,50981639,50989130,111137037,XM_022488264.1,uncharacterized LOC111137037,7491
NC_035784.1,10606607,10611878,10606607,10611878,111137039,XM_022488267.1,uncharacterized LOC111137039,5271
NC_035784.1,36657913,36674298,36657913,36674298,111137040,XM_022488268.1,uncharacterized LOC111137040,16385
NC_035784.1,76813652,76815475,76813652,76815475,111137045,XM_022488273.1,uncharacterized LOC111137045,1823
NC_035780.1,57120110,57135710,57120110,57135710,111137046,XM_022488277.1,uncharacterized LOC111137046,15600
NC_035784.1,39880543,39886985,39880543,39886559,111137047,XM_022488275.1,uncharacterized LOC111137047,6016
NC_035784.1,39880543,39886985,39880543,39886985,111137047,XM_022488274.1,uncharacterized LOC111137047,6442
NC_035784.1,2423734,2429319,2423734,2429319,111137049,XM_022488278.1,uncharacterized LOC111137049,5585
NC_035784.1,59719719,59764125,59719719,59731489,111137051,XM_022488279.1,uncharacterized LOC111137051,11770
NC_035784.1,59719719,59764125,59719719,59732112,111137051,XM_022488284.1,uncharacterized LOC111137051,12393
NC_035784.1,59719719,59764125,59719719,59733754,111137051,XM_022488281.1,uncharacterized LOC111137051,14035
NC_035784.1,59719719,59764125,59719719,59735380,111137051,XM_022488285.1,uncharacterized LOC111137051,15661
NC_035784.1,59719719,59764125,59719719,59744399,111137051,XM_022488280.1,uncharacterized LOC111137051,24680
NC_035784.1,59719719,59764125,59719719,59757767,111137051,XM_022488282.1,uncharacterized LOC111137051,38048
NC_035784.1,59719719,59764125,59719719,59764125,111137051,XM_022488283.1,uncharacterized LOC111137051,44406
NC_035784.1,54683998,54688460,54683998,54688460,111137054,XM_022488287.1,uncharacterized LOC111137054,4462
NC_035784.1,37914131,37926309,37914131,37926309,111137058,XM_022488293.1,uncharacterized LOC111137058,12178
NC_035784.1,55167899,55175909,55167923,55175909,111137061,XM_022488302.1,uncharacterized LOC111137061,7986
NC_035784.1,55167899,55175909,55167899,55175909,111137061,XM_022488303.1,uncharacterized LOC111137061,8010
NC_035784.1,30298719,30306634,30298719,30306634,111137066,XM_022488311.1,uncharacterized LOC111137066,7915
NC_035784.1,13140682,13143150,13140682,13143150,111137067,XM_022488312.1,uncharacterized LOC111137067,2468
NC_035784.1,63040317,63042167,63040317,63042167,111137069,XM_022488313.1,uncharacterized LOC111137069,1850
NC_035784.1,22394808,22435004,22394808,22435004,111137072,XM_022488317.1,uncharacterized LOC111137072,40196
NC_035784.1,38256762,38260711,38256762,38260711,111137074,XM_022488324.1,uncharacterized LOC111137074,3949
NC_035780.1,47265544,47273687,47265544,47273687,111137075,XM_022488327.1,uncharacterized LOC111137075,8143
NC_035784.1,37776386,37777641,37776393,37777641,111137081,XM_022488331.1,uncharacterized LOC111137081,1248
NC_035784.1,37776386,37777641,37776386,37777641,111137081,XM_022488332.1,uncharacterized LOC111137081,1255
NC_035784.1,21119631,21125469,21119631,21125469,111137084,XM_022488335.1,uncharacterized LOC111137084,5838
NC_035780.1,47263636,47265504,47263636,47265504,111137087,XM_022488342.1,uncharacterized LOC111137087,1868
NC_035784.1,58201985,58204063,58201985,58204063,111137088,XM_022488339.1,uncharacterized LOC111137088,2078
NC_035784.1,62942771,62944896,62942771,62944896,111137091,XM_022488343.1,uncharacterized LOC111137091,2125
NC_035780.1,56064472,56067917,56064472,56067917,111137095,XM_022488354.1,uncharacterized LOC111137095,3445
NC_035784.1,5252347,5256360,5252347,5256360,111137098,XM_022488356.1,uncharacterized LOC111137098,4013
NC_035780.1,58894932,58899778,58894932,58899778,111137100,XM_022488405.1,uncharacterized LOC111137100,4846
NC_035784.1,18087012,18090012,18087012,18090012,111137102,XM_022488359.1,uncharacterized LOC111137102,3000
NC_035784.1,55806672,55813155,55808170,55813155,111137107,XM_022488371.1,uncharacterized LOC111137107,4985
NC_035784.1,55806672,55813155,55806672,55813155,111137107,XM_022488370.1,uncharacterized LOC111137107,6483
NC_035784.1,8948612,8968386,8948612,8968386,111137108,XM_022488372.1,uncharacterized LOC111137108,19774
NC_035784.1,65586490,65588504,65586490,65588504,111137113,XM_022488404.1,uncharacterized LOC111137113,2014
NC_035784.1,73107445,73110175,73107445,73110175,111137115,XM_022488409.1,uncharacterized LOC111137115,2730
NC_035784.1,2891728,2899407,2891728,2899407,111137118,XM_022488414.1,uncharacterized LOC111137118,7679
NC_035784.1,64441854,64444404,64441854,64444404,111137121,XM_022488417.1,uncharacterized LOC111137121,2550
NC_035784.1,24440836,24483833,24440836,24483833,111137125,XM_022488421.1,uncharacterized LOC111137125,42997
NC_035784.1,33694394,33712103,33699298,33712103,111137127,XM_022488430.1,uncharacterized LOC111137127,12805
NC_035784.1,33694394,33712103,33695098,33712103,111137127,XM_022488429.1,uncharacterized LOC111137127,17005
NC_035784.1,33694394,33712103,33695097,33712103,111137127,XM_022488428.1,uncharacterized LOC111137127,17006
NC_035784.1,33694394,33712103,33694394,33712103,111137127,XM_022488426.1,uncharacterized LOC111137127,17709
NC_035780.1,28168300,28170663,28168300,28170663,111137128,XM_022488435.1,uncharacterized LOC111137128,2363
NC_035780.1,28170796,28173965,28170796,28173965,111137134,XM_022488449.1,uncharacterized LOC111137134,3169
NC_035784.1,13770619,13782243,13770619,13782243,111137135,XM_022488445.1,uncharacterized LOC111137135,11624
NC_035784.1,13713478,13717076,13713478,13717076,111137136,XM_022488448.1,uncharacterized LOC111137136,3598
NC_035784.1,13735366,13736537,13735366,13736537,111137137,XM_022488450.1,uncharacterized LOC111137137,1171
NC_035780.1,28173979,28178655,28173979,28178655,111137143,XM_022488459.1,uncharacterized LOC111137143,4676
NC_035784.1,19468471,19474600,19468471,19474600,111137157,XM_022488474.1,uncharacterized LOC111137157,6129
NC_035784.1,91020999,91024149,91020999,91024149,111137159,XM_022488476.1,uncharacterized LOC111137159,3150
NC_035784.1,3239743,3242430,3239777,3242430,111137160,XM_022488477.1,uncharacterized LOC111137160,2653
NC_035784.1,3239743,3242430,3239743,3242425,111137160,XM_022488478.1,uncharacterized LOC111137160,2682
NC_035784.1,1311973,1315703,1311973,1315703,111137161,XM_022488480.1,uncharacterized LOC111137161,3730
NC_035784.1,29333799,29338162,29333799,29338162,111137163,XM_022488483.1,uncharacterized LOC111137163,4363
NC_035784.1,53551399,53553709,53551399,53553709,111137164,XM_022488484.1,uncharacterized LOC111137164,2310
NC_035784.1,70947942,70957242,70947942,70957242,111137172,XM_022488494.1,uncharacterized LOC111137172,9300
NC_035784.1,75917797,75923062,75918572,75923061,111137175,XM_022488499.1,uncharacterized LOC111137175,4489
NC_035784.1,75917797,75923062,75917797,75923062,111137175,XM_022488498.1,uncharacterized LOC111137175,5265
NC_035784.1,934421,943739,934880,943739,111137177,XM_022488500.1,uncharacterized LOC111137177,8859
NC_035784.1,934421,943739,934421,943736,111137177,XM_022488501.1,uncharacterized LOC111137177,9315
NC_035784.1,9704804,9706141,9704804,9706141,111137188,XM_022488528.1,uncharacterized LOC111137188,1337
NC_035784.1,35519113,35530105,35519113,35530105,111137191,XM_022488535.1,uncharacterized LOC111137191,10992
NC_035784.1,40852517,40860312,40856012,40860312,111137192,XM_022488540.1,uncharacterized LOC111137192,4300
NC_035784.1,40852517,40860312,40855717,40860312,111137192,XM_022488541.1,uncharacterized LOC111137192,4595
NC_035784.1,40852517,40860312,40852839,40860312,111137192,XM_022488537.1,uncharacterized LOC111137192,7473
NC_035784.1,40852517,40860312,40852517,40860312,111137192,XM_022488536.1,uncharacterized LOC111137192,7795
NC_035784.1,9706721,9709091,9706721,9709091,111137195,XM_022488546.1,uncharacterized LOC111137195,2370
NC_035780.1,46330966,46339247,46330967,46339247,111137196,XM_022488557.1,uncharacterized LOC111137196,8280
NC_035780.1,46330966,46339247,46330966,46339247,111137196,XM_022488549.1,uncharacterized LOC111137196,8281
NC_035784.1,85086739,85090156,85086739,85090156,111137197,XM_022488547.1,uncharacterized LOC111137197,3417
NC_035784.1,85065149,85074037,85065150,85074037,111137198,XM_022488550.1,uncharacterized LOC111137198,8887
NC_035784.1,85065149,85074037,85065149,85074037,111137198,XM_022488548.1,uncharacterized LOC111137198,8888
NC_035784.1,85081878,85084713,85081878,85084713,111137199,XM_022488551.1,uncharacterized LOC111137199,2835
NC_035784.1,85043951,85060608,85043951,85060595,111137201,XM_022488554.1,uncharacterized LOC111137201,16644
NC_035784.1,85043951,85060608,85043951,85060608,111137201,XM_022488553.1,uncharacterized LOC111137201,16657
NC_035784.1,79248104,79251738,79248104,79251738,111137205,XM_022488559.1,uncharacterized LOC111137205,3634
NC_035784.1,78580989,78582958,78580989,78582958,111137209,XM_022488563.1,uncharacterized LOC111137209,1969
NC_035784.1,9850927,9853246,9850927,9853246,111137210,XM_022488564.1,uncharacterized LOC111137210,2319
NC_035780.1,46309953,46311779,46309953,46311779,111137211,XM_022488569.1,uncharacterized LOC111137211,1826
NC_035784.1,55512044,55515048,55512044,55515048,111137212,XM_022488565.1,uncharacterized LOC111137212,3004
NC_035784.1,52343844,52351001,52344940,52351001,111137227,XM_022488592.1,uncharacterized LOC111137227,6061
NC_035784.1,52343844,52351001,52343844,52351001,111137227,XM_022488591.1,uncharacterized LOC111137227,7157
NC_035784.1,9892856,9900830,9892856,9900830,111137231,XM_022488602.1,uncharacterized LOC111137231,7974
NC_035780.1,38130571,38134205,38130571,38134194,111137232,XM_022488606.1,uncharacterized LOC111137232,3623
NC_035780.1,38130571,38134205,38130571,38134205,111137232,XM_022488616.1,uncharacterized LOC111137232,3634
NC_035784.1,46267041,46273114,46267041,46273096,111137238,XM_022488615.1,uncharacterized LOC111137238,6055
NC_035784.1,46267041,46273114,46267041,46273114,111137238,XM_022488617.1,uncharacterized LOC111137238,6073
NC_035784.1,29344046,29351789,29344046,29351789,111137239,XM_022488618.1,uncharacterized LOC111137239,7743
NC_035784.1,29938821,29941321,29938821,29941321,111137240,XM_022488619.1,uncharacterized LOC111137240,2500
NC_035784.1,80902146,80905570,80902146,80905570,111137245,XM_022488625.1,uncharacterized LOC111137245,3424
NC_035784.1,9949029,9951206,9949029,9951206,111137246,XM_022488626.1,uncharacterized LOC111137246,2177
NC_035784.1,82647761,82681513,82647761,82681513,111137251,XM_022488638.1,uncharacterized LOC111137251,33752
NC_035784.1,82691560,82695797,82691560,82695797,111137253,XM_022488641.1,uncharacterized LOC111137253,4237
NC_035784.1,82651985,82654894,82651985,82654894,111137254,XM_022488642.1,uncharacterized LOC111137254,2909
NC_035784.1,84497503,84525730,84497503,84516628,111137262,XM_022488653.1,uncharacterized LOC111137262,19125
NC_035784.1,84497503,84525730,84497503,84525721,111137262,XM_022488654.1,uncharacterized LOC111137262,28218
NC_035784.1,12160863,12163063,12160863,12163063,111137269,XM_022488658.1,uncharacterized LOC111137269,2200
NC_035784.1,67721739,67724087,67721758,67724087,111137272,XM_022488668.1,uncharacterized LOC111137272,2329
NC_035784.1,67721739,67724087,67721739,67724087,111137272,XM_022488667.1,uncharacterized LOC111137272,2348
NC_035784.1,73130860,73136996,73130860,73136996,111137276,XM_022488673.1,uncharacterized LOC111137276,6136
NC_035784.1,75706422,75714085,75706422,75714085,111137281,XM_022488680.1,uncharacterized LOC111137281,7663
NC_035784.1,71416000,71421328,71416000,71421328,111137283,XM_022488685.1,uncharacterized LOC111137283,5328
NC_035784.1,22083202,22102198,22083202,22102198,111137294,XM_022488699.1,uncharacterized LOC111137294,18996
NC_035784.1,96171393,96174024,96171393,96174024,111137301,XM_022488716.1,uncharacterized LOC111137301,2631
NC_035784.1,9980644,9983184,9980644,9983184,111137304,XM_022488726.1,uncharacterized LOC111137304,2540
NC_035784.1,52679322,52681873,52679322,52681873,111137310,XM_022488739.1,uncharacterized LOC111137310,2551
NC_035784.1,52672259,52685694,52673421,52685694,111137311,XM_022488741.1,uncharacterized LOC111137311,12273
NC_035784.1,52672259,52685694,52672259,52685694,111137311,XM_022488740.1,uncharacterized LOC111137311,13435
NC_035784.1,46452560,46466332,46456176,46466332,111137312,XM_022488744.1,uncharacterized LOC111137312,10156
NC_035784.1,46452560,46466332,46452560,46466332,111137312,XM_022488742.1,uncharacterized LOC111137312,13772
NC_035784.1,92222317,92234287,92222317,92234287,111137321,XM_022488753.1,uncharacterized LOC111137321,11970
NC_035780.1,25981626,25992412,25981626,25992412,111137325,XM_022488766.1,uncharacterized LOC111137325,10786
NC_035780.1,25981626,25992412,25981626,25990046,111137325,XM_022488759.1,uncharacterized LOC111137325,8420
NC_035784.1,62841157,62847246,62841157,62847246,111137328,XM_022488760.1,uncharacterized LOC111137328,6089
NC_035784.1,43445200,43450223,43445200,43450223,111137331,XM_022488764.1,uncharacterized LOC111137331,5023
NC_035784.1,2721199,2724905,2721199,2724905,111137334,XM_022488769.1,uncharacterized LOC111137334,3706
NC_035784.1,24594197,24609902,24594197,24609902,111137335,XM_022488772.1,uncharacterized LOC111137335,15705
NC_035784.1,24594197,24609902,24603203,24609902,111137335,XM_022488770.1,uncharacterized LOC111137335,6699
NC_035784.1,24594197,24609902,24601325,24609902,111137335,XM_022488771.1,uncharacterized LOC111137335,8577
NC_035780.1,26020183,26022328,26020183,26022328,111137338,XM_022488778.1,uncharacterized LOC111137338,2145
NC_035784.1,2517990,2519775,2517990,2519775,111137339,XM_022488775.1,uncharacterized LOC111137339,1785
NC_035784.1,67184000,67188790,67184000,67188790,111137342,XM_022488779.1,uncharacterized LOC111137342,4790
NC_035780.1,26002736,26008041,26002736,26008041,111137348,XM_022488788.1,uncharacterized LOC111137348,5305
NC_035784.1,65189752,65192511,65189752,65192511,111137352,XM_022488794.1,uncharacterized LOC111137352,2759
NC_035784.1,10456956,10462647,10456956,10462647,111137353,XM_022488795.1,uncharacterized LOC111137353,5691
NC_035784.1,45092280,45094938,45092280,45094938,111137369,XM_022488805.1,uncharacterized LOC111137369,2658
NC_035784.1,2191076,2198601,2191098,2198601,111137375,XM_022488813.1,uncharacterized LOC111137375,7503
NC_035784.1,42222076,42241037,42222076,42236450,111137380,XM_022488822.1,uncharacterized LOC111137380,14374
NC_035784.1,42222076,42241037,42222076,42236493,111137380,XM_022488818.1,uncharacterized LOC111137380,14417
NC_035784.1,42222076,42241037,42222076,42236514,111137380,XM_022488819.1,uncharacterized LOC111137380,14438
NC_035784.1,42222076,42241037,42222076,42240962,111137380,XM_022488820.1,uncharacterized LOC111137380,18886
NC_035784.1,42222076,42241037,42222076,42241037,111137380,XM_022488821.1,uncharacterized LOC111137380,18961
NC_035784.1,42222076,42241037,42222076,42232053,111137380,XM_022488824.1,uncharacterized LOC111137380,9977
NC_035784.1,23059323,23063340,23059323,23063340,111137386,XM_022488829.1,uncharacterized LOC111137386,4017
NC_035784.1,23250181,23254121,23250181,23254121,111137388,XM_022488830.1,uncharacterized LOC111137388,3940
NC_035784.1,23211034,23222185,23211034,23222185,111137390,XM_022488833.1,uncharacterized LOC111137390,11151
NC_035784.1,23049350,23051079,23049350,23051079,111137408,XM_022488855.1,uncharacterized LOC111137408,1729
NC_035784.1,41402987,41412917,41402987,41404889,111137409,XM_022488861.1,uncharacterized LOC111137409,1902
NC_035784.1,41402987,41412917,41402987,41407608,111137409,XM_022488859.1,uncharacterized LOC111137409,4621
NC_035784.1,41402987,41412917,41402987,41412917,111137409,XM_022488860.1,uncharacterized LOC111137409,9930
NC_035784.1,28497865,28501689,28497865,28501689,111137416,XM_022488867.1,uncharacterized LOC111137416,3824
NC_035784.1,64216594,64220075,64216594,64220075,111137429,XM_022488880.1,uncharacterized LOC111137429,3481
NC_035784.1,2131902,2137665,2132737,2137657,111137430,XM_022488882.1,uncharacterized LOC111137430,4920
NC_035784.1,2131902,2137665,2132736,2137658,111137430,XM_022488883.1,uncharacterized LOC111137430,4922
NC_035784.1,2131902,2137665,2131902,2137665,111137430,XM_022488881.1,uncharacterized LOC111137430,5763
NC_035784.1,51068240,51079722,51068240,51079722,111137433,XM_022488885.1,uncharacterized LOC111137433,11482
NC_035780.1,17666778,17668897,17666778,17668897,111137438,XM_022488898.1,uncharacterized LOC111137438,2119
NC_035784.1,81503044,81511376,81503044,81511376,111137442,XM_022488905.1,uncharacterized LOC111137442,8332
NC_035784.1,81494098,81498310,81494098,81498310,111137443,XM_022488906.1,uncharacterized LOC111137443,4212
NC_035780.1,34007236,34011449,34007236,34011449,111137444,XM_022488909.1,uncharacterized LOC111137444,4213
NC_035784.1,81522873,81535911,81522873,81535911,111137445,XM_022488907.1,uncharacterized LOC111137445,13038
NC_035784.1,9853916,9878153,9853916,9878153,111137448,XM_022488910.1,uncharacterized LOC111137448,24237
NC_035780.1,33995805,34006771,33995805,34006771,111137455,XM_022488922.1,uncharacterized LOC111137455,10966
NC_035784.1,59326293,59329417,59326293,59329417,111137457,XM_022488921.1,uncharacterized LOC111137457,3124
NC_035784.1,53633903,53640094,53633903,53640094,111137459,XM_022488923.1,uncharacterized LOC111137459,6191
NC_035780.1,10930684,10945734,10930684,10945703,111137464,XM_022488941.1,uncharacterized LOC111137464,15019
NC_035784.1,90847931,90850282,90847931,90850282,111137468,XM_022488931.1,uncharacterized LOC111137468,2351
NC_035784.1,90857844,90859529,90857844,90859529,111137469,XM_022488932.1,uncharacterized LOC111137469,1685
NC_035784.1,90886080,90909406,90886080,90909406,111137470,XM_022488933.1,uncharacterized LOC111137470,23326
NC_035784.1,90833339,90853236,90834362,90851364,111137471,XM_022488934.1,uncharacterized LOC111137471,17002
NC_035784.1,10603082,10605849,10603082,10605849,111137479,XM_022488944.1,uncharacterized LOC111137479,2767
NC_035784.1,77550992,77558375,77550992,77558375,111137480,XM_022488945.1,uncharacterized LOC111137480,7383
NC_035784.1,39365107,39376936,39365107,39376936,111137481,XM_022488947.1,uncharacterized LOC111137481,11829
NC_035784.1,60105617,60106571,60105617,60106571,111137484,XM_022488949.1,uncharacterized LOC111137484,954
NC_035784.1,53777873,53793318,53777928,53793318,111137487,XM_022488953.1,uncharacterized LOC111137487,15390
NC_035784.1,53777873,53793318,53777873,53781789,111137487,XM_022488955.1,uncharacterized LOC111137487,3916
NC_035784.1,53777873,53793318,53787753,53793245,111137487,XM_022488954.1,uncharacterized LOC111137487,5492
NC_035784.1,75208112,75211313,75208991,75211313,111137490,XM_022488959.1,uncharacterized LOC111137490,2322
NC_035784.1,75208112,75211313,75208117,75211313,111137490,XM_022488960.1,uncharacterized LOC111137490,3196
NC_035784.1,75208112,75211313,75208112,75211313,111137490,XM_022488958.1,uncharacterized LOC111137490,3201
NC_035784.1,78096068,78099255,78096068,78099255,111137497,XM_022488969.1,uncharacterized LOC111137497,3187
NC_035784.1,49441833,49447018,49441833,49447018,111137500,XM_022488970.1,uncharacterized LOC111137500,5185
NC_035784.1,49423061,49427311,49423061,49427311,111137501,XM_022488971.1,uncharacterized LOC111137501,4250
NC_035780.1,10923734,10930509,10923734,10930509,111137504,XM_022488976.1,uncharacterized LOC111137504,6775
NC_035784.1,58649714,58662229,58649714,58662229,111137507,XM_022488975.1,uncharacterized LOC111137507,12515
NC_035784.1,38484687,38487275,38484687,38487275,111137509,XM_022488978.1,uncharacterized LOC111137509,2588
NC_035784.1,37804597,37844064,37813549,37844064,111137511,XM_022488984.1,uncharacterized LOC111137511,30515
NC_035784.1,37804597,37844064,37813461,37844064,111137511,XM_022488988.1,uncharacterized LOC111137511,30603
NC_035784.1,37804597,37844064,37813422,37844064,111137511,XM_022488987.1,uncharacterized LOC111137511,30642
NC_035784.1,37804597,37844064,37804598,37844064,111137511,XM_022488982.1,uncharacterized LOC111137511,39466
NC_035784.1,37804597,37844064,37804597,37844064,111137511,XM_022488983.1,uncharacterized LOC111137511,39467
NC_035784.1,37804597,37844064,37837906,37844064,111137511,XM_022488986.1,uncharacterized LOC111137511,6158
NC_035784.1,37808698,37811207,37808698,37811207,111137513,XM_022488989.1,uncharacterized LOC111137513,2509
NC_035784.1,37826048,37830079,37826048,37830079,111137515,XM_022488991.1,uncharacterized LOC111137515,4031
NC_035784.1,37821727,37823586,37821727,37823586,111137516,XM_022488992.1,uncharacterized LOC111137516,1859
NC_035784.1,2277652,2283808,2277652,2283808,111137528,XM_022489001.1,uncharacterized LOC111137528,6156
NC_035784.1,2284001,2293709,2284001,2293709,111137529,XM_022489002.1,uncharacterized LOC111137529,9708
NC_035784.1,34071040,34075919,34071040,34075919,111137531,XM_022489004.1,uncharacterized LOC111137531,4879
NC_035784.1,40878590,40911921,40878590,40911921,111137532,XM_022489005.1,uncharacterized LOC111137532,33331
NC_035784.1,49305293,49316234,49305293,49316234,111137534,XM_022489009.1,uncharacterized LOC111137534,10941
NC_035784.1,53420037,53424517,53420037,53422927,111137538,XM_022489020.1,uncharacterized LOC111137538,2890
NC_035784.1,53420037,53424517,53420037,53424019,111137538,XM_022489021.1,uncharacterized LOC111137538,3982
NC_035784.1,53420037,53424517,53420037,53424517,111137538,XM_022489019.1,uncharacterized LOC111137538,4480
NC_035784.1,60150620,60153518,60150620,60153518,111137539,XM_022489022.1,uncharacterized LOC111137539,2898
NC_035784.1,11042765,11046400,11042765,11046400,111137545,XM_022489029.1,uncharacterized LOC111137545,3635
NC_035784.1,58853606,58855506,58853606,58855506,111137549,XM_022489033.1,uncharacterized LOC111137549,1900
NC_035784.1,73941946,73944283,73941946,73943432,111137554,XM_022489046.1,uncharacterized LOC111137554,1486
NC_035784.1,73941946,73944283,73941946,73943938,111137554,XM_022489047.1,uncharacterized LOC111137554,1992
NC_035784.1,73941946,73944283,73941946,73944282,111137554,XM_022489048.1,uncharacterized LOC111137554,2336
NC_035784.1,73941946,73944283,73941946,73944283,111137554,XM_022489049.1,uncharacterized LOC111137554,2337
NC_035784.1,11093123,11095956,11093123,11095955,111137557,XM_022489052.1,uncharacterized LOC111137557,2832
NC_035784.1,11093123,11095956,11093123,11095956,111137557,XM_022489054.1,uncharacterized LOC111137557,2833
NC_035780.1,6979148,6990391,6979155,6990391,111137561,XM_022489070.1,uncharacterized LOC111137561,11236
NC_035780.1,6979148,6990391,6979148,6990389,111137561,XM_022489061.1,uncharacterized LOC111137561,11241
NC_035784.1,11096370,11097630,11096370,11097630,111137563,XM_022489059.1,uncharacterized LOC111137563,1260
NC_035784.1,22367057,22383339,22367057,22383339,111137564,XM_022489060.1,uncharacterized LOC111137564,16282
NC_035784.1,22384653,22389077,22384653,22389077,111137565,XM_022489062.1,uncharacterized LOC111137565,4424
NC_035784.1,38507381,38533204,38507381,38533204,111137568,XM_022489071.1,uncharacterized LOC111137568,25823
NC_035784.1,38507381,38533204,38524589,38533204,111137568,XM_022489067.1,uncharacterized LOC111137568,8615
NC_035780.1,25956672,25961772,25956672,25960015,111137575,XM_022489083.1,uncharacterized LOC111137575,3343
NC_035780.1,25956672,25961772,25956672,25960210,111137575,XM_022489108.1,uncharacterized LOC111137575,3538
NC_035780.1,25956672,25961772,25956672,25961771,111137575,XM_022489091.1,uncharacterized LOC111137575,5099
NC_035780.1,25956672,25961772,25956672,25961772,111137575,XM_022489099.1,uncharacterized LOC111137575,5100
NC_035784.1,11116137,11127952,11116137,11127952,111137578,XM_022489087.1,uncharacterized LOC111137578,11815
NC_035784.1,27446949,27462146,27446949,27462146,111137580,XM_022489089.1,uncharacterized LOC111137580,15197
NC_035784.1,11135069,11136260,11135069,11136260,111137584,XM_022489096.1,uncharacterized LOC111137584,1191
NC_035784.1,42510734,42532193,42510734,42532193,111137586,XM_022489098.1,uncharacterized LOC111137586,21459
NC_035784.1,42538630,42546393,42541337,42546387,111137587,XM_022489102.1,uncharacterized LOC111137587,5050
NC_035784.1,42538630,42546393,42538630,42546393,111137587,XM_022489100.1,uncharacterized LOC111137587,7763
NC_035784.1,67905956,67916815,67905962,67916815,111137593,XM_022489113.1,uncharacterized LOC111137593,10853
NC_035784.1,67905956,67916815,67905956,67916815,111137593,XM_022489112.1,uncharacterized LOC111137593,10859
NC_035784.1,4899807,4904615,4899809,4904615,111137599,XM_022489120.1,uncharacterized LOC111137599,4806
NC_035784.1,4899807,4904615,4899807,4904615,111137599,XM_022489121.1,uncharacterized LOC111137599,4808
NC_035784.1,3426251,3446999,3427219,3446980,111137602,XM_022489128.1,uncharacterized LOC111137602,19761
NC_035784.1,3426251,3446999,3427219,3446981,111137602,XM_022489129.1,uncharacterized LOC111137602,19762
NC_035784.1,3426251,3446999,3427219,3446983,111137602,XM_022489126.1,uncharacterized LOC111137602,19764
NC_035784.1,3426251,3446999,3427219,3446999,111137602,XM_022489130.1,uncharacterized LOC111137602,19780
NC_035784.1,3426251,3446999,3426251,3446980,111137602,XM_022489125.1,uncharacterized LOC111137602,20729
NC_035784.1,71605106,71616741,71605106,71616741,111137604,XM_022489133.1,uncharacterized LOC111137604,11635
NC_035784.1,11933521,11936209,11933521,11936209,111137606,XM_022489135.1,uncharacterized LOC111137606,2688
NC_035780.1,9014476,9020599,9014477,9020599,111137607,XM_022489139.1,uncharacterized LOC111137607,6122
NC_035780.1,9014476,9020599,9014476,9020599,111137607,XM_022489149.1,uncharacterized LOC111137607,6123
NC_035784.1,88636116,88638077,88636116,88638077,111137608,XM_022489136.1,uncharacterized LOC111137608,1961
NC_035784.1,55752780,55758451,55752780,55758451,111137613,XM_022489147.1,uncharacterized LOC111137613,5671
NC_035784.1,49193403,49220301,49193403,49220196,111137616,XM_022489153.1,uncharacterized LOC111137616,26793
NC_035784.1,49193403,49220301,49193403,49220301,111137616,XM_022489152.1,uncharacterized LOC111137616,26898
NC_035780.1,9067862,9076213,9067862,9076213,111137619,XM_022489162.1,uncharacterized LOC111137619,8351
NC_035784.1,11963176,11967287,11963176,11967287,111137620,XM_022489159.1,uncharacterized LOC111137620,4111
NC_035784.1,52094886,52103868,52094886,52103868,111137621,XM_022489160.1,uncharacterized LOC111137621,8982
NC_035784.1,82727458,82747521,82727458,82747521,111137624,XM_022489165.1,uncharacterized LOC111137624,20063
NC_035784.1,65369937,65372473,65369937,65372473,111137626,XM_022489167.1,uncharacterized LOC111137626,2536
NC_035784.1,81191592,81194562,81191592,81194562,111137628,XM_022489169.1,uncharacterized LOC111137628,2970
NC_035784.1,73486906,73490962,73486906,73490766,111137633,XM_022489182.1,uncharacterized LOC111137633,3860
NC_035784.1,73486906,73490962,73486906,73490962,111137633,XM_022489181.1,uncharacterized LOC111137633,4056
NC_035784.1,73482625,73484682,73482625,73484682,111137634,XM_022489183.1,uncharacterized LOC111137634,2057
NC_035784.1,10646463,10653592,10646463,10653592,111137637,XM_022489187.1,uncharacterized LOC111137637,7129
NC_035784.1,65418038,65421774,65418038,65421774,111137646,XM_022489198.1,uncharacterized LOC111137646,3736
NC_035784.1,26011798,26013721,26011798,26013721,111137653,XM_022489209.1,uncharacterized LOC111137653,1923
NC_035784.1,4167051,4197059,4174147,4197059,111137658,XM_022489221.1,uncharacterized LOC111137658,22912
NC_035784.1,4167051,4197059,4167051,4197059,111137658,XM_022489219.1,uncharacterized LOC111137658,30008
NC_035780.1,60703017,60730024,60703017,60728168,111137665,XM_022489353.1,uncharacterized LOC111137665,25151
NC_035780.1,60703017,60730024,60703017,60730024,111137665,XM_022489270.1,uncharacterized LOC111137665,27007
NC_035784.1,42433047,42455324,42433047,42446141,111137667,XM_022489239.1,uncharacterized LOC111137667,13094
NC_035784.1,42433047,42455324,42433047,42454602,111137667,XM_022489235.1,uncharacterized LOC111137667,21555
NC_035784.1,42433047,42455324,42433047,42454609,111137667,XM_022489233.1,uncharacterized LOC111137667,21562
NC_035784.1,42433047,42455324,42433047,42455306,111137667,XM_022489234.1,uncharacterized LOC111137667,22259
NC_035784.1,42433047,42455324,42433047,42455324,111137667,XM_022489236.1,uncharacterized LOC111137667,22277
NC_035784.1,42433047,42455324,42433047,42439245,111137667,XM_022489241.1,uncharacterized LOC111137667,6198
NC_035784.1,42433047,42455324,42433047,42439246,111137667,XM_022489237.1,uncharacterized LOC111137667,6199
NC_035784.1,28667108,28669292,28667113,28669292,111137671,XM_022489245.1,uncharacterized LOC111137671,2179
NC_035784.1,28675630,28676920,28675630,28676920,111137672,XM_022489246.1,uncharacterized LOC111137672,1290
NC_035784.1,12230122,12231641,12230122,12231641,111137673,XM_022489247.1,uncharacterized LOC111137673,1519
NC_035784.1,1957783,1979155,1957783,1979155,111137676,XM_022489249.1,uncharacterized LOC111137676,21372
NC_035784.1,1830629,1834851,1830629,1834851,111137683,XM_022489265.1,uncharacterized LOC111137683,4222
NC_035784.1,1900170,1904624,1900170,1904624,111137686,XM_022489269.1,uncharacterized LOC111137686,4454
NC_035784.1,1835140,1840216,1835140,1840216,111137691,XM_022489277.1,uncharacterized LOC111137691,5076
NC_035784.1,45141254,45142482,45141254,45142482,111137694,XM_022489282.1,uncharacterized LOC111137694,1228
NC_035784.1,2463158,2471675,2463158,2471675,111137696,XM_022489289.1,uncharacterized LOC111137696,8517
NC_035784.1,88707591,88710030,88707591,88710030,111137700,XM_022489292.1,uncharacterized LOC111137700,2439
NC_035784.1,10137235,10156777,10138206,10156777,111137701,XM_022489294.1,uncharacterized LOC111137701,18571
NC_035784.1,10137235,10156777,10137235,10156777,111137701,XM_022489293.1,uncharacterized LOC111137701,19542
NC_035784.1,61562374,61566378,61562374,61566378,111137705,XM_022489305.1,uncharacterized LOC111137705,4004
NC_035784.1,43690334,43692187,43690764,43692187,111137708,XM_022489310.1,uncharacterized LOC111137708,1423
NC_035784.1,43690334,43692187,43690690,43692187,111137708,XM_022489311.1,uncharacterized LOC111137708,1497
NC_035784.1,43690334,43692187,43690334,43692187,111137708,XM_022489312.1,uncharacterized LOC111137708,1853
NC_035784.1,4523417,4528559,4523417,4528559,111137709,XM_022489316.1,uncharacterized LOC111137709,5142
NC_035784.1,2823329,2824880,2823329,2824880,111137718,XM_022489331.1,uncharacterized LOC111137718,1551
NC_035784.1,67364550,67375912,67364550,67375912,111137726,XM_022489338.1,uncharacterized LOC111137726,11362
NC_035780.1,23474882,23476245,23474882,23476245,111137728,XM_022489747.1,uncharacterized LOC111137728,1363
NC_035780.1,26551020,26553042,26551020,26553042,111137729,XM_022489357.1,uncharacterized LOC111137729,2022
NC_035784.1,90781399,90786360,90781399,90786360,111137732,XM_022489358.1,uncharacterized LOC111137732,4961
NC_035784.1,12505109,12513287,12505109,12513287,111137733,XM_022489359.1,uncharacterized LOC111137733,8178
NC_035784.1,96944253,96946218,96944253,96946218,111137735,XM_022489361.1,uncharacterized LOC111137735,1965
NC_035784.1,96935446,96952687,96935446,96952672,111137736,XM_022489364.1,uncharacterized LOC111137736,17226
NC_035784.1,96935446,96952687,96935446,96952687,111137736,XM_022489362.1,uncharacterized LOC111137736,17241
NC_035784.1,96935446,96952687,96935446,96940405,111137736,XM_022489363.1,uncharacterized LOC111137736,4959
NC_035784.1,55297009,55301066,55297009,55301066,111137737,XM_022489365.1,uncharacterized LOC111137737,4057
NC_035784.1,39349972,39353636,39349972,39353636,111137739,XM_022489366.1,uncharacterized LOC111137739,3664
NC_035784.1,28641051,28644551,28642861,28644551,111137742,XM_022489372.1,uncharacterized LOC111137742,1690
NC_035784.1,28641051,28644551,28641051,28644551,111137742,XM_022489371.1,uncharacterized LOC111137742,3500
NC_035784.1,80876829,80883669,80876829,80883669,111137749,XM_022489382.1,uncharacterized LOC111137749,6840
NC_035784.1,80570725,80581480,80570725,80581480,111137753,XM_022489387.1,uncharacterized LOC111137753,10755
NC_035784.1,80583312,80587710,80583312,80587710,111137754,XM_022489389.1,uncharacterized LOC111137754,4398
NC_035784.1,33110376,33125380,33114560,33125380,111137762,XM_022489398.1,uncharacterized LOC111137762,10820
NC_035784.1,33110376,33125380,33110376,33125380,111137762,XM_022489397.1,uncharacterized LOC111137762,15004
NC_035784.1,33110376,33125380,33118561,33125380,111137762,XM_022489399.1,uncharacterized LOC111137762,6819
NC_035784.1,56388134,56391765,56388134,56391765,111137767,XM_022489407.1,uncharacterized LOC111137767,3631
NC_035784.1,70896969,70900624,70896969,70900624,111137772,XM_022489416.1,uncharacterized LOC111137772,3655
NC_035784.1,21116137,21118401,21116410,21118401,111137773,XM_022489418.1,uncharacterized LOC111137773,1991
NC_035784.1,21116137,21118401,21116137,21118389,111137773,XM_022489417.1,uncharacterized LOC111137773,2252
NC_035784.1,57895144,57898907,57895144,57898907,111137774,XM_022489419.1,uncharacterized LOC111137774,3763
NC_035784.1,68648389,68650428,68648389,68650428,111137778,XM_022489424.1,uncharacterized LOC111137778,2039
NC_035784.1,79599385,79616750,79599385,79611210,111137780,XM_022489427.1,uncharacterized LOC111137780,11825
NC_035784.1,79599385,79616750,79599385,79616750,111137780,XM_022489426.1,uncharacterized LOC111137780,17365
NC_035784.1,71745907,71749653,71745907,71749653,111137783,XM_022489430.1,uncharacterized LOC111137783,3746
NC_035784.1,75217695,75224068,75217701,75224068,111137784,XM_022489432.1,uncharacterized LOC111137784,6367
NC_035784.1,75217695,75224068,75217700,75224068,111137784,XM_022489433.1,uncharacterized LOC111137784,6368
NC_035784.1,75217695,75224068,75217695,75224066,111137784,XM_022489434.1,uncharacterized LOC111137784,6371
NC_035780.1,60619643,60629752,60619643,60629752,111137785,XM_022489469.1,uncharacterized LOC111137785,10109
NC_035784.1,14286230,14290808,14286230,14290808,111137787,XM_022489437.1,uncharacterized LOC111137787,4578
NC_035784.1,62579282,62588425,62585373,62588425,111137788,XM_022489439.1,uncharacterized LOC111137788,3052
NC_035784.1,62579282,62588425,62579282,62588425,111137788,XM_022489438.1,uncharacterized LOC111137788,9143
NC_035784.1,62588414,62590730,62588414,62590730,111137789,XM_022489441.1,uncharacterized LOC111137789,2316
NC_035784.1,38434530,38444989,38434530,38444989,111137792,XM_022489443.1,uncharacterized LOC111137792,10459
NC_035784.1,74901290,74925535,74901290,74925535,111137795,XM_022489446.1,uncharacterized LOC111137795,24245
NC_035784.1,22673602,22674605,22673602,22674605,111137799,XM_022489451.1,uncharacterized LOC111137799,1003
NC_035784.1,61300384,61314663,61301272,61314663,111137804,XM_022489455.1,uncharacterized LOC111137804,13391
NC_035784.1,61300384,61314663,61300384,61314663,111137804,XM_022489457.1,uncharacterized LOC111137804,14279
NC_035780.1,6221881,6223144,6221881,6223144,111137805,XM_022489461.1,uncharacterized LOC111137805,1263
NC_035784.1,47319137,47347353,47324123,47347353,111137806,XM_022489459.1,uncharacterized LOC111137806,23230
NC_035784.1,47319137,47347353,47319256,47347353,111137806,XM_022489460.1,uncharacterized LOC111137806,28097
NC_035784.1,47319137,47347353,47319137,47347353,111137806,XM_022489458.1,uncharacterized LOC111137806,28216
NC_035784.1,58515189,58528882,58515189,58528873,111137807,XM_022489463.1,uncharacterized LOC111137807,13684
NC_035784.1,58515189,58528882,58515189,58528882,111137807,XM_022489462.1,uncharacterized LOC111137807,13693
NC_035784.1,13022509,13034209,13022509,13034209,111137814,XM_022489471.1,uncharacterized LOC111137814,11700
NC_035784.1,62385108,62397370,62385109,62397172,111137822,XM_022489486.1,uncharacterized LOC111137822,12063
NC_035784.1,62385108,62397370,62385108,62397370,111137822,XM_022489487.1,uncharacterized LOC111137822,12262
NC_035780.1,7448379,7460184,7448379,7460184,111137826,XM_022489514.1,uncharacterized LOC111137826,11805
NC_035784.1,62493851,62501612,62493851,62500639,111137828,XM_022489511.1,uncharacterized LOC111137828,6788
NC_035784.1,62493851,62501612,62493851,62501612,111137828,XM_022489512.1,uncharacterized LOC111137828,7761
NC_035784.1,62486399,62503106,62486399,62503106,111137829,XM_022489513.1,uncharacterized LOC111137829,16707
NC_035784.1,22682954,22704393,22682954,22704393,111137830,XM_022489516.1,uncharacterized LOC111137830,21439
NC_035784.1,46846086,46860687,46849737,46859984,111137831,XM_022489520.1,uncharacterized LOC111137831,10247
NC_035784.1,46846086,46860687,46846086,46856376,111137831,XM_022489518.1,uncharacterized LOC111137831,10290
NC_035784.1,46846086,46860687,46849054,46859984,111137831,XM_022489519.1,uncharacterized LOC111137831,10930
NC_035784.1,46846086,46860687,46846086,46860687,111137831,XM_022489517.1,uncharacterized LOC111137831,14601
NC_035784.1,46846086,46860687,46850198,46859984,111137831,XM_022489521.1,uncharacterized LOC111137831,9786
NC_035780.1,7440146,7448256,7440146,7448256,111137833,XM_022489527.1,uncharacterized LOC111137833,8110
NC_035784.1,32103451,32106172,32103778,32106172,111137838,XM_022489530.1,uncharacterized LOC111137838,2394
NC_035784.1,32103451,32106172,32103451,32106172,111137838,XM_022489531.1,uncharacterized LOC111137838,2721
NC_035784.1,13824806,13836847,13825271,13836847,111137839,XM_022489532.1,uncharacterized LOC111137839,11576
NC_035784.1,13824806,13836847,13824806,13836847,111137839,XM_022489534.1,uncharacterized LOC111137839,12041
NC_035784.1,10710124,10711212,10710124,10711212,111137844,XM_022489537.1,uncharacterized LOC111137844,1088
NC_035784.1,80128720,80135178,80128720,80135178,111137845,XM_022489539.1,uncharacterized LOC111137845,6458
NC_035784.1,13721496,13726574,13721496,13726574,111137846,XM_022489540.1,uncharacterized LOC111137846,5078
NC_035784.1,21138589,21142632,21138589,21142632,111137848,XM_022489542.1,uncharacterized LOC111137848,4043
NC_035784.1,95256417,95258106,95256417,95258106,111137849,XM_022489543.1,uncharacterized LOC111137849,1689
NC_035784.1,95234435,95236208,95234435,95236208,111137850,XM_022489544.1,uncharacterized LOC111137850,1773
NC_035784.1,95268891,95270766,95268891,95270766,111137852,XM_022489545.1,uncharacterized LOC111137852,1875
NC_035784.1,61859045,61860005,61859045,61860005,111137856,XM_022489552.1,uncharacterized LOC111137856,960
NC_035784.1,60664219,60671057,60664219,60671057,111137859,XM_022489555.1,uncharacterized LOC111137859,6838
NC_035784.1,60671130,60674870,60671130,60674870,111137860,XM_022489556.1,uncharacterized LOC111137860,3740
NC_035784.1,13757655,13762772,13757655,13762772,111137866,XM_022489560.1,uncharacterized LOC111137866,5117
NC_035784.1,34093504,34097757,34093504,34097757,111137867,XM_022489561.1,uncharacterized LOC111137867,4253
NC_035784.1,27377815,27383051,27377815,27383051,111137870,XM_022489564.1,uncharacterized LOC111137870,5236
NC_035784.1,80712565,80725522,80712565,80725522,111137871,XM_022489565.1,uncharacterized LOC111137871,12957
NC_035784.1,90559287,90561882,90559287,90561882,111137872,XM_022489567.1,uncharacterized LOC111137872,2595
NC_035784.1,13791413,13793278,13791413,13793278,111137873,XM_022489568.1,uncharacterized LOC111137873,1865
NC_035784.1,42093372,42127854,42093372,42127854,111137876,XM_022489572.1,uncharacterized LOC111137876,34482
NC_035784.1,13811368,13814556,13811368,13814556,111137879,XM_022489575.1,uncharacterized LOC111137879,3188
NC_035784.1,474833,489812,474833,489812,111137881,XM_022489578.1,uncharacterized LOC111137881,14979
NC_035784.1,2637721,2640235,2637721,2640235,111137884,XM_022489579.1,uncharacterized LOC111137884,2514
NC_035784.1,2640428,2642362,2640428,2642362,111137885,XM_022489580.1,uncharacterized LOC111137885,1934
NC_035784.1,53800025,53805180,53800025,53805180,111137887,XM_022489582.1,uncharacterized LOC111137887,5155
NC_035784.1,72990654,72996428,72990654,72995926,111137891,XM_022489587.1,uncharacterized LOC111137891,5272
NC_035784.1,72990654,72996428,72990654,72996428,111137891,XM_022489590.1,uncharacterized LOC111137891,5774
NC_035784.1,22763099,22765651,22763099,22765651,111137892,XM_022489591.1,uncharacterized LOC111137892,2552
NC_035780.1,44438201,44439980,44438201,44439980,111137894,XM_022489596.1,uncharacterized LOC111137894,1779
NC_035784.1,7398274,7402315,7398274,7402315,111137896,XM_022489595.1,uncharacterized LOC111137896,4041
NC_035784.1,12232201,12236113,12232201,12236113,111137899,XM_022489601.1,uncharacterized LOC111137899,3912
NC_035780.1,44426302,44428229,44426302,44428229,111137902,XM_022489609.1,uncharacterized LOC111137902,1927
NC_035784.1,43155376,43170178,43155376,43170178,111137904,XM_022489608.1,uncharacterized LOC111137904,14802
NC_035784.1,43155376,43170178,43155376,43158639,111137904,XM_022489607.1,uncharacterized LOC111137904,3263
NC_035784.1,19833034,19836099,19833034,19836099,111137910,XM_022489614.1,uncharacterized LOC111137910,3065
NC_035780.1,44440597,44456669,44440597,44456669,111137912,XM_022489619.1,uncharacterized LOC111137912,16072
NC_035784.1,32492460,32495957,32492460,32495957,111137914,XM_022489617.1,uncharacterized LOC111137914,3497
NC_035784.1,33944490,33946035,33944490,33946035,111137917,XM_022489620.1,uncharacterized LOC111137917,1545
NC_035784.1,14302266,14306224,14302266,14306224,111137918,XM_022489621.1,uncharacterized LOC111137918,3958
NC_035784.1,89682043,89684118,89682043,89684118,111137919,XM_022489622.1,uncharacterized LOC111137919,2075
NC_035784.1,87291271,87295333,87291271,87295333,111137923,XM_022489625.1,uncharacterized LOC111137923,4062
NC_035780.1,44428911,44433491,44428911,44433491,111137924,XM_022489629.1,uncharacterized LOC111137924,4580
NC_035784.1,14680638,14752175,14680638,14752175,111137932,XM_022489636.1,uncharacterized LOC111137932,71537
NC_035784.1,25686428,25687840,25686428,25687840,111137935,XM_022489639.1,uncharacterized LOC111137935,1412
NC_035784.1,10422293,10423025,10422293,10423013,111137938,XM_022489649.1,uncharacterized LOC111137938,720
NC_035784.1,10422293,10423025,10422293,10423025,111137938,XM_022489648.1,uncharacterized LOC111137938,732
NC_035784.1,68283783,68290444,68283783,68290426,111137945,XM_022489662.1,uncharacterized LOC111137945,6643
NC_035784.1,68283783,68290444,68283783,68290444,111137945,XM_022489661.1,uncharacterized LOC111137945,6661
NC_035784.1,87003761,87020245,87003761,87020245,111137950,XM_022489681.1,uncharacterized LOC111137950,16484
NC_035784.1,15427449,15429954,15427449,15429954,111137953,XM_022489683.1,uncharacterized LOC111137953,2505
NC_035784.1,47417767,47422346,47417767,47422298,111137955,XM_022489685.1,uncharacterized LOC111137955,4531
NC_035784.1,47417767,47422346,47417767,47422346,111137955,XM_022489686.1,uncharacterized LOC111137955,4579
NC_035780.1,53204527,53210264,53204527,53210264,111137956,XM_022489689.1,uncharacterized LOC111137956,5737
NC_035780.1,37126403,37134919,37126403,37134919,111137970,XM_022489709.1,uncharacterized LOC111137970,8516
NC_035784.1,25082208,25093309,25082208,25093309,111137971,XM_022489705.1,uncharacterized LOC111137971,11101
NC_035784.1,25082208,25093309,25082208,25091972,111137971,XM_022489704.1,uncharacterized LOC111137971,9764
NC_035784.1,35383142,35386526,35383142,35386526,111137977,XM_022489714.1,uncharacterized LOC111137977,3384
NC_035784.1,90528749,90543327,90528749,90543253,111137981,XM_022489718.1,uncharacterized LOC111137981,14504
NC_035784.1,90528749,90543327,90528749,90543327,111137981,XM_022489719.1,uncharacterized LOC111137981,14578
NC_035784.1,90507764,90512205,90507764,90512205,111137982,XM_022489720.1,uncharacterized LOC111137982,4441
NC_035784.1,49078853,49085288,49078853,49083974,111137987,XM_022489726.1,uncharacterized LOC111137987,5121
NC_035784.1,49078853,49085288,49078853,49085288,111137987,XM_022489727.1,uncharacterized LOC111137987,6435
NC_035784.1,9885758,9889195,9885758,9889195,111137988,XM_022489730.1,uncharacterized LOC111137988,3437
NC_035780.1,39668442,39672343,39668442,39672343,111137994,XM_022489739.1,uncharacterized LOC111137994,3901
NC_035784.1,33903572,33905398,33903572,33905398,111138007,XM_022489753.1,uncharacterized LOC111138007,1826
NC_035784.1,870115,871091,870115,871091,111138008,XM_022489754.1,uncharacterized LOC111138008,976
NC_035784.1,21868572,21910081,21898124,21910081,111138013,XM_022489759.1,uncharacterized LOC111138013,11957
NC_035784.1,21868572,21910081,21896848,21910081,111138013,XM_022489766.1,uncharacterized LOC111138013,13233
NC_035784.1,21868572,21910081,21895138,21910081,111138013,XM_022489761.1,uncharacterized LOC111138013,14943
NC_035784.1,21868572,21910081,21894128,21910081,111138013,XM_022489765.1,uncharacterized LOC111138013,15953
NC_035784.1,21868572,21910081,21886317,21910081,111138013,XM_022489767.1,uncharacterized LOC111138013,23764
NC_035784.1,21868572,21910081,21882854,21910081,111138013,XM_022489764.1,uncharacterized LOC111138013,27227
NC_035784.1,21868572,21910081,21882853,21910081,111138013,XM_022489760.1,uncharacterized LOC111138013,27228
NC_035784.1,21868572,21910081,21868572,21910081,111138013,XM_022489763.1,uncharacterized LOC111138013,41509
NC_035784.1,29314351,29316981,29314351,29316981,111138016,XM_022489770.1,uncharacterized LOC111138016,2630
NC_035780.1,63395532,63399949,63395532,63399949,111138017,XM_022489774.1,uncharacterized LOC111138017,4417
NC_035784.1,51844684,51846116,51844684,51846116,111138022,XM_022489775.1,uncharacterized LOC111138022,1432
NC_035784.1,54049578,54051055,54049578,54051055,111138023,XM_022489776.1,uncharacterized LOC111138023,1477
NC_035784.1,67174944,67179631,67174944,67179631,111138024,XM_022489777.1,uncharacterized LOC111138024,4687
NC_035780.1,60645622,60647939,60645622,60647939,111138029,XM_022489832.1,uncharacterized LOC111138029,2317
NC_035784.1,34675161,34679309,34675161,34679309,111138033,XM_022489807.1,uncharacterized LOC111138033,4148
NC_035784.1,34816816,34819492,34816816,34819492,111138037,XM_022489812.1,uncharacterized LOC111138037,2676
NC_035784.1,5541690,5546426,5541693,5546420,111138038,XM_022489814.1,uncharacterized LOC111138038,4727
NC_035784.1,5541690,5546426,5541690,5546426,111138038,XM_022489813.1,uncharacterized LOC111138038,4736
NC_035784.1,59841037,59845988,59841942,59845988,111138041,XM_022489822.1,uncharacterized LOC111138041,4046
NC_035784.1,59841037,59845988,59841514,59845988,111138041,XM_022489818.1,uncharacterized LOC111138041,4474
NC_035784.1,59841037,59845988,59841037,59845988,111138041,XM_022489820.1,uncharacterized LOC111138041,4951
NC_035784.1,9927772,9931184,9927772,9931184,111138043,XM_022489824.1,uncharacterized LOC111138043,3412
NC_035784.1,49796527,49800757,49797272,49800757,111138048,XM_022489834.1,uncharacterized LOC111138048,3485
NC_035784.1,49796527,49800757,49796527,49800757,111138048,XM_022489833.1,uncharacterized LOC111138048,4230
NC_035784.1,58580700,58590885,58580700,58590885,111138050,XM_022489836.1,uncharacterized LOC111138050,10185
NC_035784.1,28850289,28852380,28850289,28852380,111138052,XM_022489839.1,uncharacterized LOC111138052,2091
NC_035784.1,71269551,71275658,71269551,71275658,111138054,XM_022489841.1,uncharacterized LOC111138054,6107
NC_035784.1,92457240,92481100,92457241,92459427,111138056,XM_022489843.1,uncharacterized LOC111138056,2186
NC_035784.1,92457240,92481100,92478878,92481100,111138056,XM_022489846.1,uncharacterized LOC111138056,2222
NC_035784.1,92457240,92481100,92457240,92481100,111138056,XM_022489844.1,uncharacterized LOC111138056,23860
NC_035784.1,92471032,92473216,92471032,92473216,111138057,XM_022489847.1,uncharacterized LOC111138057,2184
NC_035784.1,96285134,96289874,96285134,96289874,111138058,XM_022489848.1,uncharacterized LOC111138058,4740
NC_035784.1,49456055,49475741,49456055,49475741,111138062,XM_022489851.1,uncharacterized LOC111138062,19686
NC_035780.1,671959,675504,671970,675504,111138070,XM_022489880.1,uncharacterized LOC111138070,3534
NC_035780.1,671959,675504,671959,675504,111138070,XM_022489874.1,uncharacterized LOC111138070,3545
NC_035784.1,9118380,9121854,9118740,9121719,111138073,XM_022489875.1,uncharacterized LOC111138073,2979
NC_035784.1,9118380,9121854,9118740,9121854,111138073,XM_022489873.1,uncharacterized LOC111138073,3114
NC_035784.1,4460342,4462628,4460342,4462628,111138074,XM_022489876.1,uncharacterized LOC111138074,2286
NC_035784.1,31820508,31821804,31820508,31821804,111138075,XM_022489877.1,uncharacterized LOC111138075,1296
NC_035784.1,75971289,75976939,75971289,75976939,111138078,XM_022489881.1,uncharacterized LOC111138078,5650
NC_035784.1,75263405,75269006,75263405,75269006,111138082,XM_022489887.1,uncharacterized LOC111138082,5601
NC_035780.1,53915858,53919012,53916383,53919012,111138083,XM_022489892.1,uncharacterized LOC111138083,2629
NC_035784.1,27412979,27420167,27412979,27419478,111138085,XM_022489889.1,uncharacterized LOC111138085,6499
NC_035784.1,27412979,27420167,27412979,27420167,111138085,XM_022489891.1,uncharacterized LOC111138085,7188
NC_035784.1,49328487,49333809,49328487,49333809,111138087,XM_022489893.1,uncharacterized LOC111138087,5322
NC_035784.1,92780706,92792752,92780706,92792752,111138089,XM_022489895.1,uncharacterized LOC111138089,12046
NC_035784.1,12909001,12910380,12909001,12910380,111138091,XM_022489896.1,uncharacterized LOC111138091,1379
NC_035784.1,86064199,86087701,86064199,86087698,111138093,XM_022489897.1,uncharacterized LOC111138093,23499
NC_035784.1,86064199,86087701,86064199,86087699,111138093,XM_022489899.1,uncharacterized LOC111138093,23500
NC_035784.1,86064199,86087701,86064199,86087701,111138093,XM_022489898.1,uncharacterized LOC111138093,23502
NC_035784.1,36426621,36433556,36426621,36433556,111138094,XM_022489901.1,uncharacterized LOC111138094,6935
NC_035784.1,46667590,46670544,46667590,46670544,111138096,XM_022489903.1,uncharacterized LOC111138096,2954
NC_035780.1,31728305,31789132,31728305,31789132,111138099,XM_022489909.1,uncharacterized LOC111138099,60827
NC_035784.1,30173577,30176752,30173577,30176752,111138103,XM_022489911.1,uncharacterized LOC111138103,3175
NC_035784.1,50896387,50909771,50896387,50909771,111138105,XM_022489915.1,uncharacterized LOC111138105,13384
NC_035784.1,32564198,32572844,32564198,32572844,111138106,XM_022489916.1,uncharacterized LOC111138106,8646
NC_035780.1,31646496,31711055,31646496,31711055,111138107,XM_022489920.1,uncharacterized LOC111138107,64559
NC_035780.1,31573660,31637961,31573660,31637961,111138113,XM_022489933.1,uncharacterized LOC111138113,64301
NC_035784.1,44807737,44817219,44807737,44817168,111138117,XM_022489935.1,uncharacterized LOC111138117,9431
NC_035784.1,44807737,44817219,44807737,44817219,111138117,XM_022489936.1,uncharacterized LOC111138117,9482
NC_035784.1,60490052,60496079,60490052,60496079,111138122,XM_022489942.1,uncharacterized LOC111138122,6027
NC_035784.1,60228255,60230884,60228255,60230884,111138127,XM_022489961.1,uncharacterized LOC111138127,2629
NC_035784.1,60347357,60364162,60347381,60364162,111138129,XM_022489964.1,uncharacterized LOC111138129,16781
NC_035784.1,60347357,60364162,60347370,60364162,111138129,XM_022489966.1,uncharacterized LOC111138129,16792
NC_035784.1,60347357,60364162,60347360,60364162,111138129,XM_022489965.1,uncharacterized LOC111138129,16802
NC_035784.1,60347357,60364162,60347357,60364162,111138129,XM_022489963.1,uncharacterized LOC111138129,16805
NC_035784.1,60409936,60412745,60409936,60412745,111138136,XM_022489973.1,uncharacterized LOC111138136,2809
NC_035784.1,60241743,60245680,60241743,60245680,111138138,XM_022489975.1,uncharacterized LOC111138138,3937
NC_035784.1,60484131,60485630,60484131,60485630,111138139,XM_022489976.1,uncharacterized LOC111138139,1499
NC_035784.1,14767324,14770685,14767324,14770685,111138144,XM_022489980.1,uncharacterized LOC111138144,3361
NC_035784.1,7535551,7540306,7535551,7540306,111138146,XM_022489985.1,uncharacterized LOC111138146,4755
NC_035784.1,72859998,72864772,72859998,72864772,111138148,XM_022489988.1,uncharacterized LOC111138148,4774
NC_035784.1,72866255,72871869,72867461,72871869,111138149,XM_022489990.1,uncharacterized LOC111138149,4408
NC_035784.1,72866255,72871869,72866255,72871869,111138149,XM_022489989.1,uncharacterized LOC111138149,5614
NC_035780.1,64626005,64627956,64626005,64627956,111138151,XM_022489994.1,uncharacterized LOC111138151,1951
NC_035784.1,21127419,21134112,21127419,21134112,111138153,XM_022489993.1,uncharacterized LOC111138153,6693
NC_035784.1,35869021,35874437,35869021,35874437,111138156,XM_022489997.1,uncharacterized LOC111138156,5416
NC_035784.1,85655273,85656435,85655273,85656435,111138157,XM_022489998.1,uncharacterized LOC111138157,1162
NC_035784.1,88380355,88389626,88380355,88389383,111138158,XM_022490000.1,uncharacterized LOC111138158,9028
NC_035784.1,88380355,88389626,88380355,88389393,111138158,XM_022490002.1,uncharacterized LOC111138158,9038
NC_035784.1,88380355,88389626,88380355,88389626,111138158,XM_022490001.1,uncharacterized LOC111138158,9271
NC_035784.1,9354164,9363413,9354164,9363413,111138160,XM_022490003.1,uncharacterized LOC111138160,9249
NC_035784.1,82894223,82901174,82894223,82901174,111138162,XM_022490004.1,uncharacterized LOC111138162,6951
NC_035784.1,49086944,49088004,49086944,49088004,111138163,XM_022490006.1,uncharacterized LOC111138163,1060
NC_035784.1,4820435,4822295,4820435,4822295,111138164,XM_022490007.1,uncharacterized LOC111138164,1860
NC_035784.1,27119153,27128196,27119153,27128196,111138165,XM_022490010.1,uncharacterized LOC111138165,9043
NC_035784.1,50486249,50491198,50486249,50491198,111138172,XM_022490020.1,uncharacterized LOC111138172,4949
NC_035784.1,29338238,29341125,29338238,29341125,111138174,XM_022490022.1,uncharacterized LOC111138174,2887
NC_035784.1,14865861,14889690,14865861,14889690,111138176,XM_022490027.1,uncharacterized LOC111138176,23829
NC_035784.1,14863874,14865763,14863874,14865763,111138178,XM_022490029.1,uncharacterized LOC111138178,1889
NC_035784.1,64068036,64113429,64068036,64113429,111138186,XM_022490041.1,uncharacterized LOC111138186,45393
NC_035784.1,42719242,42721648,42719242,42721648,111138188,XM_022490043.1,uncharacterized LOC111138188,2406
NC_035784.1,44872841,44874997,44872841,44874997,111138189,XM_022490045.1,uncharacterized LOC111138189,2156
NC_035784.1,65391165,65412563,65391165,65412563,111138191,XM_022490047.1,uncharacterized LOC111138191,21398
NC_035784.1,92023440,92025573,92023440,92025573,111138198,XM_022490053.1,uncharacterized LOC111138198,2133
NC_035784.1,94604727,94606675,94604727,94606675,111138202,XM_022490060.1,uncharacterized LOC111138202,1948
NC_035780.1,62446498,62449675,62446498,62449675,111138205,XM_022490067.1,uncharacterized LOC111138205,3177
NC_035784.1,44778745,44794447,44778745,44794447,111138206,XM_022490064.1,uncharacterized LOC111138206,15702
NC_035784.1,3668904,3672424,3668904,3672424,111138207,XM_022490065.1,uncharacterized LOC111138207,3520
NC_035784.1,9624785,9646963,9624785,9646963,111138212,XM_022490076.1,uncharacterized LOC111138212,22178
NC_035784.1,42186401,42201526,42186401,42197116,111138215,XM_022490079.1,uncharacterized LOC111138215,10715
NC_035784.1,42186401,42201526,42186401,42201526,111138215,XM_022490078.1,uncharacterized LOC111138215,15125
NC_035784.1,42462704,42464542,42462704,42464542,111138220,XM_022490085.1,uncharacterized LOC111138220,1838
NC_035784.1,76721664,76725820,76721664,76725820,111138221,XM_022490086.1,uncharacterized LOC111138221,4156
NC_035784.1,55679356,55680729,55679356,55680729,111138223,XM_022490089.1,uncharacterized LOC111138223,1373
NC_035784.1,20857781,20872314,20857781,20872314,111138228,XM_022490093.1,uncharacterized LOC111138228,14533
NC_035784.1,20872542,20878142,20872542,20878142,111138229,XM_022490095.1,uncharacterized LOC111138229,5600
NC_035784.1,37147197,37171071,37147197,37170619,111138233,XM_022490099.1,uncharacterized LOC111138233,23422
NC_035784.1,37147197,37171071,37147197,37170622,111138233,XM_022490100.1,uncharacterized LOC111138233,23425
NC_035784.1,37147197,37171071,37147197,37171071,111138233,XM_022490098.1,uncharacterized LOC111138233,23874
NC_035784.1,41516140,41519125,41516140,41519125,111138236,XM_022490101.1,uncharacterized LOC111138236,2985
NC_035784.1,72203727,72210604,72203727,72210604,111138237,XM_022490108.1,uncharacterized LOC111138237,6877
NC_035784.1,30870193,30871498,30870193,30871498,111138238,XM_022490109.1,uncharacterized LOC111138238,1305
NC_035784.1,66607752,66612398,66607752,66612398,111138244,XM_022490115.1,uncharacterized LOC111138244,4646
NC_035784.1,61879276,61880490,61879276,61880490,111138245,XM_022490116.1,uncharacterized LOC111138245,1214
NC_035784.1,43196383,43202088,43196383,43202025,111138248,XM_022490121.1,uncharacterized LOC111138248,5642
NC_035784.1,43196383,43202088,43196383,43202088,111138248,XM_022490120.1,uncharacterized LOC111138248,5705
NC_035784.1,75665584,75670515,75665584,75670515,111138250,XM_022490122.1,uncharacterized LOC111138250,4931
NC_035784.1,61630714,61634154,61630714,61634149,111138251,XM_022490125.1,uncharacterized LOC111138251,3435
NC_035784.1,61630714,61634154,61630714,61634154,111138251,XM_022490123.1,uncharacterized LOC111138251,3440
NC_035784.1,82542908,82545150,82542908,82545150,111138259,XM_022490132.1,uncharacterized LOC111138259,2242
NC_035784.1,82550140,82552336,82550140,82552336,111138261,XM_022490134.1,uncharacterized LOC111138261,2196
NC_035784.1,26025069,26043079,26025069,26043079,111138269,XM_022490148.1,uncharacterized LOC111138269,18010
NC_035784.1,42711484,42712918,42711484,42712918,111138270,XM_022490149.1,uncharacterized LOC111138270,1434
NC_035784.1,45025031,45032088,45025031,45032088,111138272,XM_022490150.1,uncharacterized LOC111138272,7057
NC_035784.1,46973902,46986189,46973902,46986189,111138279,XM_022490154.1,uncharacterized LOC111138279,12287
NC_035784.1,49481061,49484871,49481061,49484871,111138284,XM_022490162.1,uncharacterized LOC111138284,3810
NC_035784.1,37178745,37180834,37178745,37180834,111138291,XM_022490168.1,uncharacterized LOC111138291,2089
NC_035784.1,72442166,72444786,72442166,72444786,111138292,XM_022490169.1,uncharacterized LOC111138292,2620
NC_035784.1,63701572,63712917,63701572,63712894,111138293,XM_022490171.1,uncharacterized LOC111138293,11322
NC_035784.1,63701572,63712917,63701572,63712917,111138293,XM_022490170.1,uncharacterized LOC111138293,11345
NC_035784.1,19864626,19886515,19864626,19886515,111138295,XM_022490172.1,uncharacterized LOC111138295,21889
NC_035784.1,24984335,24985945,24984738,24985945,111138298,XM_022490176.1,uncharacterized LOC111138298,1207
NC_035784.1,24984335,24985945,24984335,24985945,111138298,XM_022490177.1,uncharacterized LOC111138298,1610
NC_035784.1,36850338,36851828,36850338,36851828,111138306,XM_022490186.1,uncharacterized LOC111138306,1490
NC_035784.1,75523160,75525659,75523160,75525659,111138307,XM_022490187.1,uncharacterized LOC111138307,2499
NC_035784.1,39951619,39958803,39951621,39958803,111138309,XM_022490189.1,uncharacterized LOC111138309,7182
NC_035784.1,39951619,39958803,39951619,39958803,111138309,XM_022490190.1,uncharacterized LOC111138309,7184
NC_035784.1,53584723,53589000,53584723,53589000,111138322,XM_022490229.1,uncharacterized LOC111138322,4277
NC_035784.1,60521845,60543904,60521851,60543904,111138324,XM_022490231.1,uncharacterized LOC111138324,22053
NC_035784.1,60521845,60543904,60521845,60543904,111138324,XM_022490232.1,uncharacterized LOC111138324,22059
NC_035784.1,60521845,60543904,60521853,60529975,111138324,XM_022490234.1,uncharacterized LOC111138324,8122
NC_035784.1,61483528,61494112,61483528,61494112,111138331,XM_022490245.1,uncharacterized LOC111138331,10584
NC_035784.1,81039336,81050012,81039877,81050012,111138335,XM_022490252.1,uncharacterized LOC111138335,10135
NC_035784.1,81039336,81050012,81039336,81050012,111138335,XM_022490251.1,uncharacterized LOC111138335,10676
NC_035784.1,86969725,86972679,86969725,86972679,111138336,XM_022490253.1,uncharacterized LOC111138336,2954
NC_035784.1,86967065,86969726,86967065,86969726,111138337,XM_022490254.1,uncharacterized LOC111138337,2661
NC_035784.1,80171000,80173629,80171000,80173629,111138342,XM_022490264.1,uncharacterized LOC111138342,2629
NC_035784.1,64558778,64560528,64558778,64560528,111138349,XM_022490275.1,uncharacterized LOC111138349,1750
NC_035784.1,87846384,87852197,87846384,87852197,111138353,XM_022490280.1,uncharacterized LOC111138353,5813
NC_035784.1,41907531,41911174,41907531,41911174,111138358,XM_022490286.1,uncharacterized LOC111138358,3643
NC_035784.1,47525074,47533600,47525987,47533600,111138365,XM_022490293.1,uncharacterized LOC111138365,7613
NC_035784.1,47525074,47533600,47525503,47533600,111138365,XM_022490294.1,uncharacterized LOC111138365,8097
NC_035784.1,47525074,47533600,47525074,47533600,111138365,XM_022490295.1,uncharacterized LOC111138365,8526
NC_035784.1,86050096,86062994,86050096,86062994,111138373,XM_022490302.1,uncharacterized LOC111138373,12898
NC_035784.1,76098848,76112549,76098848,76112549,111138376,XM_022490305.1,uncharacterized LOC111138376,13701
NC_035784.1,23010447,23012935,23010447,23012935,111138377,XM_022490307.1,uncharacterized LOC111138377,2488
NC_035784.1,16356084,16357248,16356084,16357248,111138379,XM_022490309.1,uncharacterized LOC111138379,1164
NC_035784.1,6155640,6157346,6155640,6157346,111138380,XM_022490311.1,uncharacterized LOC111138380,1706
NC_035784.1,55342619,55345463,55342619,55345463,111138381,XM_022490312.1,uncharacterized LOC111138381,2844
NC_035784.1,46439655,46450266,46439655,46450266,111138383,XM_022490313.1,uncharacterized LOC111138383,10611
NC_035784.1,35991288,35993700,35991288,35993700,111138387,XM_022490321.1,uncharacterized LOC111138387,2412
NC_035784.1,3736113,3753164,3736113,3753164,111138388,XM_022490322.1,uncharacterized LOC111138388,17051
NC_035784.1,33082792,33085244,33082792,33085244,111138397,XM_022490335.1,uncharacterized LOC111138397,2452
NC_035780.1,33506520,33510135,33506520,33510135,111138399,XM_022490379.1,uncharacterized LOC111138399,3615
NC_035784.1,72125750,72131652,72129736,72131612,111138400,XM_022490340.1,uncharacterized LOC111138400,1876
NC_035784.1,72125750,72131652,72129736,72131652,111138400,XM_022490338.1,uncharacterized LOC111138400,1916
NC_035784.1,72125750,72131652,72125750,72131652,111138400,XM_022490339.1,uncharacterized LOC111138400,5902
NC_035784.1,41489751,41497679,41489751,41497679,111138405,XM_022490354.1,uncharacterized LOC111138405,7928
NC_035784.1,6380618,6384168,6380618,6384153,111138407,XM_022490357.1,uncharacterized LOC111138407,3535
NC_035784.1,6380618,6384168,6380618,6384168,111138407,XM_022490356.1,uncharacterized LOC111138407,3550
NC_035784.1,2092840,2093610,2092840,2093610,111138408,XM_022490358.1,uncharacterized LOC111138408,770
NC_035784.1,67534523,67586397,67534523,67586395,111138409,XM_022490359.1,uncharacterized LOC111138409,51872
NC_035784.1,67534523,67586397,67534523,67586397,111138409,XM_022490361.1,uncharacterized LOC111138409,51874
NC_035784.1,29702805,29714280,29702805,29714273,111138410,XM_022490362.1,uncharacterized LOC111138410,11468
NC_035784.1,29702805,29714280,29702805,29707641,111138410,XM_022490363.1,uncharacterized LOC111138410,4836
NC_035784.1,27184170,27185561,27184170,27185561,111138413,XM_022490366.1,uncharacterized LOC111138413,1391
NC_035784.1,56328919,56330102,56328919,56330102,111138416,XM_022490370.1,uncharacterized LOC111138416,1183
NC_035784.1,13639675,13642482,13639675,13642482,111138418,XM_022490371.1,uncharacterized LOC111138418,2807
NC_035784.1,19928861,19930836,19928861,19930836,111138419,XM_022490372.1,uncharacterized LOC111138419,1975
NC_035784.1,87279948,87288288,87280161,87288288,111138420,XM_022490375.1,uncharacterized LOC111138420,8127
NC_035784.1,87279948,87288288,87279948,87288288,111138420,XM_022490373.1,uncharacterized LOC111138420,8340
NC_035784.1,61802574,61805868,61802574,61805868,111138422,XM_022490378.1,uncharacterized LOC111138422,3294
NC_035784.1,61826628,61827898,61826628,61827898,111138424,XM_022490382.1,uncharacterized LOC111138424,1270
NC_035784.1,61796099,61802589,61796102,61802589,111138425,XM_022490385.1,uncharacterized LOC111138425,6487
NC_035784.1,61796099,61802589,61796101,61802589,111138425,XM_022490383.1,uncharacterized LOC111138425,6488
NC_035784.1,785888,788599,785888,788599,111138429,XM_022490388.1,uncharacterized LOC111138429,2711
NC_035784.1,758187,759763,758187,759763,111138430,XM_022490389.1,uncharacterized LOC111138430,1576
NC_035784.1,55814035,55821905,55814035,55819661,111138431,XM_022490390.1,uncharacterized LOC111138431,5626
NC_035780.1,17700637,17702502,17700637,17702502,111138433,XM_022490399.1,uncharacterized LOC111138433,1865
NC_035784.1,46256792,46264390,46257661,46264390,111138436,XM_022490403.1,uncharacterized LOC111138436,6729
NC_035784.1,30709901,30714794,30709901,30714708,111138442,XM_022490406.1,uncharacterized LOC111138442,4807
NC_035784.1,30709901,30714794,30709901,30714794,111138442,XM_022490407.1,uncharacterized LOC111138442,4893
NC_035784.1,30697877,30702861,30697877,30702861,111138444,XM_022490415.1,uncharacterized LOC111138444,4984
NC_035784.1,7098793,7100470,7098793,7100470,111138446,XM_022490418.1,uncharacterized LOC111138446,1677
NC_035784.1,13855963,13860921,13855963,13860921,111138447,XM_022490420.1,uncharacterized LOC111138447,4958
NC_035784.1,17518038,17531512,17518038,17531512,111138450,XM_022490423.1,uncharacterized LOC111138450,13474
NC_035784.1,7262061,7268267,7262061,7268267,111138452,XM_022490425.1,uncharacterized LOC111138452,6206
NC_035784.1,19456426,19468264,19456426,19468264,111138454,XM_022490428.1,uncharacterized LOC111138454,11838
NC_035784.1,88535587,88537699,88535587,88537699,111138455,XM_022490429.1,uncharacterized LOC111138455,2112
NC_035784.1,84787738,84790166,84787738,84790166,111138456,XM_022490431.1,uncharacterized LOC111138456,2428
NC_035784.1,59329604,59333049,59329604,59333049,111138457,XM_022490432.1,uncharacterized LOC111138457,3445
NC_035784.1,19314339,19333588,19314339,19333588,111138460,XM_022490438.1,uncharacterized LOC111138460,19249
NC_035784.1,80634273,80654216,80640189,80654025,111138466,XM_022490447.1,uncharacterized LOC111138466,13836
NC_035784.1,80634273,80654216,80638658,80654025,111138466,XM_022490445.1,uncharacterized LOC111138466,15367
NC_035784.1,80634273,80654216,80638659,80654216,111138466,XM_022490446.1,uncharacterized LOC111138466,15557
NC_035784.1,80634273,80654216,80634273,80654025,111138466,XM_022490448.1,uncharacterized LOC111138466,19752
NC_035784.1,925567,930596,925567,930596,111138467,XM_022490449.1,uncharacterized LOC111138467,5029
NC_035784.1,72463716,72469845,72463716,72469845,111138469,XM_022490456.1,uncharacterized LOC111138469,6129
NC_035784.1,56908905,56911622,56908905,56911622,111138470,XM_022490457.1,uncharacterized LOC111138470,2717
NC_035784.1,2523383,2531946,2523383,2530775,111138472,XM_022490459.1,uncharacterized LOC111138472,7392
NC_035784.1,2523383,2531946,2523383,2531946,111138472,XM_022490458.1,uncharacterized LOC111138472,8563
NC_035784.1,72681995,72684625,72681995,72684625,111138476,XM_022490465.1,uncharacterized LOC111138476,2630
NC_035784.1,28775354,28781932,28775354,28781932,111138477,XM_022490466.1,uncharacterized LOC111138477,6578
NC_035784.1,62700868,62708595,62701365,62708580,111138489,XM_022490482.1,uncharacterized LOC111138489,7215
NC_035784.1,62700868,62708595,62700868,62708580,111138489,XM_022490481.1,uncharacterized LOC111138489,7712
NC_035784.1,62700868,62708595,62700868,62708595,111138489,XM_022490483.1,uncharacterized LOC111138489,7727
NC_035784.1,29990570,29998443,29990570,29998443,111138492,XM_022490491.1,uncharacterized LOC111138492,7873
NC_035784.1,30000174,30092010,30053613,30064175,111138493,XM_022490495.1,uncharacterized LOC111138493,10562
NC_035784.1,30000174,30092010,30054163,30092010,111138493,XM_022490498.1,uncharacterized LOC111138493,37847
NC_035784.1,30000174,30092010,30054149,30092010,111138493,XM_022490493.1,uncharacterized LOC111138493,37861
NC_035784.1,30000174,30092010,30054148,30092010,111138493,XM_022490497.1,uncharacterized LOC111138493,37862
NC_035784.1,30000174,30092010,30000174,30064177,111138493,XM_022490496.1,uncharacterized LOC111138493,64003
NC_035784.1,30000174,30092010,30054647,30064174,111138493,XM_022490494.1,uncharacterized LOC111138493,9527
NC_035784.1,30069969,30076515,30069969,30076515,111138495,XM_022490501.1,uncharacterized LOC111138495,6546
NC_035784.1,30044926,30051402,30044926,30048689,111138496,XM_022490503.1,uncharacterized LOC111138496,3763
NC_035784.1,30044926,30051402,30044926,30051402,111138496,XM_022490502.1,uncharacterized LOC111138496,6476
NC_035784.1,52861377,52897918,52863614,52895197,111138499,XM_022490509.1,uncharacterized LOC111138499,31583
NC_035784.1,52861377,52897918,52863614,52897890,111138499,XM_022490510.1,uncharacterized LOC111138499,34276
NC_035784.1,52861377,52897918,52863614,52897918,111138499,XM_022490508.1,uncharacterized LOC111138499,34304
NC_035784.1,53232774,53236745,53234555,53236745,111138501,XM_022490513.1,uncharacterized LOC111138501,2190
NC_035784.1,53232774,53236745,53232774,53236745,111138501,XM_022490511.1,uncharacterized LOC111138501,3971
NC_035784.1,53260876,53263669,53260876,53263669,111138503,XM_022490517.1,uncharacterized LOC111138503,2793
NC_035784.1,52910954,52925817,52910954,52925817,111138504,XM_022490518.1,uncharacterized LOC111138504,14863
NC_035784.1,52965474,52968318,52965474,52968318,111138505,XM_022490520.1,uncharacterized LOC111138505,2844
NC_035780.1,14638645,14646793,14638645,14646793,111138506,XM_022490524.1,uncharacterized LOC111138506,8148
NC_035784.1,52817106,52820198,52817106,52820198,111138507,XM_022490521.1,uncharacterized LOC111138507,3092
NC_035784.1,53026632,53029825,53026632,53029825,111138508,XM_022490522.1,uncharacterized LOC111138508,3193
NC_035784.1,53125103,53136564,53125103,53136564,111138509,XM_022490523.1,uncharacterized LOC111138509,11461
NC_035784.1,53145884,53152203,53145884,53152203,111138511,XM_022490526.1,uncharacterized LOC111138511,6319
NC_035784.1,53034658,53041108,53034658,53040568,111138519,XM_022490533.1,uncharacterized LOC111138519,5910
NC_035784.1,53034658,53041108,53034658,53041108,111138519,XM_022490534.1,uncharacterized LOC111138519,6450
NC_035786.1,38822950,38825775,38822950,38825775,111104787,XM_022438920.1,probable LRR receptor-like serine/threonine-protein kinase At4g20940,2825
NC_035788.1,70145188,70148737,70145188,70148737,111110791,XM_022447406.1,protein LSM12 homolog,3549
NC_035784.1,48106811,48118226,48106811,48118226,111136118,XM_022486739.1,protein LSM14 homolog B-B-like,11415
NC_035781.1,40256550,40264247,40256550,40264247,111119639,XM_022460019.1,protein LTV1 homolog,7697
NC_035784.1,50471988,50475389,50471988,50475389,111136317,XM_022487081.1,protein LZIC-like,3401
NC_035782.1,14662454,14670178,14662454,14670178,111122904,XM_022464939.1,lupus La protein homolog,7724
NC_035786.1,32217968,32219037,32217968,32219037,111104233,XM_022438076.1,turripeptide Lol9.1-like,1069
NC_035786.1,29680412,29681534,29680412,29681534,111102629,XM_022435451.1,turripeptide Lol9.1-like,1122
NC_035789.1,243277,246133,243277,246133,111117442,XM_022456568.1,selenoprotein M-like,2856
NC_035784.1,22570303,22573170,22570303,22573170,111133836,XM_022482527.1,selenoprotein M-like,2867
NC_035781.1,55643814,55645253,55643814,55645253,111120406,XM_022461121.1,muscle M-line assembly protein unc-89-like,1439
NC_035786.1,26859882,26869064,26859882,26869064,111104197,XM_022438031.1,peptidase M20 domain-containing protein 2-like,9182
NC_035784.1,95869612,95881692,95869612,95881692,111136220,XM_022486920.1,protein MAK16 homolog A-like,12080
NC_035787.1,63395568,63400541,63398513,63400538,111107371,XM_022442560.1,protein MANBAL-like,2025
NC_035780.1,43770292,43771503,43770292,43771503,111107658,XM_022442945.1,protein MB21D2-like,1211
NC_035786.1,56133287,56134111,56133287,56134111,111105196,XM_022439366.1,protein MB21D2-like,824
NC_035787.1,60490044,60531769,60490044,60531769,111108624,XM_022444617.1,protein MCM10 homolog,41725
NC_035783.1,15625157,15629916,15625157,15629916,111129476,XM_022475869.1,protein MEMO1-like,4759
NC_035784.1,79277350,79288511,79277350,79288511,111133748,XM_022482380.1,uncharacterized MFS-type transporter YhjX-like,11161
NC_035786.1,7188271,7311401,7188271,7311401,111104380,XM_022438288.1,nucleolar MIF4G domain-containing protein 1-like,123130
NC_035785.1,48953453,48954592,48953453,48954592,111102219,XM_022434872.1,alpha/beta-gliadin MM1-like,1139
NC_035784.1,35327554,35349542,35327554,35344931,111136054,XM_022486636.1,protein MMS22-like,17377
NC_035784.1,35327554,35349542,35327554,35349542,111136054,XM_022486635.1,protein MMS22-like,21988
NC_035787.1,37233001,37346089,37233001,37346089,111110125,XM_022446489.1,protein MON2 homolog,113088
NC_035782.1,55170730,55175966,55170730,55175057,111125130,XM_022468625.1,metallophosphoesterase MPPED2-like,4327
NC_035780.1,28734177,28740474,28735333,28740474,111123744,XM_022466497.1,metallophosphoesterase MPPED2-like,5141
NC_035782.1,55170730,55175966,55170730,55175966,111125130,XM_022468624.1,metallophosphoesterase MPPED2-like,5236
NC_035780.1,28734177,28740474,28734177,28740474,111123744,XM_022466328.1,metallophosphoesterase MPPED2-like,6297
NC_035784.1,50612306,50644962,50612306,50644962,111136444,XM_022487300.1,protein MTO1 homolog,32656
NC_035783.1,13510131,13536256,13510131,13536256,111131157,XM_022478558.1,O-methyltransferase MdmC-like,26125
NC_035783.1,13562205,13565356,13562205,13565356,111128463,XM_022474075.1,O-methyltransferase MdmC-like,3151
NC_035783.1,13524509,13528250,13524509,13528250,111131158,XM_022478559.1,O-methyltransferase MdmC-like,3741
NC_035783.1,13510276,13514041,13510276,13514041,111131156,XM_022478556.1,O-methyltransferase MdmC-like,3765
NC_035783.1,13510131,13536256,13530794,13536256,111131157,XM_022478557.1,O-methyltransferase MdmC-like,5462
NC_035784.1,67951114,67958375,67951114,67958374,111135114,XM_022484855.1,protein Mo25-like,7260
NC_035784.1,67951114,67958375,67951114,67958375,111135114,XM_022484854.1,protein Mo25-like,7261
NC_035780.1,26654120,26658727,26654120,26658727,111104085,XM_022437830.1,protein Mpv17-like,4607
NC_035787.1,32278162,32289983,32278162,32289983,111110557,XM_022447107.1,cyclin-D-binding Myb-like transcription factor 1,11821
NC_035784.1,52805824,52808415,52805824,52808415,111133010,XM_022481041.1,carboxypeptidase N subunit 2-like,2591
NC_035784.1,72818603,72822350,72818603,72822350,111134733,XM_022484057.1,peroxisomal N(1)-acetyl-spermine/spermidine oxidase-like,3747
NC_035783.1,31208107,31222379,31208107,31222379,111131441,XM_022478978.1,putative N-acetylated-alpha-linked acidic dipeptidase,14272
NC_035782.1,68756242,68765609,68756242,68765609,111127394,XM_022472553.1,polypeptide N-acetylgalactosaminyltransferase 5-like,9367
NC_035782.1,57673826,57679471,57673826,57679471,111126162,XM_022470602.1,UDP-N-acetylglucosamine--dolichyl-phosphate N-acetylglucosaminephosphotransferase-like,5645
NC_035781.1,20117225,20125253,20117225,20125253,111122222,XM_022463862.1,phosphatidylinositol N-acetylglucosaminyltransferase subunit Q-like,8028
NC_035782.1,31399998,31404486,31399998,31404486,111125721,XM_022469789.1,alpha-tubulin N-acetyltransferase 1-like,4488
NC_035788.1,75424472,75439412,75424472,75439391,111110879,XM_022447531.1,heparan-alpha-glucosaminide N-acetyltransferase-like,14919
NC_035788.1,75424472,75439412,75424472,75439412,111110879,XM_022447530.1,heparan-alpha-glucosaminide N-acetyltransferase-like,14940
NC_035782.1,31771427,31773398,31771427,31773398,111124186,XM_022467047.1,alpha-tubulin N-acetyltransferase-like,1971
NC_035780.1,60428082,60429338,60428082,60429129,111119787,XM_022460280.1,glycine N-acyltransferase-like protein 3,1047
NC_035781.1,37113385,37126047,37113385,37126047,111118593,XM_022458137.1,glycine N-acyltransferase-like,12662
NC_035787.1,49725041,49742352,49725041,49742352,111106042,XM_022440561.1,Ca(2+)-independent N-acyltransferase-like,17311
NC_035784.1,70027110,70032468,70027110,70032468,111132130,XM_022479857.1,glycine N-acyltransferase-like,5358
NC_035781.1,37073191,37079284,37073191,37079284,111118592,XM_022458136.1,glycine N-acyltransferase-like,6093
NC_035786.1,37049099,37057622,37049099,37057622,111104841,XM_022439003.1,glycine N-acyltransferase-like,8523
NC_035780.1,28044888,28052355,28044888,28052355,111119381,XM_022459496.1,histidine N-alpha-methyltransferase-like,7467
NC_035786.1,40077047,40092565,40077047,40092565,111103944,XM_022437590.1,aminopeptidase N-like,15518
NC_035788.1,104016084,104040915,104016084,104040914,111115100,XM_022453693.1,aminopeptidase N-like,24830
NC_035788.1,104016084,104040915,104016084,104040915,111115100,XM_022453694.1,aminopeptidase N-like,24831
NC_035783.1,15274027,15276536,15274027,15276536,111129128,XM_022475266.1,aminopeptidase N-like,2509
NC_035783.1,12144264,12171850,12145187,12171849,111129882,XM_022476397.1,selenoprotein N-like,26662
NC_035783.1,12144264,12171850,12144265,12171850,111129882,XM_022476395.1,selenoprotein N-like,27585
NC_035783.1,12144264,12171850,12144264,12171850,111129882,XM_022476396.1,selenoprotein N-like,27586
NC_035788.1,30038558,30067751,30038558,30067750,111112772,XM_022450543.1,aminopeptidase N-like,29192
NC_035788.1,30038558,30067751,30038558,30067751,111112772,XM_022450544.1,aminopeptidase N-like,29193
NC_035782.1,59891633,59895181,59891633,59895181,111124343,XM_022467193.1,protein N-lysine methyltransferase METTL21A-like,3548
NC_035780.1,15535326,15552673,15535326,15552673,111131506,XM_022479083.1,histone-lysine N-methyltransferase SETDB1-like,17347
NC_035786.1,55140500,55144272,55140500,55144272,111104003,XM_022437690.1,histone-lysine N-methyltransferase,3772
NC_035784.1,75653739,75654635,75653739,75654635,111132597,XM_022480427.1,histone-lysine N-methyltransferase,896
NC_035783.1,21108991,21127572,21108991,21119535,111130847,XM_022478098.1,calmodulin-lysine N-methyltransferase-like,10544
NC_035783.1,21108991,21127572,21108991,21127229,111130847,XM_022478099.1,calmodulin-lysine N-methyltransferase-like,18238
NC_035783.1,21108991,21127572,21108991,21127572,111130847,XM_022478100.1,calmodulin-lysine N-methyltransferase-like,18581
NC_035789.1,6514356,6519294,6514356,6519294,111116776,XM_022455776.1,(S)-coclaurine N-methyltransferase-like,4938
NC_035788.1,45341383,45348033,45341383,45348033,111113199,XM_022451294.1,carnosine N-methyltransferase-like,6650
NC_035788.1,6952356,6961414,6952356,6961414,111112783,XM_022450577.1,phosphatidylethanolamine N-methyltransferase-like,9058
NC_035782.1,54823046,54829040,54823115,54829040,111125329,XM_022468984.1,senecionine N-oxygenase-like,5925
NC_035782.1,54823046,54829040,54823046,54829040,111125329,XM_022468985.1,senecionine N-oxygenase-like,5994
NC_035783.1,20945589,20975037,20945589,20975037,111129015,XM_022475059.1,protein-cysteine N-palmitoyltransferase HHAT-like,29448
NC_035781.1,54117164,54136687,54117164,54136687,111118541,XM_022458057.1,protein N-terminal asparagine amidohydrolase-like,19523
NC_035786.1,14715242,14746161,14716035,14746161,111103872,XM_022437440.1,USP6 N-terminal-like protein,30126
NC_035788.1,60735719,60754290,60735719,60754290,111114021,XM_022452312.1,glycylpeptide N-tetradecanoyltransferase 2-like,18571
NC_035781.1,20540652,20544767,20540652,20544767,111118914,XM_022458626.1,DNA N6-methyl adenine demethylase-like,4115
NC_035786.1,36991449,37004045,36991449,37004045,111104817,XM_022438956.1,glutamine-dependent NAD(+) synthetase-like,12596
NC_035782.1,33225995,33226482,33225995,33226482,111126886,XM_022471802.1,probable NADH dehydrogenase [ubiquinone] 1 alpha subcomplex subunit 5,487
NC_035781.1,42865179,42867243,42865179,42867243,111120868,XM_022461876.1,protein NATD1-like,2064
NC_035781.1,30280082,30289250,30280082,30289250,111118320,XM_022457726.1,nucleoporin NDC1-like,9168
NC_035781.1,59519004,59540008,59529396,59540008,111120089,XM_022460756.1,protein NDNF-like,10612
NC_035781.1,59519004,59540008,59529241,59540008,111120089,XM_022460754.1,protein NDNF-like,10767
NC_035781.1,59519004,59540008,59524678,59540008,111120089,XM_022460755.1,protein NDNF-like,15330
NC_035781.1,59519004,59540008,59519555,59540008,111120089,XM_022460753.1,protein NDNF-like,20453
NC_035781.1,59519004,59540008,59519006,59540007,111120089,XM_022460758.1,protein NDNF-like,21001
NC_035781.1,59519004,59540008,59519004,59540008,111120089,XM_022460752.1,protein NDNF-like,21004
NC_035784.1,21635206,21646162,21635206,21646162,111136005,XM_022486552.1,protein NDRG3-like,10956
NC_035783.1,19857925,19863093,19857925,19863093,111128270,XM_022473813.1,arginine-hydroxylase NDUFAF5,5168
NC_035787.1,60238656,60251398,60238656,60251398,111107814,XM_022443175.1,protein NEDD1-like,12742
NC_035780.1,32148384,32163737,32148384,32163737,111135788,XM_022486153.1,cullin-associated NEDD8-dissociated protein 1-like,15353
NC_035785.1,36260850,36262095,36260850,36262095,111101039,XM_022433292.1,omega-amidase NIT2-like,1245
NC_035788.1,90390229,90399592,90390229,90399592,111115898,XM_022454810.1,omega-amidase NIT2-like,9363
NC_035786.1,27492189,27505911,27492189,27505911,111103000,XM_022435974.1,protein NPAT-like,13722
NC_035783.1,3232705,3242153,3232705,3242153,111129948,XM_022476502.1,protein NRDE2 homolog,9448
NC_035783.1,9403826,9408015,9403826,9408015,111129116,XM_022475236.1,alpha-soluble NSF attachment protein-like,4189
NC_035783.1,8799733,8800913,8799733,8800913,111131514,XM_022479094.1,nucleoporin NUP100/NSP100-like,1180
NC_035784.1,61857746,61858936,61857746,61858936,111137855,XM_022489550.1,nucleoporin NUP100/NSP100-like,1190
NC_035782.1,2318230,2361250,2318230,2361250,111124932,XM_022468241.1,nucleoporin NUP188 homolog,43020
NC_035780.1,56263195,56266459,56263195,56266459,111136554,XM_022487495.1,nucleoporin NUP53-like,3264
NC_035780.1,3323506,3325002,3323506,3325002,111129837,XM_022476321.1,protein NYNRIN-like,1496
NC_035784.1,32602869,32607459,32602869,32607459,111138224,XM_022490090.1,protein NipSnap homolog 3A-like,4590
NC_035784.1,17809776,17824427,17809776,17824427,111133359,XM_022481693.1,protein NipSnap-like,14651
NC_035781.1,54763622,54768253,54763622,54768253,111120851,XM_022461850.1,protein Njmu-R1-like,4631
NC_035784.1,40178977,40193560,40178977,40193560,111135976,XM_022486490.1,uncharacterized Nudix hydrolase NudL-like,14583
NC_035786.1,14748907,14756923,14748907,14756923,111104293,XM_022438159.1,nucleoporin Nup37-like,8016
NC_035785.1,11625315,11633421,11625315,11633421,111099598,XM_022430935.1,nucleoporin Nup43-like,8106
NC_035785.1,12520406,12528952,12520406,12528952,111101511,XM_022434036.1,nucleoporin Nup43-like,8546
NC_035785.1,43671057,43682042,43671057,43682042,111101889,XM_022434539.1,protein O-GlcNAcase-like,10985
NC_035784.1,85010345,85025617,85010345,85025617,111133671,XM_022482269.1,sialate O-acetylesterase-like,15272
NC_035786.1,48597062,48605736,48597062,48605736,111102947,XM_022435903.1,sialate O-acetylesterase-like,8674
NC_035786.1,2711071,2719777,2711071,2719777,111103198,XM_022436274.1,sialate O-acetylesterase-like,8706
NC_035786.1,2561817,2571282,2561817,2571282,111103199,XM_022436275.1,sialate O-acetylesterase-like,9465
NC_035781.1,20633398,20645947,20633398,20645947,111122081,XM_022463636.1,choline O-acetyltransferase-like,12549
NC_035782.1,58894632,58903984,58894632,58903984,111124704,XM_022467829.1,carnitine O-acetyltransferase-like,9352
NC_035780.1,20871973,20886471,20871973,20886471,111136067,XM_022486659.1,membrane-bound O-acyltransferase domain-containing protein 2-like,14498
NC_035787.1,66115342,66124035,66115343,66124035,111105932,XM_022440432.1,protein O-glucosyltransferase 1-like,8692
NC_035780.1,4354977,4367161,4354977,4367161,111135129,XM_022484890.1,selenoprotein O-like,12184
NC_035782.1,57105653,57110277,57105653,57110277,111126013,XM_022470368.1,cathepsin O-like,4624
NC_035782.1,56665684,56672272,56665684,56672272,111123154,XM_022465307.1,cathepsin O-like,6588
NC_035781.1,262870,269976,262870,269976,111122435,XM_022464231.1,aminopeptidase O-like,7106
NC_035781.1,31669807,31677941,31669807,31677941,111118125,XM_022457441.1,aminopeptidase O-like,8134
NC_035780.1,3771199,3779809,3771199,3779809,111103139,XM_022436185.1,selenoprotein O-like,8610
NC_035781.1,15985604,15996596,15985604,15996596,111122294,XM_022463956.1,protein O-linked-mannose beta-1,10992
NC_035784.1,63720946,63723123,63720946,63723123,111136424,XM_022487265.1,protein O-mannose kinase-like,2177
NC_035782.1,7787287,7803920,7787287,7803920,111127037,XM_022472020.1,protein O-mannosyl-transferase 1-like,16633
NC_035781.1,41541015,41547369,41541015,41547369,111117922,XM_022457158.1,protein-L-isoaspartate O-methyltransferase domain-containing protein 1-like,6354
NC_035782.1,47269487,47273737,47269488,47273737,111126067,XM_022470458.1,N-acetylserotonin O-methyltransferase-like protein,4249
NC_035783.1,45203338,45217849,45203338,45217849,111131050,XM_022478382.1,protein-L-isoaspartate(D-aspartate) O-methyltransferase-like,14511
NC_035784.1,50736655,50740319,50736655,50740319,111133475,XM_022481915.1,protein-S-isoprenylcysteine O-methyltransferase-like,3664
NC_035783.1,29086938,29091010,29086938,29091010,111129394,XM_022475756.1,protein-glutamate O-methyltransferase-like,4072
NC_035783.1,29661276,29666359,29661276,29666359,111130573,XM_022477732.1,protein-glutamate O-methyltransferase-like,5083
NC_035787.1,57584167,57593445,57584167,57593445,111106534,XM_022441254.1,protein-serine O-palmitoleoyltransferase porcupine-like,9278
NC_035783.1,21612088,21629299,21612088,21629299,111128659,XM_022474408.1,carnitine O-palmitoyltransferase 1,17211
NC_035781.1,24446417,24451231,24446417,24451231,111118597,XM_022458141.1,metalloendopeptidase OMA1,4814
NC_035780.1,30765543,30775302,30765543,30775302,111109659,XM_022445870.1,protein OS-9-like,9759
NC_035786.1,52076040,52090572,52076042,52090572,111104135,XM_022437926.1,protein OSCP1-like,14530
NC_035786.1,52076040,52090572,52076041,52090572,111104135,XM_022437924.1,protein OSCP1-like,14531
NC_035786.1,52076040,52090572,52076040,52090572,111104135,XM_022437923.1,protein OSCP1-like,14532
NC_035788.1,65895738,65903152,65895738,65903152,111111621,XM_022448706.1,esterase OVCA2-like,7414
NC_035784.1,59819572,59836793,59819572,59836793,111134562,XM_022483693.1,deacetylase Oant_2987-like,17221
NC_035782.1,69392679,69399093,69392679,69399093,111123156,XM_022465310.1,oxidoreductase OpS5-like,6414
NC_035781.1,55026367,55034204,55026367,55034204,111120398,XM_022461113.1,oxidoreductase OpS5-like,7837
NC_035780.1,18696321,18706812,18696321,18706808,111111533,XM_022448685.1,ribonuclease Oy-like,10487
NC_035780.1,18696321,18706812,18696321,18706812,111111533,XM_022448606.1,ribonuclease Oy-like,10491
NC_035783.1,27731221,27742184,27731221,27742184,111131830,XM_022479554.1,ribonuclease Oy-like,10963
NC_035783.1,16308494,16311779,16308494,16311779,111130657,XM_022477835.1,ribonuclease Oy-like,3285
NC_035780.1,18696321,18706812,18696321,18703391,111111533,XM_022448761.1,ribonuclease Oy-like,7070
NC_035780.1,18801055,18808270,18801055,18808270,111127412,XM_022472616.1,ribonuclease Oy-like,7215
NC_035780.1,18696321,18706812,18698759,18706812,111111533,XM_022448847.1,ribonuclease Oy-like,8053
NC_035785.1,19673756,19681998,19673756,19681998,111100204,XM_022431870.1,ribonuclease Oy-like,8242
NC_035783.1,16429497,16438280,16429497,16438280,111131694,XM_022479337.1,ribonuclease Oy-like,8783
NC_035783.1,25570476,25579311,25570476,25579311,111131106,XM_022478481.1,ribonuclease Oy-like,8835
NC_035785.1,19159331,19168318,19159331,19168318,111101892,XM_022434542.1,ribonuclease Oy-like,8987
NC_035785.1,19313555,19323374,19313555,19323374,111101761,XM_022434361.1,ribonuclease Oy-like,9819
NC_035781.1,53039082,53041629,53039082,53041629,111118330,XM_022457735.1,ribonuclease P protein subunit rpr2-like,2547
NC_035781.1,8447412,8451221,8447412,8451221,111119350,XM_022459417.1,selenoprotein P-like,3809
NC_035781.1,8441356,8445366,8441356,8445366,111119348,XM_022459416.1,selenoprotein P-like,4010
NC_035781.1,18170388,18175207,18170388,18175207,111120769,XM_022461730.1,ribonucleases P/MRP protein subunit POP1-like,4819
NC_035780.1,17693996,17701226,17693996,17701226,111138426,XM_022490386.1,cytochrome P450 4X1-like,7230
NC_035782.1,32675081,32676770,32675081,32676770,111122941,XM_022464978.1,histone PARylation factor 1-like,1689
NC_035783.1,45139634,45145362,45139634,45145362,111129828,XM_022476303.1,neuronal PAS domain-containing protein 4-like,5728
NC_035785.1,11423494,11438638,11423494,11438638,111101096,XM_022433394.1,protein PAT1 homolog 1-like,15144
NC_035784.1,69447558,69452182,69447558,69452182,111135609,XM_022485835.1,protein PBDC1-like,4624
NC_035782.1,65719026,65720657,65719026,65720657,111124384,XM_022467235.1,protein PDC2-like,1631
NC_035782.1,65526154,65528575,65526154,65528575,111127232,XM_022472321.1,protein PDC2-like,2421
NC_035781.1,5420811,5479504,5420811,5479504,111122120,XM_022463703.1,multiple PDZ domain protein-like,58693
NC_035782.1,52317796,52346524,52317796,52346524,111124466,XM_022467318.1,uncharacterized PE-PGRS family protein PE_PGRS54-like,28728
NC_035785.1,34948209,34959639,34948209,34959639,111100795,XM_022432907.1,protein PFC0760c-like,11430
NC_035780.1,57756903,57762045,57756903,57762045,111108215,XM_022443935.1,protein PFC0760c-like,5142
NC_035780.1,7138117,7143409,7138117,7143409,111122605,XM_022464423.1,protein PFC0760c-like,5292
NC_035781.1,14136237,14143468,14136237,14143468,111119146,XM_022459005.1,protein PFC0760c-like,7231
NC_035781.1,7590843,7626904,7590843,7626904,111120065,XM_022460714.1,sperm-tail PG-rich repeat-containing protein 2-like,36061
NC_035788.1,12835620,12846755,12835620,12846755,111114745,XM_022453205.1,protein PIF-like,11135
NC_035786.1,48812287,48825783,48812287,48825783,111105131,XM_022439304.1,protein PIF-like,13496
NC_035780.1,53983024,53986225,53983024,53986225,111108062,XM_022443581.1,protein PIF-like,3201
NC_035780.1,55710744,55718251,55710744,55718251,111121428,XM_022462717.1,protein PIF-like,7507
NC_035789.1,22796166,22803704,22796166,22803704,111116492,XM_022455488.1,protein PIF-like,7538
NC_035788.1,12860064,12867946,12860064,12867946,111113502,XM_022451798.1,protein PIF-like,7882
NC_035780.1,53958797,53968662,53958797,53968662,111109234,XM_022445319.1,protein PIF-like,9865
NC_035781.1,6894728,6899347,6894728,6899347,111121635,XM_022462992.1,protein PIH1D3-like,4619
NC_035782.1,67216551,67217687,67216551,67217687,111122825,XM_022464815.1,protein PLANT CADMIUM RESISTANCE 3-like,1136
NC_035782.1,53040918,53043002,53040918,53043002,111123624,XM_022466078.1,M-phase-specific PLK1-interacting protein-like,2084
NC_035788.1,64024419,64035089,64024419,64035089,111112969,XM_022450872.1,protein PML-like,10670
NC_035787.1,21857960,21859857,21857960,21859857,111108879,XM_022444962.1,protein PML-like,1897
NC_035782.1,73667557,73669575,73667557,73669575,111124439,XM_022467292.1,protein PML-like,2018
NC_035788.1,12798398,12801355,12798398,12800758,111114740,XM_022453200.1,protein PML-like,2360
NC_035789.1,22677700,22680102,22677700,22680102,111117815,XM_022457049.1,protein PML-like,2402
NC_035784.1,91586799,91589433,91586799,91589433,111135509,XM_022485643.1,protein PML-like,2634
NC_035784.1,82057282,82059958,82057282,82059958,111134798,XM_022484196.1,protein PML-like,2676
NC_035782.1,74571683,74574499,74571683,74574499,111125849,XM_022470030.1,protein PML-like,2816
NC_035788.1,12798398,12801355,12798398,12801355,111114740,XM_022453201.1,protein PML-like,2957
NC_035781.1,11465045,11468329,11465045,11468329,111121153,XM_022462300.1,protein PML-like,3284
NC_035781.1,11395428,11398809,11395429,11398809,111118458,XM_022457950.1,protein PML-like,3380
NC_035781.1,11395428,11398809,11395428,11398809,111118458,XM_022457951.1,protein PML-like,3381
NC_035788.1,64024419,64035089,64024419,64029161,111112969,XM_022450871.1,protein PML-like,4742
NC_035788.1,91545665,91552853,91545665,91552853,111115088,XM_022453669.1,protein PML-like,7188
NC_035785.1,31408687,31423360,31408687,31423360,111100588,XM_022432641.1,helicase POLQ-like,14673
NC_035780.1,61553771,61557964,61553771,61557964,111108397,XM_022444254.1,speckle-type POZ protein-like,4193
NC_035783.1,16983842,16990829,16983842,16990829,111129271,XM_022475551.1,protein PRRC1-A-like,6987
NC_035781.1,17502547,17504675,17502547,17504675,111120144,XM_022460869.1,protein PRRC2A-like,2128
NC_035782.1,61276416,61305230,61276416,61305230,111125384,XM_022469142.1,protein PRRC2C-like,28814
NC_035787.1,65063209,65091689,65063209,65086708,111106818,XM_022441642.1,exopolyphosphatase PRUNE1-like,23499
NC_035787.1,65063209,65091689,65063209,65090005,111106818,XM_022441643.1,exopolyphosphatase PRUNE1-like,26796
NC_035787.1,65063209,65091689,65063209,65091689,111106818,XM_022441640.1,exopolyphosphatase PRUNE1-like,28480
NC_035781.1,53202917,53204462,53202917,53204462,111119339,XM_022459411.1,protein PRY2-like,1545
NC_035781.1,18000173,18008995,18000173,18008995,111118270,XM_022457642.1,ribonucleoprotein PTB-binding 1-like,8822
NC_035784.1,85931610,86013571,85931610,86013571,111136260,XM_022486980.1,protein PTCD3 homolog,81961
NC_035782.1,32602042,32615503,32602042,32615503,111127105,XM_022472125.1,protein PTHB1-like,13461
NC_035787.1,45112397,45114990,45112397,45114990,111110401,XM_022446892.1,protein PXR1-like,2593
NC_035784.1,79848642,79849064,79848642,79849064,111132627,XM_022480453.1,protein PXR1-like,422
NC_035786.1,29676546,29677677,29676546,29677677,111102628,XM_022435450.1,turripeptide Pal9.2-like,1131
NC_035786.1,32213983,32215221,32213983,32215221,111104231,XM_022438075.1,turripeptide Pal9.2-like,1238
NC_035782.1,42821778,42827449,42821778,42827449,111124590,XM_022467572.1,lysosomal Pro-X carboxypeptidase-like,5671
NC_035788.1,20561058,20562995,20561058,20562995,111115248,XM_022453910.1,bis(5'-nucleosyl)-tetraphosphatase PrpE [asymmetrical]-like,1937
NC_035788.1,63460597,63466041,63460597,63466041,111111041,XM_022447779.1,coenzyme Q-binding protein COQ10 homolog B,5444
NC_035783.1,12048829,12057570,12048829,12057570,111129889,XM_022476404.1,carboxypeptidase Q-like,8741
NC_035784.1,13609408,13618444,13609408,13618444,111138344,XM_022490270.1,triple QxxK/R motif-containing protein-like,9036
NC_035784.1,32409609,32419367,32409609,32419367,111138030,XM_022489793.1,protein RCC2-like,9758
NC_035784.1,30254842,30264618,30254842,30264618,111138301,XM_022490181.1,protein RCC2-like,9776
NC_035787.1,33598493,33601443,33598493,33601443,111108072,XM_022443595.1,protein RD3-like,2950
NC_035787.1,32273400,32276510,32273400,32276510,111109779,XM_022446012.1,protein RD3-like,3110
NC_035784.1,60589508,60592655,60589508,60592655,111136668,XM_022487683.1,protein RER1-like,3147
NC_035785.1,31208727,31231582,31208727,31231582,111100600,XM_022432656.1,protein RFT1 homolog,22855
NC_035781.1,14480163,14486952,14480163,14486952,111120547,XM_022461345.1,pyroglutamylated RFamide peptide receptor-like,6789
NC_035782.1,38399394,38404209,38399394,38404209,111123401,XM_022465699.1,uncharacterized RING finger protein ECU07_0330-like,4815
NC_035784.1,90808912,90817332,90808912,90817332,111137886,XM_022489581.1,protein RMD5 homolog A-like,8420
NC_035780.1,3934135,3936908,3934135,3936908,111109865,XM_022446122.1,DNA-directed RNA polymerase III subunit RPC10-like,2773
NC_035780.1,33481667,33485490,33481667,33485490,111119391,XM_022459519.1,uncharacterized RNA-binding protein C365.04c-like,3823
NC_035782.1,48843364,48850050,48843364,48850050,111126280,XM_022470797.1,ribosomal RNA-processing protein 14-C-like,6686
NC_035780.1,1955555,1981097,1955555,1981097,111128971,XM_022474964.1,double-stranded RNA-specific editase 1-like,25542
NC_035789.1,30464859,30578216,30464859,30578216,111117248,XM_022456317.1,protein RRNAD1-like,113357
NC_035788.1,8989698,9018067,8989698,9018067,111114792,XM_022453266.1,protein RRNAD1-like,28369
NC_035783.1,9949105,9955710,9949105,9954689,111128902,XM_022474854.1,protein RRNAD1-like,5584
NC_035783.1,9949105,9955710,9949105,9954696,111128902,XM_022474855.1,protein RRNAD1-like,5591
NC_035783.1,9949105,9955710,9949105,9955023,111128902,XM_022474853.1,protein RRNAD1-like,5918
NC_035783.1,9949105,9955710,9949105,9955710,111128902,XM_022474852.1,protein RRNAD1-like,6605
NC_035788.1,9061293,9069807,9061293,9069807,111113348,XM_022451549.1,protein RRNAD1-like,8514
NC_035784.1,71062245,71083992,71062245,71083736,111136875,XM_022488022.1,protein RRP5 homolog,21491
NC_035781.1,29535284,29540719,29535284,29540719,111119168,XM_022459046.1,protein RTF2 homolog,5435
NC_035782.1,53059490,53064934,53059490,53064934,111125311,XM_022468942.1,prenylated Rab acceptor protein 1-like,5444
NC_035782.1,25812420,25902631,25812420,25902631,111125663,XM_022469687.1,GTPase-activating Rap/Ran-GAP domain-like protein 3,90211
NC_035781.1,54332391,54342929,54332392,54342929,111121244,XM_022462418.1,dexamethasone-induced Ras-related protein 1-like,10537
NC_035782.1,5996354,6010134,5996354,6010134,111125468,XM_022469350.1,protein Red-like,13780
NC_035782.1,2453129,2468885,2453129,2468885,111126553,XM_022471276.1,protein Red-like,15756
NC_035781.1,53367140,53376491,53367140,53376491,111119655,XM_022460059.1,mitochondrial Rho GTPase 1-like,9351
NC_035783.1,44976979,44978251,44976979,44978251,111128168,XM_022473645.1,actin-binding Rho-activating protein-like,1272
NC_035781.1,8587090,8603620,8587090,8603620,111122148,XM_022463736.1,citron Rho-interacting kinase-like,16530
NC_035780.1,29365247,29367367,29365247,29367367,111105911,XM_022440393.1,neuropeptide S receptor-like,2120
NC_035781.1,36771223,36778040,36771223,36778040,111120663,XM_022461556.1,protein S-acyltransferase 24-like,6817
NC_035781.1,6704145,6712067,6704145,6712065,111120668,XM_022461564.1,radical S-adenosyl methionine domain-containing protein 2-like,7920
NC_035782.1,57617610,57632656,57617610,57632656,111125386,XM_022469145.1,selenoprotein S-like,15046
NC_035784.1,83266502,83274553,83266502,83274553,111135702,XM_022485991.1,homocysteine S-methyltransferase YbgG-like,8051
NC_035784.1,40720843,40725951,40724212,40725951,111132977,XM_022480968.1,thiopurine S-methyltransferase-like,1739
NC_035784.1,40727488,40729250,40727488,40729250,111132978,XM_022480970.1,thiopurine S-methyltransferase-like,1762
NC_035781.1,16582237,16584354,16582237,16584354,111119130,XM_022458986.1,thiopurine S-methyltransferase-like,2117
NC_035784.1,40720843,40725951,40720966,40725951,111132977,XM_022480967.1,thiopurine S-methyltransferase-like,4985
NC_035784.1,40720843,40725951,40720843,40725951,111132977,XM_022480969.1,thiopurine S-methyltransferase-like,5108
NC_035780.1,13119905,13123815,13119905,13123815,111135121,XM_022484877.1,glutathione S-transferase A-like,3910
NC_035784.1,37793831,37795699,37793831,37795699,111138098,XM_022489905.1,glutathione S-transferase-like,1868
NC_035784.1,35927655,35930098,35927655,35930098,111134208,XM_022483060.1,glutathione S-transferase-like,2443
NC_035780.1,39816544,39819172,39816544,39819172,111122121,XM_022463707.1,glutathione S-transferase-like,2628
NC_035780.1,27249931,27252632,27249931,27252632,111120486,XM_022461225.1,glutathione S-transferase-like,2701
NC_035784.1,35931438,35934411,35931438,35934411,111134207,XM_022483059.1,glutathione S-transferase-like,2973
NC_035782.1,66982091,66998876,66982091,66998876,111123975,XM_022466756.1,protein SCAI-like,16785
NC_035784.1,42562937,42566377,42562937,42566377,111136505,XM_022487398.1,protein SCO1 homolog,3440
NC_035782.1,47288904,47300261,47288904,47300261,111122535,XM_022464320.1,protein SDA1 homolog,11357
NC_035783.1,42642439,42647147,42642439,42647147,111130617,XM_022477782.1,protein SDE2 homolog,4708
NC_035780.1,14329732,14336254,14329732,14336254,111122067,XM_022463616.1,dehydrogenase/reductase SDR family member on chromosome X-like,6522
NC_035784.1,81067787,81074096,81067787,81074096,111133565,XM_022482045.1,protein SEC13 homolog,6309
NC_035784.1,21928749,21935402,21928749,21935402,111134885,XM_022484395.1,nucleoporin SEH1-like,6653
NC_035787.1,14733297,14739193,14733297,14739193,111106945,XM_022441830.1,protein SET-like,5896
NC_035782.1,53853748,53860959,53853748,53860959,111126579,XM_022471321.1,protein SET-like,7211
NC_035787.1,13581985,13589791,13581985,13589791,111107764,XM_022443108.1,protein SET-like,7806
NC_035784.1,63731342,63748529,63731342,63748529,111137510,XM_022488979.1,protein SFI1 homolog,17187
NC_035782.1,29447620,29448935,29447620,29448935,111123996,XM_022466825.1,protein SGT1 homolog,1315
NC_035787.1,21317114,21330933,21317114,21330933,111110568,XM_022447123.1,protein SHQ1 homolog,13819
NC_035781.1,43589281,43607167,43589281,43607167,111118296,XM_022457680.1,neuropeptide SIFamide receptor-like,17886
NC_035782.1,4133137,4152024,4133137,4152024,111126014,XM_022470369.1,helicase SKI2W-like,18887
NC_035782.1,3191382,3213191,3191382,3213191,111123162,XM_022465315.1,helicase SKI2W-like,21809
NC_035787.1,10454368,10457875,10454368,10457875,111108718,XM_022444757.1,S-crystallin SL11-like,3507
NC_035787.1,12446365,12450287,12446365,12450287,111106258,XM_022440862.1,S-crystallin SL11-like,3922
NC_035783.1,46398000,46402298,46398000,46402298,111130885,XM_022478154.1,S-crystallin SL11-like,4298
NC_035783.1,2010457,2043129,2010457,2043129,111130065,XM_022476746.1,protein SMG5-like,32672
NC_035782.1,50091308,50109317,50091308,50109317,111125280,XM_022468887.1,protein SMG7-like,18009
NC_035784.1,18926208,18934857,18926208,18934857,111138487,XM_022490480.1,protein SMG9-like,8649
NC_035781.1,30011853,30013266,30011853,30013266,111119337,XM_022459409.1,protein SMIM7 homolog,1413
NC_035780.1,28591338,28592375,28591338,28592375,111101440,XM_022433932.1,Golgi SNAP receptor complex member 2-like,1037
NC_035786.1,5225819,5237202,5226100,5237202,111103692,XM_022437123.1,protein SON-like,11102
NC_035786.1,5225819,5237202,5225819,5237202,111103692,XM_022437122.1,protein SON-like,11383
NC_035786.1,4973712,4986328,4973712,4986132,111103825,XM_022437356.1,protein SON-like,12420
NC_035786.1,4973712,4986328,4973712,4986328,111103825,XM_022437357.1,protein SON-like,12616
NC_035785.1,17947114,17949663,17947114,17949663,111101192,XM_022433566.1,protein SON-like,2549
NC_035785.1,17013765,17016315,17013765,17016315,111100490,XM_022432438.1,protein SON-like,2550
NC_035787.1,177178,180908,177178,180908,111107421,XM_022442615.1,protein SON-like,3730
NC_035786.1,5225819,5237202,5225819,5233188,111103692,XM_022437125.1,protein SON-like,7369
NC_035786.1,4973712,4986328,4978811,4986328,111103825,XM_022437358.1,protein SON-like,7517
NC_035782.1,45346075,45349023,45346075,45349023,111125184,XM_022468722.1,protein SPATA45 homolog,2948
NC_035787.1,60074729,60075917,60074729,60075917,111106839,XM_022441684.1,protein SPEC3-like,1188
NC_035784.1,64639740,64642464,64639740,64642464,111136177,XM_022486830.1,protein SPEC3-like,2724
NC_035780.1,63607724,63613665,63607724,63613665,111108512,XM_022444462.1,protein SPT2 homolog,5941
NC_035783.1,31175401,31180216,31175401,31180215,111130891,XM_022478160.1,protein SREK1IP1-like,4814
NC_035783.1,31175401,31180216,31175401,31180216,111130891,XM_022478161.1,protein SREK1IP1-like,4815
NC_035783.1,31486397,31492218,31486398,31492218,111131057,XM_022478390.1,protein SREK1IP1-like,5820
NC_035783.1,31486397,31492218,31486397,31492218,111131057,XM_022478392.1,protein SREK1IP1-like,5821
NC_035785.1,31785099,31794240,31785099,31794240,111100379,XM_022432165.1,protein SSUH2 homolog,9141
NC_035781.1,33331268,33338179,33334482,33338178,111119056,XM_022458867.1,metalloreductase STEAP4-like,3696
NC_035781.1,33255303,33262137,33258411,33262136,111119823,XM_022460335.1,metalloreductase STEAP4-like,3725
NC_035781.1,33255303,33262137,33258107,33262137,111119823,XM_022460336.1,metalloreductase STEAP4-like,4030
NC_035781.1,33331268,33338179,33334124,33338179,111119056,XM_022458868.1,metalloreductase STEAP4-like,4055
NC_035781.1,33255303,33262137,33255303,33262136,111119823,XM_022460334.1,metalloreductase STEAP4-like,6833
NC_035781.1,33331268,33338179,33331268,33338177,111119056,XM_022458866.1,metalloreductase STEAP4-like,6909
NC_035783.1,34658360,34665444,34658375,34665442,111130146,XM_022476879.1,protein STPG4-like,7067
NC_035783.1,34658360,34665444,34658360,34665444,111130146,XM_022476880.1,protein STPG4-like,7084
NC_035780.1,58156457,58159978,58156457,58159978,111135650,XM_022485916.1,E3 SUMO-protein ligase nse2-like,3521
NC_035784.1,33066272,33068331,33066272,33068331,111133777,XM_022482424.1,protein SYS1 homolog,2059
NC_035782.1,60589665,60644128,60589665,60644128,111125198,XM_022468738.1,protein Shroom3-like,54463
NC_035788.1,70771316,70785184,70771316,70785184,111112742,XM_022450491.1,protein Simiate-like,13868
NC_035783.1,16679379,16692530,16679379,16692530,111129335,XM_022475647.1,protein Smaug homolog 1-like,13151
NC_035780.1,39197809,39203549,39197809,39203549,111107378,XM_022442563.1,protein SpAN-like,5740
NC_035784.1,39966035,39971059,39966035,39971059,111137101,XM_022488358.1,protein Spindly-A-like,5024
NC_035782.1,26920658,26924276,26920658,26924276,111123337,XM_022465602.1,protein Star-like,3618
NC_035782.1,50755447,50760247,50755447,50760247,111126333,XM_022470877.1,malignant T-cell-amplified sequence 1 homolog,4800
NC_035780.1,45311955,45330320,45315146,45330320,111131563,XM_022479202.1,troponin T-like,15174
NC_035780.1,45311955,45330320,45315102,45330320,111131563,XM_022479239.1,troponin T-like,15218
NC_035780.1,45311955,45330320,45315093,45330320,111131563,XM_022479265.1,troponin T-like,15227
NC_035780.1,45311955,45330320,45314250,45330320,111131563,XM_022479231.1,troponin T-like,16070
NC_035780.1,45311955,45330320,45314243,45330320,111131563,XM_022479272.1,troponin T-like,16077
NC_035780.1,45311955,45330320,45314240,45330320,111131563,XM_022479195.1,troponin T-like,16080
NC_035780.1,45311955,45330320,45314234,45330320,111131563,XM_022479171.1,troponin T-like,16086
NC_035780.1,44608486,44627856,44608486,44624698,111132450,XM_022480295.1,troponin T-like,16212
NC_035780.1,44608486,44627856,44608486,44624742,111132450,XM_022480326.1,troponin T-like,16256
NC_035780.1,44608486,44627856,44608486,44624751,111132450,XM_022480348.1,troponin T-like,16265
NC_035780.1,44608486,44627856,44608486,44625566,111132450,XM_022480289.1,troponin T-like,17080
NC_035780.1,44608486,44627856,44608486,44625569,111132450,XM_022480268.1,troponin T-like,17083
NC_035780.1,44608486,44627856,44608486,44625572,111132450,XM_022480356.1,troponin T-like,17086
NC_035780.1,44608486,44627856,44608486,44625577,111132450,XM_022480318.1,troponin T-like,17091
NC_035780.1,45311955,45330320,45311958,45330320,111131563,XM_022479224.1,troponin T-like,18362
NC_035780.1,45311955,45330320,45311957,45330320,111131563,XM_022479162.1,troponin T-like,18363
NC_035780.1,45311955,45330320,45311956,45330320,111131563,XM_022479279.1,troponin T-like,18364
NC_035780.1,45311955,45330320,45311955,45330320,111131563,XM_022479178.1,troponin T-like,18365
NC_035780.1,44608486,44627856,44608486,44627854,111132450,XM_022480341.1,troponin T-like,19368
NC_035780.1,44608486,44627856,44608486,44627855,111132450,XM_022480333.1,troponin T-like,19369
NC_035780.1,44608486,44627856,44608486,44627856,111132450,XM_022480276.1,troponin T-like,19370
NC_035781.1,56742867,56802331,56742867,56802331,111119404,XM_022459540.1,voltage-dependent T-type calcium channel subunit alpha-1H-like,59464
NC_035784.1,89618239,89641645,89618493,89641645,111132029,XM_022479660.1,ribonuclease T2-like,23152
NC_035784.1,89618239,89641645,89618450,89641645,111132029,XM_022479659.1,ribonuclease T2-like,23195
NC_035784.1,89618239,89641645,89618239,89641645,111132029,XM_022479661.1,ribonuclease T2-like,23406
NC_035785.1,19466561,19471481,19466561,19471481,111100202,XM_022431868.1,ribonuclease T2-like,4920
NC_035785.1,19235377,19242163,19235377,19241645,111100037,XM_022431622.1,ribonuclease T2-like,6268
NC_035785.1,19235377,19242163,19235377,19242163,111100037,XM_022431624.1,ribonuclease T2-like,6786
NC_035780.1,61720330,61744423,61720330,61744423,111114702,XM_022453133.1,protein TANC2-like,24093
NC_035781.1,10359659,10377439,10359659,10371584,111119867,XM_022460426.1,protein TBATA-like,11925
NC_035781.1,10359659,10377439,10359659,10377435,111119867,XM_022460427.1,protein TBATA-like,17776
NC_035781.1,10359659,10377439,10359659,10377436,111119867,XM_022460430.1,protein TBATA-like,17777
NC_035781.1,10359659,10377439,10359659,10377437,111119867,XM_022460428.1,protein TBATA-like,17778
NC_035781.1,10359659,10377439,10359659,10377439,111119867,XM_022460425.1,protein TBATA-like,17780
NC_035780.1,43761921,43768844,43761921,43768844,111120074,XM_022460737.1,protein TBRG4-like,6923
NC_035780.1,46232803,46240178,46232803,46240178,111112862,XM_022450754.1,protein TBRG4-like,7375
NC_035785.1,43611975,43619688,43611975,43619688,111100376,XM_022432161.1,protein TEX261-like,7713
NC_035786.1,19532728,19537608,19532728,19537608,111102593,XM_022435406.1,protein TFG-like,4880
NC_035786.1,12422708,12427919,12422708,12427919,111105617,XM_022439984.1,protein TFG-like,5211
NC_035782.1,55635116,55637810,55635116,55637810,111125098,XM_022468569.1,protein THEM6-like,2694
NC_035784.1,62116542,62167071,62116542,62167071,111136733,XM_022487820.1,nucleolysin TIAR-like,50529
NC_035781.1,35537696,35551121,35537696,35551121,111119053,XM_022458863.1,metalloprotease TIKI1-like,13425
NC_035782.1,64661193,64681637,64661193,64681637,111125351,XM_022469076.1,nucleoprotein TPR-like,20444
NC_035781.1,15717987,15749119,15717991,15749119,111118796,XM_022458426.1,nucleoprotein TPR-like,31128
NC_035781.1,15717987,15749119,15717987,15749119,111118796,XM_022458425.1,nucleoprotein TPR-like,31132
NC_035782.1,41548511,41601070,41548511,41601070,111124238,XM_022467093.1,nucleoprotein TPR-like,52559
NC_035782.1,30647558,30657364,30647558,30657325,111126756,XM_022471595.1,nucleoprotein TPR-like,9767
NC_035782.1,30647558,30657364,30647558,30657364,111126756,XM_022471594.1,nucleoprotein TPR-like,9806
NC_035781.1,41506620,41514179,41506620,41514179,111122353,XM_022464097.1,protein TSSC1-like,7559
NC_035780.1,60383840,60385532,60383840,60385513,111099459,XM_022430752.1,protein TSSC4-like,1673
NC_035780.1,60383840,60385532,60383841,60385532,111099459,XM_022430743.1,protein TSSC4-like,1691
NC_035788.1,21886309,21901233,21886309,21901233,111115662,XM_022454485.1,ciliogenesis-associated TTC17-interacting protein-like,14924
NC_035780.1,6812526,6823506,6812526,6823506,111132626,XM_022480456.1,HIV Tat-specific factor 1-like,10980
NC_035781.1,53399415,53403188,53400187,53403188,111120885,XM_022461905.1,protein Tob1-like,3001
NC_035781.1,53399415,53403188,53399999,53403188,111120885,XM_022461906.1,protein Tob1-like,3189
NC_035781.1,53399415,53403188,53399685,53403188,111120885,XM_022461908.1,protein Tob1-like,3503
NC_035781.1,53399415,53403188,53399415,53403188,111120885,XM_022461904.1,protein Tob1-like,3773
NC_035782.1,3525265,3527140,3525265,3527140,111124539,XM_022467480.1,kunitz-type U19-barytoxin-Tl1a-like,1875
NC_035786.1,25255616,25269700,25255616,25269700,111102825,XM_022435714.1,probable U3 small nucleolar RNA-associated protein 11,14084
NC_035784.1,44744667,44777218,44744667,44777218,111135412,XM_022485453.1,protein UBASH3A homolog,32551
NC_035783.1,8256021,8265954,8256021,8265954,111128001,XM_022473366.1,probable UDP-sugar transporter protein SLC35A4,9933
NC_035786.1,46193527,46207721,46193527,46207721,111104814,XM_022438952.1,E3 UFM1-protein ligase 1 homolog,14194
NC_035787.1,29001012,29006113,29001012,29006113,111106318,XM_022440949.1,protein UXT-like,5101
NC_035784.1,25297474,25302146,25297474,25300477,111099106,XM_022430474.1,exonuclease V-like,3003
NC_035784.1,25297474,25302146,25297474,25301755,111099106,XM_022430473.1,exonuclease V-like,4281
NC_035782.1,41811714,41816111,41811714,41816111,111123536,XM_022465927.1,endonuclease V-like,4397
NC_035784.1,25297474,25302146,25297474,25302109,111099106,XM_022430476.1,exonuclease V-like,4635
NC_035784.1,25297474,25302146,25297474,25302146,111099106,XM_022430475.1,exonuclease V-like,4672
NC_035781.1,47074441,47076405,47074441,47076405,111122433,XM_022464225.1,Ig-like V-type domain-containing protein FAM187A,1964
NC_035780.1,24984174,24986853,24984174,24986853,111112876,XM_022450734.1,vasopressin V1b receptor-like,2679
NC_035784.1,4447257,4460127,4447257,4460127,111136905,XM_022488073.1,protein VAC14 homolog,12870
NC_035786.1,51927612,51930245,51927612,51930245,111104798,XM_022438936.1,small VCP/p97-interacting protein-like,2633
NC_035781.1,48453551,48461689,48453551,48461689,111118543,XM_022458061.1,factor VIII intron 22 protein-like,8138
NC_035781.1,26182172,26185923,26182172,26185923,111120775,XM_022461738.1,glutamate-rich WD repeat-containing protein 1-like,3751
NC_035784.1,14022881,14043204,14022881,14043204,111133909,XM_022482642.1,ATPase WRNIP1-like,20323
NC_035782.1,65725345,65746692,65725345,65746692,111127228,XM_022472316.1,protein WWC2-like,21347
NC_035780.1,17893952,17916178,17893952,17916178,111134836,XM_022484291.1,von Willebrand factor D and EGF domain-containing protein-like,22226
NC_035784.1,8217729,8228851,8217729,8228851,111134088,XM_022482890.1,neural Wiskott-Aldrich syndrome protein-like,11122
NC_035782.1,48905186,48923048,48905188,48923043,111127135,XM_022472175.1,protein Wnt-1-like,17855
NC_035782.1,48905186,48923048,48905186,48923048,111127135,XM_022472176.1,protein Wnt-1-like,17862
NC_035782.1,48960228,48975776,48960228,48975775,111126881,XM_022471792.1,protein Wnt-10b-like,15547
NC_035782.1,48960228,48975776,48966444,48975775,111126881,XM_022471793.1,protein Wnt-10b-like,9331
NC_035784.1,92545887,92558450,92545887,92558450,111135626,XM_022485857.1,protein Wnt-11b-2-like,12563
NC_035784.1,92610620,92645550,92610620,92645550,111137758,XM_022489395.1,protein Wnt-11b-2-like,34930
NC_035784.1,92483975,92490055,92483975,92490055,111134023,XM_022482788.1,protein Wnt-11b-2-like,6080
NC_035784.1,92429089,92435565,92429089,92435565,111136584,XM_022487529.1,protein Wnt-11b-2-like,6476
NC_035785.1,20584036,20599204,20584036,20599204,111100180,XM_022431833.1,protein Wnt-16-like,15168
NC_035787.1,19578877,19595032,19578877,19595032,111106587,XM_022441316.1,protein Wnt-16-like,16155
NC_035787.1,49186286,49197401,49186287,49197401,111106516,XM_022441232.1,protein Wnt-2b-A-like,11114
NC_035787.1,49186286,49197401,49186286,49197401,111106516,XM_022441231.1,protein Wnt-2b-A-like,11115
NC_035787.1,49186286,49197401,49187924,49197399,111106516,XM_022441233.1,protein Wnt-2b-A-like,9475
NC_035784.1,30940227,30950811,30940227,30950811,111132156,XM_022479901.1,protein Wnt-4-like,10584
NC_035784.1,30940227,30950811,30940227,30949477,111132156,XM_022479900.1,protein Wnt-4-like,9250
NC_035784.1,31764183,31773484,31764183,31773484,111132932,XM_022480878.1,protein Wnt-4-like,9301
NC_035788.1,51677255,51688212,51677255,51688212,111115598,XM_022454388.1,protein Wnt-5b-like,10957
NC_035787.1,55986695,56016163,55997416,56016163,111108394,XM_022444246.1,protein Wnt-5b-like,18747
NC_035787.1,55986695,56016163,55995523,56016163,111108394,XM_022444243.1,protein Wnt-5b-like,20640
NC_035787.1,55986695,56016163,55992703,56016163,111108394,XM_022444245.1,protein Wnt-5b-like,23460
NC_035787.1,55986695,56016163,55986695,56016163,111108394,XM_022444244.1,protein Wnt-5b-like,29468
NC_035782.1,48928824,48951740,48928824,48939411,111126345,XM_022470889.1,protein Wnt-6-like,10587
NC_035782.1,48928824,48951740,48928824,48940320,111126345,XM_022470888.1,protein Wnt-6-like,11496
NC_035782.1,48928824,48951740,48928824,48951740,111126345,XM_022470890.1,protein Wnt-6-like,22916
NC_035787.1,25135595,25168288,25147974,25168286,111109611,XM_022445802.1,protein Wnt-7b-like,20312
NC_035787.1,25135595,25168288,25147972,25168288,111109611,XM_022445804.1,protein Wnt-7b-like,20316
NC_035787.1,24157943,24195467,24157944,24179595,111110219,XM_022446616.1,protein Wnt-7b-like,21651
NC_035787.1,24157943,24195467,24157943,24179696,111110219,XM_022446619.1,protein Wnt-7b-like,21753
NC_035787.1,25135595,25168288,25135595,25168288,111109611,XM_022445803.1,protein Wnt-7b-like,32693
NC_035787.1,24157943,24195467,24157943,24195467,111110219,XM_022446620.1,protein Wnt-7b-like,37524
NC_035781.1,9475647,9482681,9475647,9482681,111121327,XM_022462555.1,protein Wnt-8b-like,7034
NC_035782.1,48878698,48894377,48878698,48894377,111126651,XM_022471437.1,protein Wnt-9a-like,15679
NC_035782.1,64824566,64828210,64824566,64828210,111126108,XM_022470514.1,PI-PLC X domain-containing protein 2-like,3644
NC_035782.1,64764839,64774910,64764839,64774910,111125349,XM_022469073.1,protocadherin-11 X-linked-like,10071
NC_035782.1,39994910,40019837,40002193,40019837,111124768,XM_022467945.1,protocadherin-11 X-linked-like,17644
NC_035782.1,40291933,40317010,40298485,40316154,111124767,XM_022467941.1,protocadherin-11 X-linked-like,17669
NC_035782.1,39994910,40019837,40001189,40019837,111124768,XM_022467944.1,protocadherin-11 X-linked-like,18648
NC_035782.1,40291933,40317010,40291933,40316154,111124767,XM_022467940.1,protocadherin-11 X-linked-like,24221
NC_035782.1,39994910,40019837,39994910,40019837,111124768,XM_022467943.1,protocadherin-11 X-linked-like,24927
NC_035782.1,40291933,40317010,40291933,40317010,111124767,XM_022467942.1,protocadherin-11 X-linked-like,25077
NC_035782.1,50420519,50424650,50420519,50424650,111125045,XM_022468486.1,protocadherin-11 X-linked-like,4131
NC_035781.1,60464943,60472700,60464943,60472700,111121964,XM_022463464.1,group XIIA secretory phospholipase A2-like,7757
NC_035780.1,58819897,58831784,58819897,58831784,111101848,XM_022434470.1,protein XRP2-like,11887
NC_035780.1,58819897,58831784,58824738,58831784,111101848,XM_022434479.1,protein XRP2-like,7046
NC_035784.1,8679721,8690739,8679721,8690739,111135761,XM_022486087.1,group XV phospholipase A2-like,11018
NC_035782.1,40605627,40624725,40605627,40624725,111127436,XM_022472612.1,probable Xaa-Pro aminopeptidase P,19098
NC_035782.1,19108892,19109923,19108892,19109923,111126383,XM_022470976.1,N-terminal Xaa-Pro-Lys N-methyltransferase 1-like,1031
NC_035780.1,25335514,25337342,25335514,25337342,111129016,XM_022475064.1,neuropeptide Y receptor type 6-like,1828
NC_035784.1,22017846,22026800,22017846,22026800,111135315,XM_022485264.1,chromodomain Y-like protein,8954
NC_035788.1,80539760,80553110,80539760,80553110,111114944,XM_022453501.1,pro-neuropeptide Y-like,13350
NC_035780.1,13347363,13351553,13348549,13351553,111113871,XM_022452167.1,pro-neuropeptide Y-like,3004
NC_035780.1,13347363,13351553,13347363,13351553,111113871,XM_022452174.1,pro-neuropeptide Y-like,4190
NC_035782.1,41396226,41403384,41396226,41403384,111125412,XM_022469196.1,protocadherin-11 Y-linked-like,7158
NC_035783.1,50235236,50241977,50235236,50241969,111127827,XM_022473094.1,protein YIF1B-B-like,6733
NC_035783.1,50235236,50241977,50235236,50241977,111127827,XM_022473096.1,protein YIF1B-B-like,6741
NC_035781.1,42770911,42775816,42770911,42775816,111118389,XM_022457835.1,protein YIPF1-like,4905
NC_035780.1,27610036,27617026,27610038,27617026,111113833,XM_022452290.1,protein YIPF3-like,6988
NC_035780.1,27610036,27617026,27610036,27617026,111113833,XM_022452224.1,protein YIPF3-like,6990
NC_035783.1,18551393,18557603,18551393,18557603,111128203,XM_022473694.1,protein YIPF4-like,6210
NC_035782.1,74232594,74257901,74232594,74257901,111123462,XM_022465788.1,protein YIPF5-like,25307
NC_035782.1,73991259,74019352,73991259,74019352,111127353,XM_022472492.1,protein YIPF5-like,28093
NC_035782.1,66628700,66632447,66628700,66632447,111127330,XM_022472460.1,protein YIPF6-like,3747
NC_035782.1,66801050,66805017,66801050,66805017,111127329,XM_022472459.1,protein YIPF6-like,3967
NC_035787.1,52620582,52633890,52620600,52633890,111106639,XM_022441387.1,protein Ycf2-like,13290
NC_035787.1,52620582,52633890,52620599,52633890,111106639,XM_022441386.1,protein Ycf2-like,13291
NC_035787.1,52620582,52633890,52620585,52633890,111106639,XM_022441383.1,protein Ycf2-like,13305
NC_035786.1,42927616,42929329,42927616,42929329,111105081,XM_022439255.1,protein Ycf2-like,1713
NC_035787.1,8291012,8296563,8291012,8296563,111107211,XM_022442294.1,protein Ycf2-like,5551
NC_035781.1,4486196,4491953,4486196,4491953,111118903,XM_022458604.1,protein Ycf2-like,5757
NC_035782.1,41798379,41809300,41798540,41809300,111127146,XM_022472200.1,palmitoyltransferase ZDHHC15-like,10760
NC_035782.1,41798379,41809300,41798384,41809300,111127146,XM_022472204.1,palmitoyltransferase ZDHHC15-like,10916
NC_035782.1,41798379,41809300,41798383,41806522,111127146,XM_022472202.1,palmitoyltransferase ZDHHC15-like,8139
NC_035782.1,41798379,41809300,41798381,41806522,111127146,XM_022472205.1,palmitoyltransferase ZDHHC15-like,8141
NC_035782.1,41798379,41809300,41798382,41806652,111127146,XM_022472199.1,palmitoyltransferase ZDHHC15-like,8270
NC_035782.1,41798379,41809300,41798379,41806652,111127146,XM_022472203.1,palmitoyltransferase ZDHHC15-like,8273
NC_035780.1,41591542,41679803,41591542,41679803,111124769,XM_022467957.1,palmitoyltransferase ZDHHC17-like,88261
NC_035783.1,29073663,29075286,29073663,29075286,111129411,XM_022475783.1,palmitoyltransferase ZDHHC22-like,1623
NC_035780.1,58211704,58216623,58212408,58216623,111135632,XM_022485868.1,palmitoyltransferase ZDHHC22-like,4215
NC_035780.1,58211704,58216623,58211704,58216623,111135632,XM_022485878.1,palmitoyltransferase ZDHHC22-like,4919
NC_035782.1,56841178,56845578,56841178,56845578,111127482,XM_022472673.1,palmitoyltransferase ZDHHC23-like,4400
NC_035782.1,50295203,50303963,50295203,50303963,111126991,XM_022471957.1,palmitoyltransferase ZDHHC3-like,8760
NC_035784.1,46830258,46841265,46830258,46841265,111135476,XM_022485581.1,palmitoyltransferase ZDHHC5-like,11007
NC_035781.1,35359681,35366465,35359681,35366465,111121831,XM_022463269.1,palmitoyltransferase ZDHHC6-like,6784
NC_035786.1,14603803,14628162,14603803,14628162,111103367,XM_022436589.1,palmitoyltransferase ZDHHC9-like,24359
NC_035781.1,51629886,51656990,51644815,51656990,111121017,XM_022462105.1,protein ZGRF1-like,12175
NC_035781.1,51448941,51474201,51453041,51474201,111121016,XM_022462103.1,protein ZGRF1-like,21160
NC_035781.1,51448941,51474201,51449035,51474201,111121016,XM_022462104.1,protein ZGRF1-like,25166
NC_035781.1,51448941,51474201,51448941,51474201,111121016,XM_022462102.1,protein ZGRF1-like,25260
NC_035784.1,57828697,57841847,57828697,57841847,111137655,XM_022489211.1,protein ZINC INDUCED FACILITATOR-LIKE 1-like,13150
NC_035781.1,52277885,52285959,52277885,52285959,111119527,XM_022459739.1,poly [ADP-ribose] polymerase 12-like,8074
NC_035780.1,6805505,6812307,6805505,6812307,111130808,XM_022478057.1,glutamate [NMDA] receptor subunit 1-like,6802
NC_035784.1,54285309,54286926,54285309,54286926,111135133,XM_022484892.1,bis(5'-nucleosyl)-tetraphosphatase [asymmetrical]-like,1617
NC_035780.1,23285391,23298828,23285391,23298828,111135290,XM_022485236.1,glycogen [starch] synthase-like,13437
NC_035783.1,50972998,50980836,50972998,50980836,111130417,XM_022477486.1,uncharacterized aarF domain-containing protein kinase 1-like,7838
NC_035784.1,53416658,53418436,53416658,53418436,111137537,XM_022489017.1,something about silencing protein 10-like,1778
NC_035781.1,2331405,2357345,2331405,2357345,111122423,XM_022464215.1,eyes absent homolog 2-like,25940
NC_035781.1,8536895,8547551,8536895,8547551,111118713,XM_022458298.1,hippocampus abundant transcript 1 protein-like,10656
NC_035780.1,16516331,16524077,16516331,16524077,111101029,XM_022433264.1,chromatin accessibility complex protein 1-like,7746
NC_035780.1,47580699,47585114,47580699,47585114,111110312,XM_022446755.1,isoamyl acetate-hydrolyzing esterase 1 homolog,4415
NC_035780.1,3685823,3694132,3685823,3694132,111101827,XM_022434449.1,neuronal acetylcholine receptor subunit alpha-10-like,8309
NC_035786.1,37655823,37663770,37655823,37663770,111105510,XM_022439848.1,pectin acetylesterase 5-like,7947
NC_035780.1,27561071,27572239,27561071,27572239,111136968,XM_022488172.1,histone acetyltransferase type B catalytic subunit-like,11168
NC_035786.1,43075398,43082756,43075398,43082756,111104702,XM_022438785.1,acetyl-CoA acetyltransferase,7358
NC_035786.1,11483021,11490476,11483021,11490476,111105615,XM_022439981.1,acetyl-CoA acetyltransferase,7455
NC_035786.1,20604076,20613207,20604076,20613207,111104248,XM_022438091.1,acetyl-CoA acetyltransferase,9131
NC_035780.1,27867421,27898199,27867421,27898199,111115391,XM_022454120.1,gamma-aminobutyric acid type B receptor subunit 2-like,30778
NC_035782.1,11536640,11543399,11536640,11543399,111122758,XM_022464659.1,fatty acid-binding protein,6759
NC_035780.1,18314104,18326279,18314104,18326279,111110063,XM_022446436.1,glutamic acid-rich protein-like,12175
NC_035780.1,4267666,4269413,4267666,4269413,111114641,XM_022453072.1,cartilage acidic protein 1-like,1747
NC_035781.1,579455,583376,579455,583376,111120938,XM_022461997.1,methylmalonic aciduria and homocystinuria type C protein homolog,3921
NC_035789.1,25095321,25112718,25095321,25112718,111117165,XM_022456247.1,cytoplasmic aconitate hydratase-like,17397
NC_035780.1,50599426,50601596,50599426,50601596,111135367,XM_022485406.1,T-lymphocyte activation antigen CD86-like,2170
NC_035780.1,17095718,17109717,17095718,17109717,111132179,XM_022479948.1,transcriptional activator protein Pur-beta-B-like,13999
NC_035781.1,4182173,4245982,4182173,4245982,111122401,XM_022464181.1,caspase activity and apoptosis inhibitor 1-like,63809
NC_035780.1,7644230,7658994,7644230,7658994,111130876,XM_022478147.1,steroidogenic acute regulatory protein-like,14764
NC_035787.1,6975708,6977083,6975708,6977083,111107539,XM_022442785.1,putative acyl--CoA ligase YdaB,1375
NC_035780.1,11158637,11166705,11158637,11166705,111111509,XM_022448531.1,fatty acyl-CoA reductase 1-like,8068
NC_035780.1,6772926,6783600,6772926,6783600,111132545,XM_022480379.1,peroxisomal acyl-coenzyme A oxidase 1-like,10674
NC_035781.1,29773187,29780305,29773187,29780305,111121118,XM_022462247.1,lipoamide acyltransferase component of branched-chain alpha-keto acid dehydrogenase complex,7118
NC_035780.1,6372753,6379231,6372753,6379231,111121096,XM_022462259.1,transcriptional adapter 3-B-like,6478
NC_035783.1,4535397,4557623,4535397,4557623,111130590,XM_022477755.1,thyroid adenoma-associated protein homolog,22226
NC_035784.1,7324066,7325763,7324165,7325763,111135888,XM_022486330.1,tRNA-specific adenosine deaminase 2-like,1598
NC_035782.1,69749331,69751290,69749331,69751290,111125746,XM_022469829.1,methionine adenosyltransferase 2 subunit beta-like,1959
NC_035780.1,7492336,7498975,7492336,7498975,111130860,XM_022478122.1,serine-rich adhesin for platelets-like,6639
NC_035780.1,48648623,48656857,48648623,48656857,111119825,XM_022460341.1,cell adhesion molecule-related/down-regulated by oncogenes-like,8234
NC_035780.1,8260034,8287945,8260034,8287945,111130935,XM_022478228.1,bromodomain adjacent to zinc finger domain protein 2B-like,27911
NC_035780.1,9503252,9504848,9503252,9504848,111118190,XM_022457527.1,alpha-2 adrenergic receptor-like,1596
NC_035780.1,16581329,16583311,16581329,16583311,111106002,XM_022440513.1,low affinity immunoglobulin epsilon Fc receptor-like,1982
NC_035783.1,31087236,31106547,31087236,31106547,111128209,XM_022473703.1,MAP/microtubule affinity-regulating kinase 3-like,19311
NC_035782.1,73173091,73178407,73173091,73178407,111125137,XM_022468640.1,mothers against decapentaplegic homolog 5-like,5316
NC_035780.1,47249378,47255787,47249378,47255787,111107183,XM_022442233.1,hemagglutinin/amebocyte aggregation factor-like,6409
NC_035786.1,27508114,27517348,27508114,27517348,111103002,XM_022435977.1,glucose-repressible alcohol dehydrogenase transcriptional effector-like,9234
NC_035784.1,66433919,66437667,66433919,66437667,111132935,XM_022480885.1,4-hydroxy-2-oxoglutarate aldolase,3748
NC_035783.1,4529245,4531690,4529245,4531690,111131435,XM_022478956.1,deoxyribose-phosphate aldolase-like,2445
NC_035783.1,6569713,6572178,6569713,6572178,111131512,XM_022479092.1,deoxyribose-phosphate aldolase-like,2465
NC_035784.1,38243774,38248094,38243774,38248094,111136940,XM_022488123.1,fructose-bisphosphate aldolase-like,4320
NC_035784.1,38196730,38206811,38201763,38206811,111135106,XM_022484842.1,fructose-bisphosphate aldolase-like,5048
NC_035784.1,27759425,27769819,27759425,27769819,111135685,XM_022485958.1,putative all-trans-retinol 13,10394
NC_035781.1,29874741,29878033,29874741,29878033,111122027,XM_022463553.1,sterile alpha motif domain-containing protein 15-like,3292
NC_035785.1,31724785,31732707,31724785,31732707,111101010,XM_022433216.1,tubulin alpha-1 chain-like,7922
NC_035780.1,29541557,29565855,29541557,29565855,111135369,XM_022485373.1,collagen alpha-1(I) chain-like,24298
NC_035785.1,36448400,36453600,36448400,36453600,111100041,XM_022431628.1,collagen alpha-1(III) chain-like,5200
NC_035788.1,51609072,51659235,51609072,51659235,111113290,XM_022451418.1,collagen alpha-1(IV) chain-like,50163
NC_035788.1,12808522,12825790,12808522,12825790,111114730,XM_022453182.1,collagen alpha-1(VII) chain-like,17268
NC_035786.1,440696,442283,440696,442283,111104846,XM_022439008.1,collagen alpha-1(VIII) chain-like,1587
NC_035786.1,42988255,42989823,42988255,42989823,111104395,XM_022438315.1,collagen alpha-1(X) chain-like,1568
NC_035788.1,31492689,31506590,31492689,31506590,111115149,XM_022453786.1,collagen alpha-1(XI) chain-like,13901
NC_035780.1,9797183,9809488,9797183,9809488,111105495,XM_022439859.1,collagen alpha-1(XII) chain-like,12305
NC_035780.1,9849517,9856386,9849517,9856386,111110207,XM_022446606.1,collagen alpha-1(XIV) chain-like,6869
NC_035784.1,26828821,26843524,26828821,26843524,111132275,XM_022480067.1,collagen alpha-1(XXIII) chain-like,14703
NC_035784.1,28935650,28945123,28935650,28945123,111132287,XM_022480080.1,collagen alpha-1(XXIV) chain-like,9473
NC_035781.1,33691788,33715736,33691788,33715736,111119571,XM_022459850.1,collagen alpha-1(XXV) chain-like,23948
NC_035784.1,2013234,2015969,2014286,2015969,111136034,XM_022486609.1,UDP-D-xylose:L-fucose alpha-1,1683
NC_035784.1,2013234,2015969,2013649,2015969,111136034,XM_022486608.1,UDP-D-xylose:L-fucose alpha-1,2320
NC_035784.1,2013234,2015969,2013235,2015969,111136034,XM_022486606.1,UDP-D-xylose:L-fucose alpha-1,2734
NC_035784.1,2013234,2015969,2013234,2015969,111136034,XM_022486607.1,UDP-D-xylose:L-fucose alpha-1,2735
NC_035782.1,25014706,25018714,25014775,25018714,111125283,XM_022468889.1,GDP-Man:Man(3)GlcNAc(2)-PP-Dol alpha-1,3939
NC_035782.1,25014706,25018714,25014706,25018714,111125283,XM_022468888.1,GDP-Man:Man(3)GlcNAc(2)-PP-Dol alpha-1,4008
NC_035784.1,1083329,1090209,1083329,1087934,111137190,XM_022488534.1,dol-P-Man:Man(5)GlcNAc(2)-PP-Dol alpha-1,4605
NC_035784.1,13283,18805,13283,18805,111136555,XM_022487493.1,dol-P-Man:Man(5)GlcNAc(2)-PP-Dol alpha-1,5522
NC_035784.1,1083329,1090209,1083329,1090209,111137190,XM_022488533.1,dol-P-Man:Man(5)GlcNAc(2)-PP-Dol alpha-1,6880
NC_035787.1,35722262,35731017,35722262,35730913,111108038,XM_022443524.1,dol-P-Man:Man(7)GlcNAc(2)-PP-Dol alpha-1,8651
NC_035787.1,35722262,35731017,35722262,35731016,111108038,XM_022443523.1,dol-P-Man:Man(7)GlcNAc(2)-PP-Dol alpha-1,8754
NC_035787.1,35722262,35731017,35722262,35731017,111108038,XM_022443525.1,dol-P-Man:Man(7)GlcNAc(2)-PP-Dol alpha-1,8755
NC_035788.1,70005619,70008115,70005619,70008115,111112993,XM_022450908.1,tubulin alpha-1A chain,2496
NC_035783.1,17093655,17096960,17093655,17096960,111130827,XM_022478070.1,thyrostimulin alpha-2 subunit-like,3305
NC_035784.1,26473790,26488332,26473790,26488332,111132274,XM_022480066.1,collagen alpha-2(I) chain-like,14542
NC_035781.1,59667309,59669633,59667309,59669633,111121069,XM_022462182.1,collagen alpha-2(IV) chain-like,2324
NC_035783.1,53133018,53136700,53133018,53136700,111130110,XM_022476815.1,collagen alpha-2(VI) chain-like,3682
NC_035787.1,17372937,17374357,17372937,17374357,111110363,XM_022446837.1,collagen alpha-2(VIII) chain-like,1420
NC_035785.1,33633538,33646811,33633538,33646811,111100522,XM_022432477.1,catenin alpha-2-like,13273
NC_035788.1,73763843,73789244,73763843,73779315,111116056,XM_022455043.1,integrin alpha-2-like,15472
NC_035788.1,73763843,73789244,73763843,73789244,111116056,XM_022455042.1,integrin alpha-2-like,25401
NC_035788.1,77149922,77196515,77150056,77189513,111111392,XM_022448343.1,integrin alpha-2-like,39457
NC_035788.1,77149922,77196515,77150058,77192344,111111392,XM_022448368.1,integrin alpha-2-like,42286
NC_035788.1,77149922,77196515,77150056,77192344,111111392,XM_022448345.1,integrin alpha-2-like,42288
NC_035788.1,77149922,77196515,77150617,77196515,111111392,XM_022448348.1,integrin alpha-2-like,45898
NC_035788.1,77149922,77196515,77150406,77196515,111111392,XM_022448347.1,integrin alpha-2-like,46109
NC_035788.1,77149922,77196515,77150058,77196513,111111392,XM_022448365.1,integrin alpha-2-like,46455
NC_035788.1,77149922,77196515,77150058,77196514,111111392,XM_022448366.1,integrin alpha-2-like,46456
NC_035788.1,77149922,77196515,77150057,77196515,111111392,XM_022448363.1,integrin alpha-2-like,46458
NC_035788.1,77149922,77196515,77150056,77196515,111111392,XM_022448357.1,integrin alpha-2-like,46459
NC_035788.1,77149922,77196515,77149922,77196515,111111392,XM_022448344.1,integrin alpha-2-like,46593
NC_035788.1,72138538,72193972,72144710,72193309,111111487,XM_022448484.1,integrin alpha-2-like,48599
NC_035788.1,72138538,72193972,72144710,72193535,111111487,XM_022448481.1,integrin alpha-2-like,48825
NC_035788.1,72138538,72193972,72144710,72193855,111111487,XM_022448483.1,integrin alpha-2-like,49145
NC_035788.1,72138538,72193972,72144710,72193972,111111487,XM_022448493.1,integrin alpha-2-like,49262
NC_035788.1,72138538,72193972,72141357,72193972,111111487,XM_022448503.1,integrin alpha-2-like,52615
NC_035788.1,72138538,72193972,72138538,72193972,111111487,XM_022448494.1,integrin alpha-2-like,55434
NC_035782.1,21105361,21119643,21105361,21119643,111125057,XM_022468510.1,collagen alpha-3(VI) chain-like,14282
NC_035783.1,17918264,17936172,17918264,17936172,111131713,XM_022479366.1,collagen alpha-4(VI) chain-like,17908
NC_035788.1,70011873,70042374,70011874,70042373,111114593,XM_022452965.1,integrin alpha-4-like,30499
NC_035788.1,70011873,70042374,70011873,70042374,111114593,XM_022452964.1,integrin alpha-4-like,30501
NC_035788.1,70881023,70914527,70881023,70914527,111112736,XM_022450484.1,integrin alpha-4-like,33504
NC_035784.1,78633411,78637531,78633411,78637531,111133195,XM_022481329.1,collagen alpha-5(IV) chain-like,4120
NC_035783.1,26443490,26448494,26443490,26448494,111131334,XM_022478807.1,collagen alpha-5(VI) chain-like,5004
NC_035782.1,19397308,19410773,19397308,19410773,111124088,XM_022466950.1,collagen alpha-6(VI) chain-like,13465
NC_035788.1,60440814,60469691,60440814,60469690,111113265,XM_022451378.1,integrin alpha-6-like,28876
NC_035788.1,60440814,60469691,60440814,60469691,111113265,XM_022451377.1,integrin alpha-6-like,28877
NC_035787.1,10514114,10520126,10514114,10520126,111108598,XM_022444581.1,tubulin alpha-8 chain-like,6012
NC_035788.1,3623562,3641661,3623562,3641661,111111969,XM_022449185.1,integrin alpha-8-like,18099
NC_035788.1,67300259,67331930,67300259,67331930,111113404,XM_022451656.1,integrin alpha-8-like,31671
NC_035788.1,70645931,70681657,70645931,70681657,111114114,XM_022452403.1,integrin alpha-8-like,35726
NC_035788.1,66848587,66870890,66848587,66870890,111115505,XM_022454267.1,integrin alpha-9-like,22303
NC_035787.1,59754427,59759144,59754427,59759144,111106925,XM_022441805.1,plasma alpha-L-fucosidase-like,4717
NC_035787.1,59745194,59750288,59745194,59750288,111106921,XM_022441802.1,plasma alpha-L-fucosidase-like,5094
NC_035787.1,59874480,59880140,59874480,59880140,111106920,XM_022441801.1,plasma alpha-L-fucosidase-like,5660
NC_035787.1,59883626,59890362,59883626,59890362,111106928,XM_022441810.1,plasma alpha-L-fucosidase-like,6736
NC_035787.1,59729664,59737242,59729664,59737242,111106930,XM_022441812.1,plasma alpha-L-fucosidase-like,7578
NC_035787.1,59857318,59866597,59857318,59866454,111106926,XM_022441808.1,plasma alpha-L-fucosidase-like,9136
NC_035787.1,59857318,59866597,59857319,59866597,111106926,XM_022441806.1,plasma alpha-L-fucosidase-like,9278
NC_035788.1,43924833,43935143,43924833,43935143,111112079,XM_022449380.1,N-acetylglucosamine-1-phosphodiester alpha-N-acetylglucosaminidase-like,10310
NC_035784.1,68524264,68535352,68524264,68535352,111136957,XM_022488149.1,N-acetylglucosamine-1-phosphodiester alpha-N-acetylglucosaminidase-like,11088
NC_035786.1,26291978,26293521,26291978,26293521,111103047,XM_022436047.1,N-acetylglucosamine-1-phosphodiester alpha-N-acetylglucosaminidase-like,1543
NC_035786.1,26297343,26299094,26297343,26299094,111104964,XM_022439143.1,N-acetylglucosamine-1-phosphodiester alpha-N-acetylglucosaminidase-like,1751
NC_035785.1,22186347,22188118,22186347,22188118,111101881,XM_022434527.1,N-acetylglucosamine-1-phosphodiester alpha-N-acetylglucosaminidase-like,1771
NC_035785.1,44914906,44916683,44914906,44916683,111101733,XM_022434322.1,N-acetylglucosamine-1-phosphodiester alpha-N-acetylglucosaminidase-like,1777
NC_035784.1,56861682,56864167,56861682,56864167,111134296,XM_022483197.1,N-acetylglucosamine-1-phosphodiester alpha-N-acetylglucosaminidase-like,2485
NC_035784.1,41547304,41549974,41547304,41549974,111137598,XM_022489117.1,N-acetylglucosamine-1-phosphodiester alpha-N-acetylglucosaminidase-like,2670
NC_035785.1,44906635,44910049,44906635,44910049,111099543,XM_022430857.1,N-acetylglucosamine-1-phosphodiester alpha-N-acetylglucosaminidase-like,3414
NC_035784.1,39342992,39347022,39342992,39347022,111137372,XM_022488810.1,N-acetylglucosamine-1-phosphodiester alpha-N-acetylglucosaminidase-like,4030
NC_035783.1,31403766,31408967,31403766,31408967,111129608,XM_022476063.1,N-acetylglucosamine-1-phosphodiester alpha-N-acetylglucosaminidase-like,5201
NC_035784.1,53840325,53849843,53840325,53849843,111132788,XM_022480611.1,N-acetylglucosamine-1-phosphodiester alpha-N-acetylglucosaminidase-like,9518
NC_035783.1,3316332,3321589,3316332,3321589,111131674,XM_022479309.1,peptidyl-glycine alpha-amidating monooxygenase B-like,5257
NC_035783.1,17418786,17432517,17418786,17432517,111129951,XM_022476507.1,neutral alpha-glucosidase AB-like,13731
NC_035781.1,4450022,4461673,4450026,4461610,111120703,XM_022461627.1,lysosomal alpha-glucosidase-like,11584
NC_035781.1,4450022,4461673,4450027,4461673,111120703,XM_022461626.1,lysosomal alpha-glucosidase-like,11646
NC_035781.1,4450022,4461673,4450022,4461673,111120703,XM_022461628.1,lysosomal alpha-glucosidase-like,11651
NC_035786.1,57042999,57066098,57042999,57066098,111102931,XM_022435885.1,coiled-coil alpha-helical rod protein 1-like,23099
NC_035783.1,22123130,22127548,22123130,22127548,111130769,XM_022478000.1,peptidylglycine alpha-hydroxylating monooxygenase-like,4418
NC_035788.1,62084376,62091915,62084376,62091915,111112746,XM_022450499.1,interferon alpha-inducible protein 27-like protein 2B,7539
NC_035782.1,28757300,28760279,28757300,28760279,111126613,XM_022471371.1,probable alpha-ketoglutarate-dependent hypophosphite dioxygenase,2979
NC_035781.1,19900272,19911246,19900272,19911246,111119851,XM_022460377.1,lysosomal alpha-mannosidase-like,10974
NC_035781.1,19887164,19898298,19887164,19898298,111119850,XM_022460376.1,lysosomal alpha-mannosidase-like,11134
NC_035784.1,7325409,7329798,7325409,7329798,111135886,XM_022486325.1,internal alternative NAD(P)H-ubiquinone oxidoreductase A1,4389
NC_035783.1,46211131,46259811,46211131,46259729,111128163,XM_022473638.1,protein amalgam-like,48598
NC_035783.1,46211131,46259811,46211131,46259811,111128163,XM_022473639.1,protein amalgam-like,48680
NC_035783.1,30796057,30812320,30796057,30811202,111130428,XM_022477501.1,peptide-N(4)-(N-acetyl-beta-glucosaminyl)asparagine amidase-like,15145
NC_035783.1,30796057,30812320,30796057,30812320,111130428,XM_022477500.1,peptide-N(4)-(N-acetyl-beta-glucosaminyl)asparagine amidase-like,16263
NC_035784.1,84945597,84958656,84945597,84958656,111134418,XM_022483405.1,fatty-acid amide hydrolase 2-like,13059
NC_035786.1,34442000,34444067,34442000,34444067,111103563,XM_022436914.1,putative amidohydrolase YtcJ,2067
NC_035782.1,56391344,56401071,56391344,56401071,111124752,XM_022467915.1,glutamyl-tRNA(Gln) amidotransferase subunit B,9727
NC_035787.1,34442503,34448648,34442503,34448648,111109674,XM_022445890.1,glutamine amidotransferase-like class 1 domain-containing protein 1,6145
NC_035783.1,15696587,15713666,15696587,15713666,111130970,XM_022478278.1,mitochondrial amidoxime reducing component 2-like,17079
NC_035781.1,47787573,47790584,47787573,47790584,111120925,XM_022461979.1,mitochondrial amidoxime-reducing component 1-like,3011
NC_035781.1,14451182,14464549,14451182,14464549,111120533,XM_022461328.1,FMRFamide-activated amiloride-sensitive sodium channel-like,13367
NC_035783.1,28489497,28494552,28489497,28494552,111129375,XM_022475728.1,putative amine oxidase [copper-containing],5055
NC_035781.1,41733616,41735087,41733616,41735087,111120301,XM_022461030.1,trace amine-associated receptor 4-like,1471
NC_035781.1,14020900,14031473,14020900,14031473,111119910,XM_022460485.1,proton-coupled amino acid transporter 2-like,10573
NC_035781.1,54749710,54755667,54749710,54755667,111120850,XM_022461849.1,methionine aminopeptidase 1-like,5957
NC_035784.1,80550631,80563388,80550631,80563388,111137751,XM_022489383.1,cytosol aminopeptidase-like,12757
NC_035781.1,10446696,10459616,10446696,10459616,111119860,XM_022460404.1,glutamyl aminopeptidase-like,12920
NC_035789.1,4889569,4912213,4889569,4912213,111116710,XM_022455698.1,glutamyl aminopeptidase-like,22644
NC_035784.1,96579810,96606206,96579810,96606206,111134238,XM_022483110.1,puromycin-sensitive aminopeptidase-like,26396
NC_035784.1,81408700,81415618,81408700,81415618,111099180,XM_022430589.1,cytosol aminopeptidase-like,6918
NC_035780.1,54770739,54778433,54770739,54778433,111136770,XM_022487874.1,aspartyl aminopeptidase-like,7694
NC_035781.1,26652728,26673802,26652728,26673802,111118324,XM_022457729.1,glutamine--fructose-6-phosphate aminotransferase [isomerizing] 2-like,21074
NC_035783.1,39147390,39164547,39154324,39164547,111128099,XM_022473552.1,kynurenine/alpha-aminoadipate aminotransferase,10223
NC_035781.1,31836439,31852402,31836440,31847450,111121530,XM_022462845.1,kynurenine/alpha-aminoadipate aminotransferase,11010
NC_035783.1,39147390,39164547,39152246,39164547,111128099,XM_022473551.1,kynurenine/alpha-aminoadipate aminotransferase,12301
NC_035781.1,31836439,31852402,31836442,31849043,111121530,XM_022462843.1,kynurenine/alpha-aminoadipate aminotransferase,12601
NC_035784.1,21715344,21728757,21715344,21728757,111137596,XM_022489115.1,aspartate aminotransferase,13413
NC_035783.1,39147390,39164547,39150675,39164547,111128099,XM_022473550.1,kynurenine/alpha-aminoadipate aminotransferase,13872
NC_035781.1,31836439,31852402,31836447,31852397,111121530,XM_022462847.1,kynurenine/alpha-aminoadipate aminotransferase,15950
NC_035781.1,31836439,31852402,31836448,31852402,111121530,XM_022462846.1,kynurenine/alpha-aminoadipate aminotransferase,15954
NC_035783.1,39147390,39164547,39147390,39164547,111128099,XM_022473553.1,kynurenine/alpha-aminoadipate aminotransferase,17157
NC_035783.1,39172435,39176026,39172435,39176026,111128100,XM_022473554.1,kynurenine/alpha-aminoadipate aminotransferase,3591
NC_035784.1,81831516,81836683,81831516,81836683,111134810,XM_022484227.1,aspartate aminotransferase,5167
NC_035787.1,38909514,38915022,38909514,38915022,111109618,XM_022445812.1,4-aminobutyrate aminotransferase,5508
NC_035784.1,69019685,69025805,69019685,69025347,111136290,XM_022487038.1,ornithine aminotransferase,5662
NC_035784.1,69019685,69025805,69019685,69025805,111136290,XM_022487037.1,ornithine aminotransferase,6120
NC_035787.1,34871704,34878171,34871704,34878171,111106568,XM_022441292.1,4-aminobutyrate aminotransferase,6467
NC_035781.1,31836439,31852402,31836440,31843101,111121530,XM_022462844.1,kynurenine/alpha-aminoadipate aminotransferase,6661
NC_035780.1,28308822,28316908,28308822,28316908,111110658,XM_022447254.1,branched-chain-amino-acid aminotransferase,8086
NC_035781.1,31824812,31833292,31824812,31833292,111121858,XM_022463324.1,kynurenine/alpha-aminoadipate aminotransferase,8480
NC_035781.1,41356917,41366499,41356917,41366499,111119686,XM_022460104.1,4-aminobutyrate aminotransferase,9582
NC_035784.1,2729710,2747583,2730310,2747583,111135147,XM_022484923.1,tyrosine aminotransferase-like,17273
NC_035784.1,2729710,2747583,2729710,2747583,111135147,XM_022484922.1,tyrosine aminotransferase-like,17873
NC_035784.1,55163433,55184865,55163433,55184864,111137062,XM_022488305.1,serine--pyruvate aminotransferase-like,21431
NC_035788.1,30219483,30227096,30219483,30227096,111115125,XM_022453750.1,phosphoserine aminotransferase-like,7613
NC_035780.1,27551561,27560912,27551561,27560912,111136961,XM_022488160.1,aspartate aminotransferase-like,9351
NC_035788.1,36950968,36960849,36950968,36960849,111116065,XM_022455052.1,phosphoserine aminotransferase-like,9881
NC_035787.1,46918724,46930197,46918724,46930197,111105890,XM_022440346.1,histidine ammonia-lyase-like,11473
NC_035781.1,40911281,40915272,40911281,40915272,111119739,XM_022460195.1,L-threonine ammonia-lyase-like,3991
NC_035781.1,778370,786566,778406,786566,111122100,XM_022463658.1,L-threonine ammonia-lyase-like,8160
NC_035781.1,778370,786566,778370,786565,111122100,XM_022463660.1,L-threonine ammonia-lyase-like,8195
NC_035780.1,2852608,2861907,2852608,2861907,111129522,XM_022475977.1,putative ammonium transporter 1,9299
NC_035781.1,26034578,26039383,26034578,26039383,111121057,XM_022462160.1,paired amphipathic helix protein Sin3a-like,4805
NC_035782.1,55021730,55024229,55021730,55024229,111123540,XM_022465930.1,serum amyloid A-5 protein-like,2499
NC_035786.1,50280411,50282231,50280411,50282231,111104579,XM_022438600.1,C5a anaphylatoxin chemotactic receptor 1-like,1820
NC_035782.1,59113887,59132320,59113887,59132320,111125402,XM_022469168.1,A-kinase anchor protein 7-like,18433
NC_035782.1,57476122,57482389,57476122,57482389,111126644,XM_022471423.1,A-agglutinin anchorage subunit-like,6267
NC_035780.1,2028071,2046722,2028071,2046722,111121733,XM_022463175.1,LIM and SH3 domain protein 1-like,18651
NC_035781.1,52874497,52880595,52874497,52880595,111122179,XM_022463800.1,Fanconi anemia core complex-associated protein 24-like,6098
NC_035782.1,45383541,45387154,45383542,45387154,111125165,XM_022468699.1,protein angel homolog 2-like,3612
NC_035780.1,58690843,58696862,58690843,58696862,111134428,XM_022483465.1,brain-specific angiogenesis inhibitor 1-like,6019
NC_035782.1,42854916,42862524,42854916,42860433,111123696,XM_022466217.1,type-1 angiotensin II receptor B-like,5517
NC_035783.1,24179714,24208032,24179714,24208031,111130107,XM_022476812.1,carbonic anhydrase 2-like,28317
NC_035781.1,41266816,41271014,41266816,41271014,111120606,XM_022461450.1,carbonic anhydrase-like,4198
NC_035780.1,55867872,55873360,55867872,55873360,111125708,XM_022469768.1,carbonic anhydrase-like,5488
NC_035781.1,41248671,41255055,41248671,41255055,111120607,XM_022461451.1,carbonic anhydrase-like,6384
NC_035782.1,69132008,69146659,69132008,69146659,111127093,XM_022472112.1,carbonic anhydrase-related protein 10-like,14651
NC_035780.1,7993660,7997415,7993660,7997415,111134162,XM_022483001.1,sulfate anion transporter 1-like,3755
NC_035781.1,14792942,14797089,14792942,14797089,111119917,XM_022460495.1,voltage-dependent anion-selective channel protein 2-like,4147
NC_035780.1,20610053,20624705,20610053,20624705,111123848,XM_022466480.1,putative ankyrin repeat protein RF_0381,14652
NC_035780.1,4012455,4013027,4012455,4013027,111130177,XM_022476941.1,phytochrome-interacting ankyrin-repeat protein 2-like,572
NC_035783.1,11628923,11646218,11628923,11646218,111127724,XM_022472955.1,DNA annealing helicase and endonuclease ZRANB3-like,17295
NC_035784.1,95856100,95866005,95856100,95866005,111134745,XM_022484084.1,ventral anterior homeobox 2b-like,9905
NC_035780.1,63628598,63632075,63628598,63632075,111103534,XM_022436913.1,ferredoxin-fold anticodon-binding domain-containing protein 1-like,3477
NC_035780.1,46876132,46883168,46876132,46883168,111115421,XM_022454160.1,sperm-associated antigen 16 protein-like,7036
NC_035780.1,55212955,55216661,55212955,55216661,111108125,XM_022443724.1,CD209 antigen-like protein 2,3706
NC_035780.1,8717138,8727459,8717144,8727459,111114134,XM_022452426.1,CD81 antigen-like,10315
NC_035780.1,8717138,8727459,8717140,8727459,111114134,XM_022452438.1,CD81 antigen-like,10319
NC_035780.1,8717138,8727459,8717138,8727459,111114134,XM_022452457.1,CD81 antigen-like,10321
NC_035780.1,10200744,10214756,10200744,10212013,111115832,XM_022454704.1,CD151 antigen-like,11269
NC_035780.1,31985632,31997345,31985632,31997345,111125239,XM_022468819.1,CD63 antigen-like,11713
NC_035780.1,12018507,12035048,12023277,12035048,111110084,XM_022446454.1,CD151 antigen-like,11771
NC_035780.1,12018507,12035048,12022493,12035048,111110084,XM_022446446.1,CD151 antigen-like,12555
NC_035784.1,12812595,12825595,12812595,12825595,111134612,XM_022483789.1,CD109 antigen-like,13000
NC_035784.1,36488860,36621198,36488938,36621198,111133801,XM_022482471.1,CD109 antigen-like,132260
NC_035784.1,36488860,36621198,36488873,36621198,111133801,XM_022482472.1,CD109 antigen-like,132325
NC_035784.1,36488860,36621198,36488860,36621198,111133801,XM_022482470.1,CD109 antigen-like,132338
NC_035780.1,10200744,10214756,10200744,10214756,111115832,XM_022454697.1,CD151 antigen-like,14012
NC_035784.1,90016712,90186559,90037245,90182305,111136261,XM_022486982.1,major antigen-like,145060
NC_035784.1,90016712,90186559,90037244,90182305,111136261,XM_022486984.1,major antigen-like,145061
NC_035784.1,21225212,21241752,21225212,21241752,111133342,XM_022481651.1,CD209 antigen-like,16540
NC_035780.1,12018507,12035048,12018507,12035048,111110084,XM_022446437.1,CD151 antigen-like,16541
NC_035784.1,90016712,90186559,90016712,90182305,111136261,XM_022486983.1,major antigen-like,165593
NC_035784.1,54073596,54075985,54073596,54075985,111134406,XM_022483378.1,CD82 antigen-like,2389
NC_035780.1,37665584,37668044,37665584,37668044,111107286,XM_022442423.1,CD166 antigen-like,2460
NC_035782.1,50762632,50788968,50762632,50788967,111123575,XM_022465991.1,CD109 antigen-like,26335
NC_035782.1,50762632,50788968,50762632,50788968,111123575,XM_022465989.1,CD109 antigen-like,26336
NC_035782.1,71523183,71552387,71523183,71552387,111124694,XM_022467809.1,CD109 antigen-like,29204
NC_035782.1,42063586,42066565,42063586,42066547,111127640,XM_022472899.1,CD63 antigen-like,2961
NC_035782.1,42063586,42066565,42063586,42066565,111127640,XM_022472898.1,CD63 antigen-like,2979
NC_035782.1,42117766,42120788,42117766,42120788,111124242,XM_022467098.1,CD151 antigen-like,3022
NC_035780.1,60345429,60348772,60345429,60348772,111115068,XM_022453650.1,CD82 antigen-like,3343
NC_035784.1,90016712,90186559,90111915,90145613,111136261,XM_022486994.1,major antigen-like,33698
NC_035782.1,72683266,72717330,72683266,72717284,111124638,XM_022467693.1,CD109 antigen-like,34018
NC_035782.1,72683266,72717330,72683266,72717330,111124638,XM_022467692.1,CD109 antigen-like,34064
NC_035780.1,41851789,41886586,41851789,41886586,111131392,XM_022478885.1,CD82 antigen-like,34797
NC_035786.1,12473152,12476839,12473152,12476839,111103752,XM_022437209.1,CD209 antigen-like,3687
NC_035786.1,31505978,31545228,31505978,31545228,111105010,XM_022439187.1,CD109 antigen-like,39250
NC_035783.1,39253183,39258195,39253183,39258195,111127787,XM_022473035.1,CD151 antigen-like,5012
NC_035786.1,28875402,28927018,28875402,28927018,111104989,XM_022439166.1,CD109 antigen-like,51616
NC_035780.1,8717138,8727459,8721630,8727459,111114134,XM_022452450.1,CD81 antigen-like,5829
NC_035784.1,90016712,90186559,90111915,90172473,111136261,XM_022486991.1,major antigen-like,60558
NC_035781.1,34981196,34987385,34981196,34987385,111117585,XM_022456742.1,CD151 antigen-like,6189
NC_035787.1,52752456,52758936,52752456,52758936,111108611,XM_022444595.1,CD151 antigen-like,6480
NC_035781.1,1995797,2002451,1995797,2002451,111121756,XM_022463185.1,CD82 antigen-like,6654
NC_035780.1,8717138,8727459,8720635,8727459,111114134,XM_022452433.1,CD81 antigen-like,6824
NC_035780.1,8717138,8727459,8720631,8727459,111114134,XM_022452444.1,CD81 antigen-like,6828
NC_035784.1,90016712,90186559,90111915,90182304,111136261,XM_022486993.1,major antigen-like,70389
NC_035784.1,90016712,90186559,90111915,90182305,111136261,XM_022486987.1,major antigen-like,70390
NC_035787.1,50802795,50873309,50802795,50873309,111106857,XM_022441704.1,CD109 antigen-like,70514
NC_035784.1,90016712,90186559,90111915,90186546,111136261,XM_022486989.1,major antigen-like,74631
NC_035784.1,90016712,90186559,90111915,90186559,111136261,XM_022486990.1,major antigen-like,74644
NC_035781.1,30632996,30640564,30632996,30640564,111122208,XM_022463837.1,CD151 antigen-like,7568
NC_035780.1,10200744,10214756,10200744,10208357,111115832,XM_022454732.1,CD151 antigen-like,7613
NC_035787.1,11612743,11620869,11612743,11620466,111110094,XM_022446450.1,CD82 antigen-like,7723
NC_035781.1,1493880,1501906,1493880,1501906,111121085,XM_022462210.1,CD82 antigen-like,8026
NC_035787.1,11612743,11620869,11612743,11620869,111110094,XM_022446449.1,CD82 antigen-like,8126
NC_035780.1,10200744,10214756,10200744,10208946,111115832,XM_022454724.1,CD151 antigen-like,8202
NC_035780.1,12018507,12035048,12026708,12035048,111110084,XM_022446462.1,CD151 antigen-like,8340
NC_035782.1,35764436,35773692,35764436,35773692,111124716,XM_022467842.1,CD63 antigen-like,9256
NC_035782.1,20511155,20520506,20511155,20520506,111126343,XM_022470886.1,CD63 antigen-like,9351
NC_035780.1,48959301,49017932,48959301,49017932,111113100,XM_022451095.1,carcinoembryonic antigen-related cell adhesion molecule 2-like,58631
NC_035781.1,14932223,14944287,14932223,14944287,111119517,XM_022459726.1,wings apart-like protein homolog,12064
NC_035781.1,17688814,17709987,17688814,17709987,111121166,XM_022462317.1,bifunctional apoptosis regulator-like,21173
NC_035780.1,22578293,22580477,22578293,22580477,111122449,XM_022464261.1,nuclear apoptosis-inducing factor 1-like,2184
NC_035780.1,55193277,55197587,55193277,55197587,111135797,XM_022486178.1,fas apoptotic inhibitory molecule 1-like,4310
NC_035782.1,37512649,37519440,37512649,37519440,111126839,XM_022471741.1,protein app1-like,6791
NC_035784.1,24903109,24926165,24903109,24926165,111136002,XM_022486544.1,Golgi apparatus protein 1-like,23056
NC_035782.1,36592144,36599266,36592144,36599266,111127489,XM_022472686.1,non-classical arabinogalactan protein 31-like,7122
NC_035780.1,38035337,38039267,38035337,38039267,111117041,XM_022456110.1,protein archease-like,3930
NC_035780.1,20466757,20471978,20466757,20471978,111113171,XM_022451212.1,protein arginine N-methyltransferase 1-like,5221
NC_035784.1,21423839,21438648,21423839,21438648,111136723,XM_022487803.1,probable arginine--tRNA ligase,14809
NC_035784.1,70714515,70718955,70714515,70718955,111137997,XM_022489741.1,protein argonaute 3-like,4440
NC_035780.1,24228355,24248087,24228356,24248087,111130325,XM_022477240.1,protein argonaute-2-like,19731
NC_035780.1,24228355,24248087,24228355,24248087,111130325,XM_022477281.1,protein argonaute-2-like,19732
NC_035780.1,20571017,20597711,20571017,20597711,111123818,XM_022466430.1,protein argonaute-2-like,26694
NC_035783.1,10994336,11023056,10994336,11023056,111131857,XM_022479598.1,TOG array regulator of axonemal microtubules protein 1-like,28720
NC_035781.1,31412440,31415117,31412440,31415117,111121109,XM_022462235.1,growth arrest and DNA damage-inducible protein GADD45 alpha-like,2677
NC_035783.1,16114035,16116409,16114035,16116409,111130818,XM_022478061.1,growth arrest-specific protein 1 homolog,2374
NC_035787.1,59032001,59043180,59032001,59043047,111105836,XM_022440262.1,protein artemis-like,11046
NC_035787.1,59032001,59043180,59032001,59043086,111105836,XM_022440263.1,protein artemis-like,11085
NC_035787.1,59032001,59043180,59032001,59043180,111105836,XM_022440261.1,protein artemis-like,11179
NC_035787.1,55180242,55191921,55180242,55191786,111106142,XM_022440691.1,protein artemis-like,11544
NC_035787.1,55180242,55191921,55180242,55191921,111106142,XM_022440690.1,protein artemis-like,11679
NC_035786.1,42551806,42555393,42551806,42555393,111104147,XM_022437945.1,protein artichoke-like,3587
NC_035784.1,55014643,55021401,55014643,55021401,111137044,XM_022488272.1,protein artichoke-like,6758
NC_035782.1,65053244,65070357,65053244,65070357,111124379,XM_022467230.1,probable asparagine--tRNA ligase,17113
NC_035783.1,19851129,19856753,19851129,19856753,111130193,XM_022476965.1,threonine aspartase 1-like,5624
NC_035780.1,39657448,39665957,39657448,39665957,111133529,XM_022482009.1,lysosomal aspartic protease-like,8509
NC_035780.1,2653510,2664271,2653510,2664271,111112387,XM_022449872.1,dynein assembly factor 1,10761
NC_035781.1,57917161,57920994,57917161,57920994,111118425,XM_022457902.1,spermatogenesis associated 6-like protein,3833
NC_035780.1,29477554,29490484,29477554,29490484,111137522,XM_022488999.1,ras association domain-containing protein 9-like,12930
NC_035783.1,35527983,35537501,35527983,35537501,111128228,XM_022473735.1,protein asteroid homolog 1-like,9518
NC_035787.1,61512636,61517361,61512636,61517361,111106015,XM_022440523.1,mesencephalic astrocyte-derived neurotrophic factor homolog,4725
NC_035782.1,20081304,20087379,20081304,20087379,111127662,XM_022472942.1,out at first protein-like,6075
NC_035781.1,10481049,10483289,10481049,10483289,111119882,XM_022460449.1,protein atonal homolog 8-like,2240
NC_035781.1,55883389,55884454,55883389,55884454,111122093,XM_022463650.1,protein atonal-like,1065
NC_035781.1,58710173,58711290,58710173,58711290,111119796,XM_022460295.1,protein atonal-like,1117
NC_035783.1,35685139,35688504,35685139,35688504,111130724,XM_022477935.1,optic atrophy 3 protein homolog,3365
NC_035781.1,53513747,53527494,53513747,53527494,111118809,XM_022458441.1,scaffold attachment factor B2-like,13747
NC_035781.1,46074338,46092660,46074338,46092660,111117852,XM_022457082.1,HAUS augmin-like complex subunit 3,18322
NC_035786.1,606808,610172,606808,610172,111103559,XM_022436902.1,uveal autoantigen with coiled-coil domains and ankyrin repeats-like,3364
NC_035781.1,35510514,35514965,35510514,35514965,111120523,XM_022461302.1,protein aveugle-like,4451
NC_035780.1,48069619,48076808,48069619,48076808,111121250,XM_022462428.1,failed axon connections homolog,7189
NC_035782.1,38901828,38936667,38901828,38936667,111123610,XM_022466058.1,phosphorylase b kinase regulatory subunit alpha,34839
NC_035784.1,58107041,58109761,58107041,58109761,111138109,XM_022489918.1,cytochrome b-245 light chain-like,2720
NC_035780.1,372174,376974,372174,376974,111101799,XM_022434407.1,cytochrome b-c1 complex subunit 7-like,4800
NC_035780.1,777050,782032,777050,782032,111130095,XM_022476914.1,NADH-cytochrome b5 reductase 3-like,4982
NC_035783.1,19428992,19431777,19428992,19431777,111130921,XM_022478207.1,cytochrome b5-like,2785
NC_035784.1,22204928,22208051,22204928,22208051,111134235,XM_022483103.1,cytochrome b5-like,3123
NC_035787.1,5885827,5890100,5885827,5890100,111108726,XM_022444774.1,cytochrome b561 domain-containing protein 2-like,4273
NC_035788.1,89533874,89537372,89533874,89537372,111114279,XM_022452565.1,cytochrome b561-like,3498
NC_035788.1,88070493,88074090,88070493,88074090,111114253,XM_022452537.1,cytochrome b561-like,3597
NC_035782.1,17525254,17533124,17525254,17533124,111127605,XM_022472857.1,erythrocyte band 7 integral membrane protein-like,7870
NC_035783.1,19551442,19568441,19551442,19568441,111131591,XM_022479198.1,protein bark beetle-like,16999
NC_035783.1,190996,212157,190996,212157,111131097,XM_022478445.1,TFIIH basal transcription factor complex helicase XPD subunit-like,21161
NC_035784.1,15081122,15158214,15081122,15158214,111137781,XM_022489428.1,peripheral-type benzodiazepine receptor-associated protein 1-like,77092
NC_035780.1,13411140,13425265,13411140,13425265,111136389,XM_022487208.1,amyloid beta A4 protein-like,14125
NC_035781.1,14400768,14416443,14400768,14416442,111120548,XM_022461346.1,UDP-GlcNAc:betaGal beta-1,15674
NC_035781.1,14400768,14416443,14400768,14416443,111120548,XM_022461347.1,UDP-GlcNAc:betaGal beta-1,15675
NC_035780.1,21064616,21135337,21112852,21135337,111136299,XM_022487056.1,N-acetyllactosaminide beta-1,22485
NC_035780.1,25710440,25719653,25715754,25719652,111129668,XM_022476133.1,N-acetyllactosaminide beta-1,3898
NC_035780.1,21064616,21135337,21090541,21135337,111136299,XM_022487064.1,N-acetyllactosaminide beta-1,44796
NC_035780.1,21154857,21161443,21154857,21161443,111111947,XM_022449169.1,N-acetyllactosaminide beta-1,6586
NC_035780.1,21215430,21222107,21215430,21222107,111106297,XM_022440917.1,N-acetyllactosaminide beta-1,6677
NC_035782.1,21241904,21251310,21244448,21251310,111125443,XM_022469260.1,N-acetyllactosaminide beta-1,6862
NC_035780.1,21064616,21135337,21064616,21135337,111136299,XM_022487072.1,N-acetyllactosaminide beta-1,70721
NC_035782.1,21241904,21251310,21243866,21251310,111125443,XM_022469255.1,N-acetyllactosaminide beta-1,7444
NC_035780.1,26443985,26451844,26443985,26451844,111119853,XM_022460402.1,N-acetyllactosaminide beta-1,7859
NC_035782.1,21241904,21251310,21242706,21251310,111125443,XM_022469256.1,N-acetyllactosaminide beta-1,8604
NC_035782.1,21241904,21251310,21242684,21251310,111125443,XM_022469259.1,N-acetyllactosaminide beta-1,8626
NC_035780.1,25710440,25719653,25710440,25719653,111129668,XM_022476140.1,N-acetyllactosaminide beta-1,9213
NC_035782.1,21241904,21251310,21241904,21251310,111125443,XM_022469257.1,N-acetyllactosaminide beta-1,9406
NC_035788.1,78856056,78874757,78856056,78874757,111113326,XM_022451516.1,integrin beta-1-A-like,18701
NC_035788.1,78817236,78842294,78817236,78842294,111116158,XM_022455159.1,integrin beta-1-A-like,25058
NC_035781.1,2439883,2445246,2439883,2445246,111120133,XM_022460850.1,integrin beta-1-binding protein 1-like,5363
NC_035788.1,10701761,10705809,10701761,10705809,111113476,XM_022451772.1,pregnancy-specific beta-1-glycoprotein 5-like,4048
NC_035784.1,71396287,71404241,71396288,71404241,111135714,XM_022486014.1,integrin beta-1-like,7953
NC_035784.1,71396287,71404241,71396287,71404241,111135714,XM_022486013.1,integrin beta-1-like,7954
NC_035782.1,41331497,41340898,41331497,41340898,111125405,XM_022469176.1,protocadherin beta-15-like,9401
NC_035788.1,21590968,21605167,21590968,21605167,111112955,XM_022450848.1,integrin beta-3-like,14199
NC_035788.1,21568445,21585072,21568445,21585072,111112953,XM_022450847.1,integrin beta-3-like,16627
NC_035788.1,21439774,21462704,21439774,21462704,111112951,XM_022450844.1,integrin beta-3-like,22930
NC_035788.1,21611320,21638685,21611320,21638685,111112952,XM_022450845.1,integrin beta-3-like,27365
NC_035782.1,41125521,41135104,41125521,41135104,111125408,XM_022469193.1,protocadherin beta-3-like,9583
NC_035784.1,79782791,79783246,79782791,79783246,111132624,XM_022480452.1,tubulin beta-4 chain-like,455
NC_035783.1,17069137,17085209,17069137,17085209,111128799,XM_022474655.1,thyrostimulin beta-5 subunit-like,16072
NC_035784.1,48761508,48762843,48761508,48762843,111132420,XM_022480223.1,integrin beta-5-like,1335
NC_035788.1,21521075,21552064,21521075,21552064,111113608,XM_022451902.1,integrin beta-5-like,30989
NC_035782.1,41376340,41385834,41376342,41385833,111125411,XM_022469194.1,protocadherin beta-8-like,9491
NC_035782.1,41376340,41385834,41376340,41385834,111125411,XM_022469195.1,protocadherin beta-8-like,9494
NC_035785.1,1846925,1853528,1846925,1853528,111101492,XM_022434010.1,probable beta-D-xylosidase 2,6603
NC_035781.1,35332644,35334601,35332644,35334601,111122201,XM_022463825.1,thermostable beta-glucosidase B-like,1957
NC_035785.1,2060007,2065610,2060007,2065610,111100104,XM_022431719.1,periplasmic beta-glucosidase-like,5603
NC_035782.1,56216235,56223796,56216235,56223796,111122836,XM_022464837.1,dolichyl-phosphate beta-glucosyltransferase-like,7561
NC_035780.1,29899247,29904215,29899247,29904215,111132880,XM_022480806.1,putative beta-hexosaminidase,4968
NC_035784.1,16573728,16576811,16573728,16576811,111134889,XM_022484418.1,aspartate beta-hydroxylase domain-containing protein 2-like,3083
NC_035780.1,38990747,39000794,38990747,39000794,111107354,XM_022442531.1,aspartyl/asparaginyl beta-hydroxylase-like,10047
NC_035781.1,826552,837983,826554,837983,111121470,XM_022462765.1,tyramine beta-hydroxylase-like,11429
NC_035781.1,826552,837983,826552,837983,111121470,XM_022462767.1,tyramine beta-hydroxylase-like,11431
NC_035780.1,37500664,37516327,37500664,37516327,111107258,XM_022442371.1,aspartyl/asparaginyl beta-hydroxylase-like,15663
NC_035787.1,37830870,37907696,37830870,37858488,111106355,XM_022441010.1,tyramine beta-hydroxylase-like,27618
NC_035784.1,48874012,48878623,48874012,48878623,111133921,XM_022482656.1,dopamine beta-hydroxylase-like,4611
NC_035782.1,60167858,60173183,60167858,60173183,111122967,XM_022465015.1,dopamine beta-hydroxylase-like,5325
NC_035783.1,29958621,29964217,29958621,29964217,111127802,XM_022473052.1,tyramine beta-hydroxylase-like,5596
NC_035787.1,37830870,37907696,37830870,37907696,111106355,XM_022441011.1,tyramine beta-hydroxylase-like,76826
NC_035782.1,66946546,66954869,66946546,66954868,111125361,XM_022469094.1,dopamine beta-hydroxylase-like,8322
NC_035782.1,66946546,66954869,66946546,66954869,111125361,XM_022469095.1,dopamine beta-hydroxylase-like,8323
NC_035782.1,66764188,66772710,66764188,66772710,111127321,XM_022472442.1,dopamine beta-hydroxylase-like,8522
NC_035781.1,9333564,9342227,9333564,9342227,111118696,XM_022458275.1,tyramine beta-hydroxylase-like,8663
NC_035784.1,9443223,9449171,9443223,9449171,111137166,XM_022488487.1,3 beta-hydroxysteroid dehydrogenase/Delta 5-->4-isomerase type 4-like,5948
NC_035782.1,52559258,52567103,52559258,52567103,111125963,XM_022470277.1,serine beta-lactamase-like protein LACTB,7845
NC_035781.1,54570121,54581639,54570121,54581639,111119458,XM_022459648.1,transducin beta-like protein 3,11518
NC_035782.1,21366012,21379996,21366012,21379996,111123003,XM_022465080.1,catenin beta-like,13984
NC_035782.1,24860977,24878993,24863343,24878993,111127650,XM_022472921.1,thymosin beta-like,15650
NC_035782.1,24860977,24878993,24862658,24878993,111127650,XM_022472920.1,thymosin beta-like,16335
NC_035782.1,24860977,24878993,24860977,24878993,111127650,XM_022472922.1,thymosin beta-like,18016
NC_035781.1,26561815,26611438,26561815,26611438,111122334,XM_022464055.1,dystrobrevin beta-like,49623
NC_035781.1,48388098,48392586,48388118,48392586,111121065,XM_022462169.1,chitobiosyldiphosphodolichol beta-mannosyltransferase-like,4468
NC_035781.1,48388098,48392586,48388098,48392586,111121065,XM_022462170.1,chitobiosyldiphosphodolichol beta-mannosyltransferase-like,4488
NC_035781.1,49481091,49485975,49481091,49485880,111118130,XM_022457446.1,chitobiosyldiphosphodolichol beta-mannosyltransferase-like,4789
NC_035781.1,49481091,49485975,49481091,49485975,111118130,XM_022457447.1,chitobiosyldiphosphodolichol beta-mannosyltransferase-like,4884
NC_035783.1,11096953,11109023,11096953,11109023,111129357,XM_022475693.1,tectonin beta-propeller repeat-containing protein 2-like,12070
NC_035782.1,12351254,12371964,12351254,12371964,111123773,XM_022466336.1,cystathionine beta-synthase-like,20710
NC_035787.1,52162904,52178081,52162904,52178081,111108246,XM_022444001.1,UDP-D-xylose:ribitol-5-phosphate beta1,15177
NC_035781.1,57780096,57784484,57780096,57784484,111120427,XM_022461141.1,sodium bicarbonate transporter-like protein 11,4388
NC_035781.1,20594584,20613318,20594584,20613318,111118912,XM_022458624.1,protein bicaudal C homolog 1-B-like,18734
NC_035780.1,64200955,64212388,64200955,64212388,111122585,XM_022464386.1,pseudouridine-metabolizing bifunctional protein C1861.05-like,11433
NC_035780.1,6760973,6762313,6760973,6762313,111130799,XM_022478046.1,platelet binding protein GspB-like,1340
NC_035781.1,596324,602532,596324,602532,111120892,XM_022461913.1,ribosome biogenesis protein BRX1 homolog,6208
NC_035780.1,38424761,38446059,38424761,38446059,111104310,XM_022438222.1,ergothioneine biosynthesis protein 1-like,21298
NC_035781.1,10495768,10498934,10495768,10498934,111119886,XM_022460454.1,phenazine biosynthesis-like domain-containing protein,3166
NC_035781.1,55333685,55345779,55333685,55345779,111121893,XM_022463369.1,multivesicular body subunit 12B-like,12094
NC_035783.1,10279516,10286006,10279516,10286006,111129900,XM_022476431.1,basal body-orientation factor 1-like,6490
NC_035788.1,68198877,68214604,68199859,68214604,111112487,XM_022450002.1,protein boule-like,14745
NC_035788.1,68198877,68214604,68198877,68214604,111112487,XM_022450001.1,protein boule-like,15727
NC_035780.1,20349898,20356210,20349898,20356210,111103659,XM_022437079.1,forkhead box protein N4-like,6312
NC_035781.1,39121027,39127522,39121027,39127522,111120830,XM_022461818.1,TATA box-binding protein-like protein 1,6495
NC_035781.1,35084181,35089835,35084181,35089835,111121843,XM_022463296.1,HMG box-containing protein 4-like,5654
NC_035780.1,13443736,13476508,13443736,13476508,111128868,XM_022474777.1,myc box-dependent-interacting protein 1-like,32772
NC_035781.1,41547508,41562839,41547508,41562839,111117921,XM_022457155.1,lethal(3)malignant brain tumor-like protein 3,15331
NC_035784.1,28896234,28905965,28896234,28905965,111133639,XM_022482164.1,protein brambleberry-like,9731
NC_035781.1,23168735,23173139,23168735,23173139,111120092,XM_022460764.1,double-strand break repair protein MRE11-like,4404
NC_035784.1,3533644,3553837,3533644,3553837,111132955,XM_022480917.1,active breakpoint cluster region-related protein-like,20193
NC_035781.1,16690175,16709419,16690175,16709419,111119457,XM_022459646.1,Golgi-specific brefeldin A-resistance guanine nucleotide exchange factor 1-like,19244
NC_035784.1,32607551,32631985,32607551,32631984,111135792,XM_022486167.1,protein broad-minded-like,24433
NC_035784.1,32607551,32631985,32607551,32631985,111135792,XM_022486162.1,protein broad-minded-like,24434
NC_035782.1,19533519,19573122,19533519,19573122,111122705,XM_022464577.1,stimulated by retinoic acid gene 6 protein-like,39603
NC_035780.1,38113961,38118246,38113961,38118246,111104049,XM_022437759.1,cytochrome c oxidase subunit NDUFA4-like,4285
NC_035783.1,54460852,54472995,54460852,54472995,111131663,XM_022479296.1,proto-oncogene c-Fos-like,12143
NC_035783.1,53405437,53417765,53405437,53417765,111131718,XM_022479373.1,proto-oncogene c-Fos-like,12328
NC_035783.1,53405437,53417765,53415217,53417765,111131718,XM_022479374.1,proto-oncogene c-Fos-like,2548
NC_035783.1,54460852,54472995,54470431,54472995,111131663,XM_022479297.1,proto-oncogene c-Fos-like,2564
NC_035783.1,53405437,53417765,53414999,53417765,111131718,XM_022479376.1,proto-oncogene c-Fos-like,2766
NC_035783.1,54460852,54472995,54470209,54472995,111131663,XM_022479299.1,proto-oncogene c-Fos-like,2786
NC_035783.1,54460852,54472995,54467521,54472995,111131663,XM_022479298.1,proto-oncogene c-Fos-like,5474
NC_035783.1,53405437,53417765,53412103,53417765,111131718,XM_022479375.1,proto-oncogene c-Fos-like,5662
NC_035788.1,67017331,67019539,67017331,67019539,111112645,XM_022450308.1,cytochrome c-like,2208
NC_035781.1,16199352,16205809,16199352,16205809,111117758,XM_022457002.1,cytochrome c-type heme lyase-like,6457
NC_035784.1,23435253,23441085,23435253,23441085,111132066,XM_022479715.1,cytochrome c1-2,5832
NC_035784.1,23231242,23237445,23231242,23237445,111137398,XM_022488845.1,cytochrome c1-2,6203
NC_035780.1,2392317,2407896,2392317,2407896,111115013,XM_022453591.1,fat-like cadherin-related tumor suppressor homolog,15579
NC_035781.1,1454710,1466401,1454710,1466401,111118277,XM_022457650.1,voltage-dependent calcium channel subunit alpha-2/delta-2-like,11691
NC_035781.1,8750118,8754995,8750118,8754995,111120483,XM_022461215.1,soluble calcium-activated nucleotidase 1-like,4877
NC_035781.1,2800687,2803105,2800687,2803105,111118097,XM_022457404.1,EF-hand calcium-binding domain-containing protein 1-like,2418
NC_035780.1,47749864,47756800,47749864,47756800,111101594,XM_022434131.1,IQ calmodulin-binding motif-containing protein 1-like,6936
NC_035780.1,30827894,30830027,30827894,30830027,111104564,XM_022438587.1,breast cancer anti-estrogen resistance protein 1-like,2133
NC_035786.1,50439617,50443803,50439617,50443803,111104760,XM_022438872.1,oral cancer-overexpressed protein 1-like,4186
NC_035780.1,6552195,6558340,6552195,6558340,111128335,XM_022473912.1,golgin candidate 3-like,6145
NC_035783.1,14872637,14882786,14872637,14882786,111127856,XM_022473143.1,CB1 cannabinoid receptor-interacting protein 1-like,10149
NC_035781.1,13011144,13015287,13011144,13015287,111118604,XM_022458155.1,protein canopy 4-like,4143
NC_035784.1,36737929,36743566,36737929,36743566,111136549,XM_022487480.1,mRNA cap guanine-N7 methyltransferase-like,5637
NC_035783.1,14388880,14400608,14388880,14400608,111128793,XM_022474644.1,nuclear cap-binding protein subunit 1-like,11728
NC_035784.1,68077348,68110040,68077348,68110040,111134199,XM_022483042.1,neuropeptides capa receptor-like,32692
NC_035782.1,40735493,40760187,40735493,40760187,111123821,XM_022466434.1,protein capicua homolog,24694
NC_035780.1,13312723,13323577,13312723,13323577,111101743,XM_022434341.1,FGGY carbohydrate kinase domain-containing protein-like,10854
NC_035782.1,55901679,55920243,55901679,55920243,111122701,XM_022464574.1,putative carbonic anhydrase-like protein 1,18564
NC_035784.1,12513379,12523074,12513379,12523074,111135400,XM_022485430.1,phosphoenolpyruvate carboxykinase [GTP]-like,9695
NC_035784.1,12526994,12532359,12526994,12532359,111134713,XM_022484022.1,phosphoenolpyruvate carboxykinase,5365
NC_035784.1,61749684,61758034,61749684,61758034,111135403,XM_022485434.1,leucine carboxyl methyltransferase 1-like,8350
NC_035780.1,28395185,28405538,28395185,28405538,111124619,XM_022467694.1,ubiquitin carboxyl-terminal hydrolase 44-like,10353
NC_035781.1,42098437,42106222,42098437,42106222,111121209,XM_022462370.1,methylcrotonoyl-CoA carboxylase beta chain,7785
NC_035783.1,6046485,6069595,6049167,6069595,111128990,XM_022474999.1,pyruvate carboxylase,20428
NC_035783.1,5000039,5023334,5000039,5020660,111128687,XM_022474451.1,pyruvate carboxylase,20621
NC_035783.1,6046485,6069595,6046485,6069595,111128990,XM_022474998.1,pyruvate carboxylase,23110
NC_035783.1,5000039,5023334,5000039,5023334,111128687,XM_022474453.1,pyruvate carboxylase,23295
NC_035785.1,4559778,4572680,4559778,4572680,111100531,XM_022432505.1,acetyl-CoA carboxylase-like,12902
NC_035785.1,4481034,4668665,4481034,4668665,111100523,XM_022432487.1,acetyl-CoA carboxylase-like,187631
NC_035785.1,4506863,4510407,4506863,4510407,111100721,XM_022432803.1,acetyl-CoA carboxylase-like,3544
NC_035785.1,4481034,4668665,4628616,4668664,111100523,XM_022432496.1,acetyl-CoA carboxylase-like,40048
NC_035785.1,4481034,4668665,4625963,4668665,111100523,XM_022432495.1,acetyl-CoA carboxylase-like,42702
NC_035785.1,4481034,4668665,4625962,4668665,111100523,XM_022432485.1,acetyl-CoA carboxylase-like,42703
NC_035785.1,4481034,4668665,4625535,4668665,111100523,XM_022432486.1,acetyl-CoA carboxylase-like,43130
NC_035785.1,3909350,3955861,3909350,3955861,111099995,XM_022431547.1,acetyl-CoA carboxylase-like,46511
NC_035781.1,2997906,3000103,2997906,3000103,111118846,XM_022458529.1,liver carboxylesterase 2-like,2197
NC_035788.1,86710107,86717932,86710107,86717932,111112315,XM_022449756.1,liver carboxylesterase-like,7825
NC_035780.1,19475014,19496585,19475014,19496585,111132855,XM_022480749.1,cytosolic carboxypeptidase 1-like,21571
NC_035781.1,18129334,18148412,18129334,18148412,111120593,XM_022461421.1,cytosolic carboxypeptidase-like protein 5,19078
NC_035784.1,55875379,55893412,55875379,55893412,111136466,XM_022487339.1,breast carcinoma-amplified sequence 3-like,18033
NC_035781.1,20833116,20836692,20833116,20836692,111121268,XM_022462457.1,mitochondrial cardiolipin hydrolase-like,3576
NC_035788.1,72979931,72999433,72979931,72999433,111112801,XM_022450603.1,peroxisomal carnitine O-octanoyltransferase-like,19502
NC_035787.1,61586842,61594336,61586842,61594336,111108746,XM_022444804.1,mitochondrial carnitine/acylcarnitine carrier protein-like,7494
NC_035780.1,9758295,9765961,9758295,9765961,111115194,XM_022453851.1,solute carrier family 25 member 40-like,7666
NC_035783.1,51360279,51370177,51360279,51370177,111129351,XM_022475684.1,secretory carrier-associated membrane protein 1-like,9898
NC_035780.1,7103281,7115773,7103281,7115773,111125896,XM_022470122.1,ATP-binding cassette sub-family B member 8,12492
NC_035780.1,27912452,27926213,27912452,27926213,111127234,XM_022472367.1,calpain-2 catalytic subunit-like,13761
NC_035782.1,7850241,7853790,7850241,7853790,111126335,XM_022470880.1,protein catecholamines up-like,3549
NC_035780.1,2380664,2391321,2380664,2391321,111099207,XM_022430642.1,organic cation transporter protein-like,10657
NC_035784.1,7797966,7832266,7797966,7832266,111134967,XM_022484591.1,probable cation-transporting ATPase 13A3,34300
NC_035781.1,2428176,2439564,2428176,2439564,111120132,XM_022460849.1,cerebral cavernous malformations protein 2 homolog,11388
NC_035780.1,8512990,8533322,8512990,8533322,111135084,XM_022484807.1,programmed cell death 6-interacting protein-like,20332
NC_035780.1,42011653,42022219,42011653,42022219,111136014,XM_022486568.1,stromal cell-derived factor 2-like,10566
NC_035781.1,27543115,27561763,27543115,27561763,111119800,XM_022460300.1,germ cell-less protein-like 1,18648
NC_035785.1,50241716,50251593,50241716,50251593,111099619,XM_022430981.1,endothelial cell-specific molecule 1-like,9877
NC_035786.1,50330555,50375153,50330555,50375153,111103297,XM_022436469.1,epithelial cell-transforming sequence 2 oncogene-like,44598
NC_035782.1,17973601,17977447,17973601,17977447,111124073,XM_022466935.1,P cell-type agglutination protein map4-like,3846
NC_035781.1,42777939,42786455,42777939,42786455,111118199,XM_022457534.1,inner centromere protein A-like,8516
NC_035784.1,71358302,71365224,71358302,71365224,111137275,XM_022488672.1,alkaline ceramidase 3-like,6922
NC_035781.1,39824471,39832742,39824471,39832742,111121929,XM_022463428.1,neutral ceramidase-like,8271
NC_035781.1,39011892,39020296,39011892,39020296,111122385,XM_022464153.1,neutral ceramidase-like,8404
NC_035787.1,50074827,50080591,50074827,50080591,111105816,XM_022440218.1,protein cereblon-like,5764
NC_035785.1,36570429,36578742,36570429,36578742,111101286,XM_022433728.1,short/branched chain specific acyl-CoA dehydrogenase,8313
NC_035780.1,21999322,22004666,21999322,22004666,111122190,XM_022463814.1,translocating chain-associated membrane protein 1-like 1,5344
NC_035780.1,29205951,29208043,29205951,29208043,111099835,XM_022431303.1,sodium channel modifier 1-like,2092
NC_035785.1,43119098,43209981,43119098,43209981,111101212,XM_022433603.1,Kv channel-interacting protein 4-like,90883
NC_035781.1,18567335,18607208,18567335,18607208,111120154,XM_022460881.1,transmembrane channel-like protein 3,39873
NC_035780.1,3920144,3928549,3920144,3928549,111112068,XM_022449378.1,tubulin-specific chaperone cofactor E-like protein,8405
NC_035784.1,12936938,12943956,12936938,12943956,111136675,XM_022487704.1,pachytene checkpoint protein 2 homolog,7018
NC_035780.1,22547217,22558741,22547217,22558741,111103268,XM_022436403.1,C-C chemokine receptor type 1-like,11524
NC_035781.1,43163492,43170094,43163492,43170094,111119842,XM_022460359.1,putative chitinase 1,6602
NC_035781.1,43176841,43180562,43176841,43180562,111118377,XM_022457800.1,putative chitinase,3721
NC_035782.1,23828827,23832122,23828827,23832122,111127052,XM_022472048.1,glutamate-gated chloride channel alpha-like,3295
NC_035784.1,37797388,37802565,37797388,37802565,111137030,XM_022488257.1,neutral cholesterol ester hydrolase 1-like,5177
NC_035780.1,8181103,8186242,8181103,8186242,111120179,XM_022460908.1,high-affinity choline transporter 1-like,5139
NC_035784.1,16301050,16308111,16301050,16308111,111132216,XM_022480005.1,low choriolytic enzyme-like,7061
NC_035781.1,214994,225994,214994,225994,111122440,XM_022464236.1,sister chromatid cohesion protein DCC1-like,11000
NC_035784.1,61183734,61199529,61183734,61199529,111134707,XM_022484013.1,apoptotic chromatin condensation inducer in the nucleus-like,15795
NC_035784.1,60416796,60437484,60416796,60437484,111138124,XM_022489944.1,period circadian protein-like,20688
NC_035784.1,42902486,42924763,42902486,42924763,111132053,XM_022479690.1,feeding circuit activating peptides-like,22277
NC_035780.1,682820,730982,682820,730982,111108931,XM_022445033.1,peptidyl-prolyl cis-trans isomerase FPR2-like,48162
NC_035786.1,32998753,33024371,32998753,33024371,111104252,XM_022438100.1,protein claret segregational-like,25618
NC_035786.1,46788609,46817274,46788609,46817274,111103244,XM_022436333.1,phosphatidylinositol-binding clathrin assembly protein LAP-like,28665
NC_035782.1,62583310,62601585,62583310,62601585,111125077,XM_022468534.1,pre-mRNA cleavage complex 2 protein Pcf11-like,18275
NC_035781.1,643314,648696,643314,648696,111118056,XM_022457345.1,iron-sulfur cluster assembly 1 homolog,5382
NC_035786.1,56618565,56626958,56618565,56626958,111103668,XM_022437089.1,hsp90 co-chaperone Cdc37-like,8393
NC_035785.1,41710483,41727336,41710483,41727336,111099610,XM_022430961.1,transcriptional coactivator YAP1-like,16853
NC_035783.1,21566655,21569886,21566655,21569886,111130834,XM_022478076.1,multiple coagulation factor deficiency protein 2 homolog,3231
NC_035782.1,17608996,17613150,17608996,17613150,111127590,XM_022472825.1,spore coat protein SP65-like,4154
NC_035781.1,57676848,57694857,57676848,57694857,111119623,XM_022459989.1,succinyl-CoA:3-ketoacid coenzyme A transferase 1,18009
NC_035780.1,6826798,6832888,6826798,6832888,111132648,XM_022480477.1,transcription cofactor vestigial-like protein 2,6090
NC_035781.1,9054782,9069115,9054782,9069115,111118945,XM_022458676.1,RB1-inducible coiled-coil protein 1-like,14333
NC_035780.1,29584272,29617677,29584272,29617677,111135364,XM_022485361.1,fibril-forming collagen alpha chain-like,33405
NC_035781.1,30799383,30817008,30799383,30817008,111119689,XM_022460110.1,rapamycin-insensitive companion of mTOR-like,17625
NC_035780.1,51044151,51071193,51044151,51071193,111132841,XM_022480736.1,APOBEC1 complementation factor-like,27042
NC_035780.1,349425,360957,349425,360957,111102393,XM_022435101.1,elongator complex protein 4-like,11532
NC_035784.1,72698925,72707681,72698925,72707681,111134511,XM_022483612.1,RNA/RNP complex-1-interacting phosphatase-like,8756
NC_035781.1,59685212,59686579,59685212,59686579,111121325,XM_022462552.1,arp2/3 complex-activating protein rickA-like,1367
NC_035781.1,10154797,10172537,10154797,10172537,111121005,XM_022462087.1,AP-1 complex-associated regulatory protein-like,17740
NC_035780.1,30752136,30754439,30752136,30754439,111105869,XM_022440327.1,MRN complex-interacting protein-like,2303
NC_035784.1,63795419,63798632,63795419,63798632,111133017,XM_022481048.1,chromatin complexes subunit BAP18-like,3213
NC_035780.1,10529044,10530031,10529044,10530031,111108952,XM_022445044.1,complement component 1 Q subcomponent-binding protein,987
NC_035780.1,56461426,56462869,56461426,56462869,111108178,XM_022443821.1,small conductance calcium-activated potassium channel protein 2-like,1443
NC_035781.1,47045823,47056224,47045823,47056224,111120881,XM_022461899.1,ubiquitin conjugation factor E4 A-like,10401
NC_035781.1,27147911,27153512,27147911,27153512,111120918,XM_022461962.1,evolutionarily conserved signaling intermediate in Toll pathway,5601
NC_035781.1,30775160,30781608,30775160,30781608,111119693,XM_022460119.1,tether containing UBX domain for GLUT4-like,6448
NC_035781.1,14841067,14862742,14841067,14862742,111119914,XM_022460491.1,proprotein convertase subtilisin/kexin type 5-like,21675
NC_035786.1,7577093,7590648,7577093,7590648,111104132,XM_022437919.1,oxygen-dependent coproporphyrinogen-III oxidase-like,13555
NC_035784.1,41762864,41765607,41762864,41765607,111135457,XM_022485548.1,brevican core protein-like,2743
NC_035783.1,18388141,18397406,18388141,18397406,111128892,XM_022474836.1,REST corepressor 3-like,9265
NC_035781.1,48586968,48589667,48586968,48589667,111120872,XM_022461881.1,mapk-regulated corepressor-interacting protein 1-like,2699
NC_035783.1,27393620,27399823,27393620,27399823,111130263,XM_022477088.1,dr1-associated corepressor-like,6203
NC_035783.1,25995364,26002292,25995364,26002292,111127937,XM_022473266.1,dr1-associated corepressor-like,6928
NC_035783.1,5480791,5486651,5480791,5486651,111128090,XM_022473532.1,protein cornichon homolog 4-like,5860
NC_035787.1,63577901,63582623,63577901,63582623,111107346,XM_022442511.1,ectoderm-neural cortex protein 1-like,4722
NC_035780.1,16368939,16369898,16368939,16369898,111113127,XM_022451127.1,spore cortex-lytic enzyme-like,959
NC_035781.1,55039920,55048359,55039920,55048359,111118412,XM_022457883.1,sodium/glucose cotransporter 4-like,8439
NC_035784.1,37883029,37890973,37883029,37890973,111137995,XM_022489736.1,sodium/myo-inositol cotransporter-like,7944
NC_035789.1,11341021,11406292,11341021,11406292,111117330,XM_022456406.1,protein couch potato-like,65271
NC_035780.1,19518168,19551572,19518168,19551572,111106215,XM_022440798.1,G-protein coupled receptor GRL101-like,33404
NC_035782.1,47493488,47522612,47493488,47522612,111124549,XM_022467491.1,protein cramped-like,29124
NC_035784.1,62404362,62414250,62404362,62414250,111137189,XM_022488531.1,DNA cross-link repair 1A protein-like,9888
NC_035781.1,5623609,5686073,5623609,5686073,111118678,XM_022458248.1,microtubule-actin cross-linking factor 1,62464
NC_035784.1,31273968,31278544,31273968,31278544,111132303,XM_022480100.1,protein crumbs homolog 2-like,4576
NC_035786.1,23730401,23741793,23730401,23741793,111104010,XM_022437704.1,protein crumbs-like,11392
NC_035782.1,62354546,62391261,62364655,62391261,111123700,XM_022466226.1,protein crumbs-like,26606
NC_035782.1,62354546,62391261,62354547,62391261,111123700,XM_022466224.1,protein crumbs-like,36714
NC_035782.1,62354546,62391261,62354546,62391261,111123700,XM_022466223.1,protein crumbs-like,36715
NC_035782.1,72987778,72993183,72987778,72993183,111126533,XM_022471241.1,protein crumbs-like,5405
NC_035780.1,51124159,51143224,51124159,51143224,111115123,XM_022453797.1,one cut domain family member 2-like,19065
NC_035787.1,32597237,32601429,32597237,32601429,111105794,XM_022440181.1,pupal cuticle protein 36-like,4192
NC_035781.1,36833906,36871427,36833906,36871427,111120085,XM_022460747.1,guanylate cyclase 32E-like,37521
NC_035789.1,16161439,16170848,16161439,16170848,111116379,XM_022455367.1,adenylate cyclase,9409
NC_035780.1,40572941,40670102,40572941,40670102,111131100,XM_022478484.1,adenylyl cyclase-associated protein 1-like,97161
NC_035783.1,44863334,44870229,44863334,44870229,111131656,XM_022479283.1,triokinase/FMN cyclase-like,6895
NC_035783.1,44872329,44880306,44872581,44880306,111131560,XM_022479155.1,triokinase/FMN cyclase-like,7725
NC_035783.1,44872329,44880306,44872329,44880305,111131560,XM_022479156.1,triokinase/FMN cyclase-like,7976
NC_035784.1,66033200,66044514,66033200,66044514,111133847,XM_022482541.1,ADP-ribosyl cyclase/cyclic ADP-ribose hydrolase-like,11314
NC_035780.1,55806972,55817517,55806972,55817517,111136404,XM_022487233.1,cell cycle control protein 50A-like,10545
NC_035787.1,67343518,67356817,67343518,67356817,111106887,XM_022441760.1,G2/mitotic-specific cyclin S13-7-like,13299
NC_035782.1,72787772,72791530,72787772,72790354,111122860,XM_022464869.1,G2/mitotic-specific cyclin-A-like,2582
NC_035782.1,71437067,71440757,71437067,71440757,111122939,XM_022464977.1,G2/mitotic-specific cyclin-A-like,3690
NC_035782.1,72787772,72791530,72787772,72791530,111122860,XM_022464868.1,G2/mitotic-specific cyclin-A-like,3758
NC_035787.1,65786059,65796878,65786059,65796878,111105936,XM_022440436.1,G2/mitotic-specific cyclin-B-like,10819
NC_035784.1,45132832,45145089,45132832,45145089,111137693,XM_022489280.1,G2/mitotic-specific cyclin-B-like,12257
NC_035783.1,40339839,40343771,40339839,40343771,111131322,XM_022478793.1,G2/mitotic-specific cyclin-B-like,3932
NC_035783.1,41408557,41412498,41408557,41412498,111131500,XM_022479068.1,G2/mitotic-specific cyclin-B-like,3941
NC_035785.1,33382093,33386648,33382093,33386648,111099741,XM_022431171.1,G2/mitotic-specific cyclin-B3-like,4555
NC_035786.1,39935865,39943902,39935865,39943902,111103611,XM_022437001.1,G1/S-specific cyclin-D2-like,8037
NC_035784.1,23517263,23521777,23517263,23521777,111099092,XM_022430452.1,G1/S-specific cyclin-E-like,4514
NC_035784.1,23905249,23911399,23905249,23911399,111132839,XM_022480706.1,G1/S-specific cyclin-E-like,6150
NC_035780.1,49303468,49323005,49303468,49323005,111107859,XM_022443262.1,probable cyclin-dependent serine/threonine-protein kinase DDB_G0292550,19537
NC_035783.1,30071031,30075586,30071031,30075203,111128302,XM_022473860.1,5-formyltetrahydrofolate cyclo-ligase-like,4172
NC_035783.1,30071031,30075586,30071032,30075585,111128302,XM_022473858.1,5-formyltetrahydrofolate cyclo-ligase-like,4553
NC_035783.1,30071031,30075586,30071031,30075586,111128302,XM_022473857.1,5-formyltetrahydrofolate cyclo-ligase-like,4555
NC_035783.1,12843655,12856428,12843655,12856428,111127871,XM_022473162.1,GTP cyclohydrolase 1-like,12773
NC_035783.1,14969767,14990770,14971634,14990770,111129904,XM_022476435.1,glutaminyl-peptide cyclotransferase-like,19136
NC_035783.1,14969767,14990770,14969767,14990770,111129904,XM_022476436.1,glutaminyl-peptide cyclotransferase-like,21003
NC_035781.1,27971180,27977263,27971180,27977263,111121120,XM_022462249.1,digestive cysteine proteinase 1-like,6083
NC_035788.1,53494081,53541206,53494081,53541206,111113296,XM_022451444.1,reversion-inducing cysteine-rich protein with Kazal motifs-like,47125
NC_035780.1,34863572,34879114,34863572,34879114,111105066,XM_022439242.1,RNA cytidine acetyltransferase-like,15542
NC_035783.1,44982530,44985564,44982530,44985564,111127953,XM_022473284.1,phosphatidate cytidylyltransferase,3034
NC_035781.1,20460601,20469566,20460601,20469566,111122043,XM_022463570.1,phosphatidate cytidylyltransferase,8965
NC_035781.1,2699676,2712921,2699676,2712921,111121266,XM_022462455.1,ethanolamine-phosphate cytidylyltransferase-like,13245
NC_035780.1,45006758,45013441,45006758,45013441,111107703,XM_022443029.1,D-ribitol-5-phosphate cytidylyltransferase-like,6683
NC_035784.1,12308443,12321360,12308443,12321360,111137940,XM_022489652.1,probable cytochrome P450 49a1,12917
NC_035788.1,14675221,14683615,14675221,14683615,111116166,XM_022455167.1,probable cytoplasmic aconitate hydratase,8394
NC_035785.1,30185392,30186473,30185392,30186473,111102102,XM_022434754.1,actin cytoskeleton-regulatory complex protein PAN1-like,1081
NC_035780.1,43783417,43785818,43783417,43785818,111137851,XM_022489549.1,probable cytosolic iron-sulfur protein assembly protein CIAO1 homolog,2401
NC_035788.1,32147236,32166660,32147236,32166660,111115937,XM_022454861.1,probable dTDP-glucose 4,19424
NC_035780.1,47197450,47209606,47197450,47209606,111107802,XM_022443164.1,protein dachsous-like,12156
NC_035781.1,45876574,45894244,45876574,45894244,111118038,XM_022457324.1,protein dachsous-like,17670
NC_035787.1,20199213,20220809,20200658,20220809,111109559,XM_022445730.1,protein dachsous-like,20151
NC_035787.1,20199213,20220809,20199213,20220809,111109559,XM_022445731.1,protein dachsous-like,21596
NC_035782.1,64504494,64535396,64504494,64535396,111125358,XM_022469092.1,protein dachsous-like,30902
NC_035780.1,27467847,27490600,27467847,27490600,111129824,XM_022476295.1,DNA damage-binding protein 1-like,22753
NC_035780.1,8009824,8020164,8009824,8020164,111109628,XM_022445838.1,DNA damage-regulated autophagy modulator protein 2-like,10340
NC_035782.1,55742837,55747086,55742837,55747086,111125397,XM_022469162.1,protein dcd1A-like,4249
NC_035784.1,3891497,3897735,3891497,3897735,111132406,XM_022480208.1,N-acetylglucosaminyl-phosphatidylinositol de-N-acetylase-like,6238
NC_035783.1,5571935,5572848,5571935,5572848,111130483,XM_022477591.1,violaxanthin de-epoxidase,913
NC_035781.1,13468944,13476491,13468944,13476491,111118105,XM_022457415.1,histone deacetylase 3-like,7547
NC_035787.1,8682889,8719647,8708766,8719647,111108377,XM_022444213.1,carbohydrate deacetylase-like,10881
NC_035784.1,63657937,63673166,63659255,63673166,111134704,XM_022484008.1,arylacetamide deacetylase-like,13911
NC_035784.1,63657937,63673166,63657937,63673166,111134704,XM_022484009.1,arylacetamide deacetylase-like,15229
NC_035787.1,8682889,8719647,8682889,8698243,111108377,XM_022444212.1,carbohydrate deacetylase-like,15354
NC_035784.1,52907328,52929908,52907328,52929908,111138516,XM_022490531.1,arylacetamide deacetylase-like,22580
NC_035784.1,75862942,75896246,75862942,75896246,111137776,XM_022489421.1,arylacetamide deacetylase-like,33304
NC_035787.1,8682889,8719647,8682889,8719640,111108377,XM_022444214.1,carbohydrate deacetylase-like,36751
NC_035782.1,11555803,11562303,11556943,11562303,111122746,XM_022464634.1,N-acetylglucosamine-6-phosphate deacetylase-like,5360
NC_035782.1,11899451,11906030,11900603,11906024,111125912,XM_022470151.1,N-acetylglucosamine-6-phosphate deacetylase-like,5421
NC_035785.1,36290318,36296151,36290318,36295766,111101222,XM_022433628.1,arylacetamide deacetylase-like,5448
NC_035785.1,36290318,36296151,36290318,36296123,111101222,XM_022433629.1,arylacetamide deacetylase-like,5805
NC_035785.1,36290318,36296151,36290318,36296151,111101222,XM_022433627.1,arylacetamide deacetylase-like,5833
NC_035782.1,11555803,11562303,11555803,11562303,111122746,XM_022464633.1,N-acetylglucosamine-6-phosphate deacetylase-like,6500
NC_035782.1,11899451,11906030,11899451,11906030,111125912,XM_022470150.1,N-acetylglucosamine-6-phosphate deacetylase-like,6579
NC_035783.1,11039237,11045414,11039237,11045414,111130904,XM_022478176.1,D-tyrosyl-tRNA(Tyr) deacylase 1-like,6177
NC_035784.1,58368136,58370726,58368136,58370726,111132480,XM_022480291.1,protein deadpan-like,2590
NC_035781.1,42615493,42619441,42615493,42619441,111120310,XM_022461038.1,adenosine deaminase 2-like,3948
NC_035783.1,57821936,57827310,57821936,57827310,111128584,XM_022474284.1,adenosine deaminase-like protein,5374
NC_035780.1,33835021,33847289,33835823,33847289,111135409,XM_022485454.1,guanine deaminase-like,11466
NC_035780.1,33835021,33847289,33835021,33847289,111135409,XM_022485463.1,guanine deaminase-like,12268
NC_035788.1,60635415,60648708,60635415,60648708,111116164,XM_022455166.1,porphobilinogen deaminase-like,13293
NC_035782.1,2438504,2451979,2438504,2451979,111123736,XM_022466276.1,deoxycytidylate deaminase-like,13475
NC_035784.1,43092625,43107930,43092626,43107930,111133754,XM_022482390.1,cytidine deaminase-like,15304
NC_035784.1,43092625,43107930,43092625,43107930,111133754,XM_022482391.1,cytidine deaminase-like,15305
NC_035784.1,40136988,40138837,40136988,40138837,111138297,XM_022490175.1,cytidine deaminase-like,1849
NC_035782.1,5992088,5996036,5992088,5996036,111125470,XM_022469351.1,deoxycytidylate deaminase-like,3948
NC_035784.1,43092625,43107930,43103693,43107930,111133754,XM_022482389.1,cytidine deaminase-like,4237
NC_035784.1,43084649,43089378,43085050,43089378,111138152,XM_022489991.1,cytidine deaminase-like,4328
NC_035784.1,43084649,43089378,43084649,43089378,111138152,XM_022489992.1,cytidine deaminase-like,4729
NC_035784.1,37497314,37502794,37497314,37502794,111136709,XM_022487784.1,cytidine deaminase-like,5480
NC_035781.1,18175411,18180957,18175411,18180957,111120770,XM_022461731.1,2-iminobutanoate/2-iminopropanoate deaminase-like,5546
NC_035781.1,19210939,19217272,19210939,19217272,111121371,XM_022462632.1,2-iminobutanoate/2-iminopropanoate deaminase-like,6333
NC_035780.1,33835021,33847289,33838937,33847289,111135409,XM_022485481.1,guanine deaminase-like,8352
NC_035782.1,33368908,33377923,33368908,33377923,111126157,XM_022470588.1,porphobilinogen deaminase-like,9015
NC_035780.1,32671778,32681467,32671778,32681467,111131673,XM_022479311.1,adenosine deaminase-like,9689
NC_035780.1,15936015,15939905,15936015,15939905,111100322,XM_022432061.1,cell death abnormality protein 1-like,3890
NC_035780.1,56351895,56359283,56351895,56359283,111127658,XM_022472941.1,cell death-inducing p53-target protein 1 homolog,7388
NC_035781.1,5557334,5578730,5557334,5578730,111119678,XM_022460090.1,glycogen debranching enzyme-like,21396
NC_035782.1,8960354,8962325,8960354,8962325,111123046,XM_022465134.1,phosphopantothenoylcysteine decarboxylase subunit VHS3-like,1971
NC_035786.1,37339211,37351404,37339211,37351189,111104136,XM_022437928.1,malonyl-CoA decarboxylase,11978
NC_035786.1,37339211,37351404,37339223,37351404,111104136,XM_022437927.1,malonyl-CoA decarboxylase,12181
NC_035786.1,39365119,39382764,39365330,39382764,111104175,XM_022437981.1,malonyl-CoA decarboxylase,17434
NC_035786.1,39365119,39382764,39365119,39382764,111104175,XM_022437980.1,malonyl-CoA decarboxylase,17645
NC_035780.1,28008999,28019400,28009018,28019400,111110396,XM_022446886.1,aromatic-L-amino-acid decarboxylase-like,10382
NC_035780.1,28008999,28019400,28008999,28019400,111110396,XM_022446894.1,aromatic-L-amino-acid decarboxylase-like,10401
NC_035782.1,12918177,12930107,12918177,12930107,111125691,XM_022469749.1,2-amino-3-carboxymuconate-6-semialdehyde decarboxylase-like,11930
NC_035780.1,27968756,27981798,27968756,27981798,111111022,XM_022447758.1,aromatic-L-amino-acid decarboxylase-like,13042
NC_035780.1,28889561,28904051,28889561,28904051,111114715,XM_022453153.1,phosphonopyruvate decarboxylase-like,14490
NC_035788.1,39015031,39035990,39015031,39035990,111113817,XM_022452108.1,histidine decarboxylase-like,20959
NC_035783.1,22017903,22020398,22017903,22020398,111128940,XM_022474913.1,2-oxo-4-hydroxy-4-carboxy-5-ureidoimidazoline decarboxylase-like,2495
NC_035781.1,46203097,46205812,46203097,46205812,111117829,XM_022457065.1,cis-aconitate decarboxylase-like,2715
NC_035781.1,46426182,46428958,46426182,46428958,111122246,XM_022463893.1,cis-aconitate decarboxylase-like,2776
NC_035783.1,33677624,33680544,33677624,33680544,111129204,XM_022475449.1,2-oxo-4-hydroxy-4-carboxy-5-ureidoimidazoline decarboxylase-like,2920
NC_035784.1,13525672,13529280,13525672,13529280,111133157,XM_022481277.1,phosphopantothenoylcysteine decarboxylase-like,3608
NC_035781.1,1144874,1152819,1148290,1152819,111119190,XM_022459093.1,ornithine decarboxylase-like,4529
NC_035782.1,33540667,33549254,33540667,33546396,111125148,XM_022468652.1,aromatic-L-amino-acid decarboxylase-like,5729
NC_035784.1,14273726,14282831,14273726,14280735,111133348,XM_022481659.1,diphosphomevalonate decarboxylase-like,7009
NC_035781.1,1144874,1152819,1144874,1152819,111119190,XM_022459092.1,ornithine decarboxylase-like,7945
NC_035782.1,33540667,33549254,33540667,33549254,111125148,XM_022468651.1,aromatic-L-amino-acid decarboxylase-like,8587
NC_035784.1,14273726,14282831,14273726,14282831,111133348,XM_022481658.1,diphosphomevalonate decarboxylase-like,9105
NC_035784.1,48858166,48868150,48858166,48868150,111138313,XM_022490191.1,aromatic-L-amino-acid decarboxylase-like,9984
NC_035783.1,48328865,48331194,48328865,48331194,111129521,XM_022475973.1,mRNA decay activator protein ZFP36L1-like,2329
NC_035784.1,3159309,3159800,3159309,3159800,111136232,XM_022486936.1,partitioning defective 6 homolog gamma-like,491
NC_035781.1,10063640,10068919,10063640,10068919,111121894,XM_022463373.1,putative defense protein Hdd11-like,5279
NC_035781.1,50980637,50982253,50980637,50982253,111118301,XM_022457684.1,big defensin-like,1616
NC_035781.1,50970178,50971968,50970178,50971968,111121992,XM_022463504.1,big defensin-like,1790
NC_035781.1,50956160,50958189,50956160,50958189,111121991,XM_022463503.1,big defensin-like,2029
NC_035781.1,46965264,46967368,46965264,46967368,111118669,XM_022458237.1,big defensin-like,2104
NC_035781.1,46948073,46950195,46948073,46950195,111118349,XM_022457755.1,big defensin-like,2122
NC_035781.1,46957719,46960745,46957719,46960745,111118067,XM_022457359.1,big defensin-like,3026
NC_035781.1,50979667,50980233,50979667,50980233,111118279,XM_022457658.1,big defensin-like,566
NC_035784.1,64120949,64132362,64120949,64132362,111138280,XM_022490158.1,probable deferrochelatase/peroxidase YfeX,11413
NC_035783.1,3444275,3452686,3444275,3452686,111127878,XM_022473177.1,serologically defined colon cancer antigen 8 homolog,8411
NC_035781.1,14788082,14792078,14788082,14792078,111119915,XM_022460493.1,cerebellar degeneration-related protein 2-like,3996
NC_035780.1,32746900,32773125,32746900,32773125,111136152,XM_022486810.1,glucose-induced degradation protein 8 homolog,26225
NC_035780.1,10489723,10497648,10489723,10497648,111102428,XM_022435152.1,ER degradation-enhancing alpha-mannosidase-like protein 2,7925
NC_035782.1,49187893,49196464,49187893,49196439,111127085,XM_022472098.1,haloacid dehalogenase-like hydrolase domain-containing protein 2,8546
NC_035783.1,11132600,11135141,11132600,11135141,111128521,XM_022474150.1,hydroxyacyl-thioester dehydratase type 2,2541
NC_035781.1,49189020,49190418,49189020,49190418,111119251,XM_022459247.1,L-rhamnonate dehydratase-like,1398
NC_035781.1,48683014,48684424,48683014,48684424,111119078,XM_022458896.1,L-rhamnonate dehydratase-like,1410
NC_035782.1,45082289,45087068,45082367,45087068,111126166,XM_022470606.1,D-threo-3-hydroxyaspartate dehydratase-like,4701
NC_035782.1,45082289,45087068,45082320,45087068,111126166,XM_022470607.1,D-threo-3-hydroxyaspartate dehydratase-like,4748
NC_035782.1,45082289,45087068,45082289,45087068,111126166,XM_022470605.1,D-threo-3-hydroxyaspartate dehydratase-like,4779
NC_035780.1,34823563,34829102,34823563,34829102,111100699,XM_022432785.1,methylthioribulose-1-phosphate dehydratase-like,5539
NC_035788.1,52329886,52335575,52329886,52335575,111111541,XM_022448581.1,trans-L-3-hydroxyproline dehydratase-like,5689
NC_035784.1,48991352,48998480,48991352,48998480,111136419,XM_022487257.1,serine dehydratase-like,7128
NC_035780.1,1882143,1890106,1882143,1890106,111102448,XM_022435197.1,NADH dehydrogenase [ubiquinone] flavoprotein 1,7963
NC_035784.1,50365820,50376707,50365820,50376707,111137005,XM_022488226.1,6-phosphogluconate dehydrogenase,10887
NC_035784.1,35530260,35541897,35530260,35541897,111136399,XM_022487223.1,delta-1-pyrroline-5-carboxylate dehydrogenase,11637
NC_035784.1,35705658,35717567,35705658,35717567,111133052,XM_022481116.1,delta-1-pyrroline-5-carboxylate dehydrogenase,11909
NC_035783.1,15517086,15529273,15517086,15529273,111130419,XM_022477492.1,aldehyde dehydrogenase,12187
NC_035780.1,10374294,10386940,10374294,10386940,111105919,XM_022440405.1,D-beta-hydroxybutyrate dehydrogenase,12646
NC_035787.1,6581804,6596141,6582148,6596141,111109592,XM_022445779.1,succinate-semialdehyde dehydrogenase,13993
NC_035787.1,6581804,6596141,6581867,6596141,111109592,XM_022445780.1,succinate-semialdehyde dehydrogenase,14274
NC_035787.1,6581804,6596141,6581804,6596141,111109592,XM_022445781.1,succinate-semialdehyde dehydrogenase,14337
NC_035787.1,60680840,60696390,60680840,60696390,111109254,XM_022445336.1,dihydrolipoyl dehydrogenase,15550
NC_035782.1,15356512,15376283,15356512,15373100,111125851,XM_022470035.1,glycerol-3-phosphate dehydrogenase,16588
NC_035782.1,15356512,15376283,15356512,15373146,111125851,XM_022470037.1,glycerol-3-phosphate dehydrogenase,16634
NC_035782.1,15356512,15376283,15356512,15373147,111125851,XM_022470033.1,glycerol-3-phosphate dehydrogenase,16635
NC_035780.1,11844137,11861651,11844137,11861651,111128408,XM_022474007.1,D-beta-hydroxybutyrate dehydrogenase,17514
NC_035781.1,3167038,3185557,3167038,3185557,111118600,XM_022458143.1,2-oxoglutarate dehydrogenase,18519
NC_035782.1,15356512,15376283,15356512,15376283,111125851,XM_022470034.1,glycerol-3-phosphate dehydrogenase,19771
NC_035780.1,11853320,11875036,11853320,11875036,111128397,XM_022473990.1,D-beta-hydroxybutyrate dehydrogenase,21716
NC_035787.1,61140288,61162853,61140288,61162853,111108359,XM_022444177.1,dihydrolipoyl dehydrogenase,22565
NC_035782.1,14689136,14714496,14689136,14714484,111123631,XM_022466091.1,glycerol-3-phosphate dehydrogenase,25348
NC_035782.1,14689136,14714496,14689136,14714496,111123631,XM_022466088.1,glycerol-3-phosphate dehydrogenase,25360
NC_035783.1,37006636,37009326,37006636,37009326,111130998,XM_022478315.1,D-beta-hydroxybutyrate dehydrogenase,2690
NC_035783.1,37018208,37020942,37018208,37020942,111131000,XM_022478316.1,D-beta-hydroxybutyrate dehydrogenase,2734
NC_035784.1,13259454,13264245,13259454,13264245,111133078,XM_022481157.1,D-2-hydroxyglutarate dehydrogenase,4791
NC_035787.1,20175289,20180192,20175289,20180192,111108792,XM_022444875.1,isobutyryl-CoA dehydrogenase,4903
NC_035780.1,10387524,10392428,10387524,10392428,111114604,XM_022452989.1,D-beta-hydroxybutyrate dehydrogenase,4904
NC_035786.1,19195573,19200628,19195573,19200628,111104314,XM_022438187.1,isobutyryl-CoA dehydrogenase,5055
NC_035780.1,57202253,57207343,57202253,57207343,111124057,XM_022466951.1,3-hydroxyisobutyrate dehydrogenase,5090
NC_035783.1,19541126,19546290,19541126,19546290,111129934,XM_022476486.1,malate dehydrogenase,5164
NC_035783.1,3607956,3613483,3607956,3613483,111129515,XM_022475959.1,L-2-hydroxyglutarate dehydrogenase,5527
NC_035784.1,38045989,38051860,38045989,38051860,111136621,XM_022487600.1,malate dehydrogenase,5871
NC_035786.1,46132011,46138214,46132011,46138214,111102940,XM_022435895.1,D-beta-hydroxybutyrate dehydrogenase,6203
NC_035781.1,2088026,2094409,2088026,2094409,111121738,XM_022463136.1,isovaleryl-CoA dehydrogenase,6383
NC_035783.1,5275220,5281781,5275220,5281663,111129864,XM_022476356.1,L-2-hydroxyglutarate dehydrogenase,6443
NC_035781.1,52372447,52379003,52372447,52379003,111119107,XM_022458956.1,glutamate dehydrogenase,6556
NC_035783.1,5275220,5281781,5275220,5281781,111129864,XM_022476355.1,L-2-hydroxyglutarate dehydrogenase,6561
NC_035781.1,1594237,1601860,1594237,1601855,111119361,XM_022459450.1,isovaleryl-CoA dehydrogenase,7618
NC_035781.1,1594237,1601860,1594237,1601860,111119361,XM_022459449.1,isovaleryl-CoA dehydrogenase,7623
NC_035781.1,6689268,6697142,6689268,6697142,111121380,XM_022462647.1,glutaryl-CoA dehydrogenase,7874
NC_035780.1,10374294,10386940,10374294,10383756,111105919,XM_022440416.1,D-beta-hydroxybutyrate dehydrogenase,9462
NC_035780.1,11853320,11875036,11865450,11875036,111128397,XM_022473998.1,D-beta-hydroxybutyrate dehydrogenase,9586
NC_035781.1,23409266,23416513,23409266,23416513,111122056,XM_022463591.1,hydroxysteroid dehydrogenase-like protein 2,7247
NC_035788.1,5445915,5457061,5445915,5457061,111114474,XM_022452783.1,D-3-phosphoglycerate dehydrogenase-like,11146
NC_035789.1,4712417,4724107,4712417,4724107,111117567,XM_022456717.1,D-beta-hydroxybutyrate dehydrogenase-like,11690
NC_035780.1,39799712,39811770,39799712,39811770,111122793,XM_022464725.1,D-beta-hydroxybutyrate dehydrogenase-like,12058
NC_035780.1,63727038,63728356,63727038,63728356,111099143,XM_022430529.1,glyceraldehyde-3-phosphate dehydrogenase-like,1318
NC_035781.1,48086257,48091616,48089811,48091616,111122144,XM_022463732.1,opine dehydrogenase-like,1805
NC_035781.1,49843744,49847828,49843744,49845550,111119819,XM_022460328.1,opine dehydrogenase-like,1806
NC_035780.1,54811513,54829656,54811513,54829656,111136587,XM_022487537.1,xanthine dehydrogenase-like,18143
NC_035781.1,49802160,49820721,49802160,49820721,111119820,XM_022460331.1,opine dehydrogenase-like,18561
NC_035781.1,49843744,49847828,49843744,49845650,111119819,XM_022460326.1,opine dehydrogenase-like,1906
NC_035781.1,49843744,49847828,49843744,49845660,111119819,XM_022460327.1,opine dehydrogenase-like,1916
NC_035781.1,48086257,48091616,48089697,48091616,111122144,XM_022463730.1,opine dehydrogenase-like,1919
NC_035781.1,48086257,48091616,48089687,48091616,111122144,XM_022463731.1,opine dehydrogenase-like,1929
NC_035780.1,60915745,60918673,60915745,60918673,111112758,XM_022450524.1,alcohol dehydrogenase-like,2928
NC_035781.1,48082269,48085597,48082269,48085597,111118735,XM_022458336.1,opine dehydrogenase-like,3328
NC_035783.1,38907338,38910720,38907338,38910720,111131336,XM_022478808.1,sorbitol dehydrogenase-like,3382
NC_035781.1,49848469,49851885,49848469,49851885,111118741,XM_022458350.1,opine dehydrogenase-like,3416
NC_035785.1,41516336,41522022,41516386,41519895,111100326,XM_022432063.1,D-beta-hydroxybutyrate dehydrogenase-like,3509
NC_035785.1,41516336,41522022,41516336,41519895,111100326,XM_022432065.1,D-beta-hydroxybutyrate dehydrogenase-like,3559
NC_035788.1,76602716,76640750,76602716,76640748,111112920,XM_022450802.1,4-trimethylaminobutyraldehyde dehydrogenase-like,38032
NC_035788.1,76602716,76640750,76602716,76640750,111112920,XM_022450801.1,4-trimethylaminobutyraldehyde dehydrogenase-like,38034
NC_035781.1,31687241,31691316,31687241,31691316,111118934,XM_022458652.1,octopine dehydrogenase-like,4075
NC_035781.1,49843744,49847828,49843744,49847828,111119819,XM_022460325.1,opine dehydrogenase-like,4084
NC_035786.1,47862240,47866343,47862240,47866343,111104054,XM_022437764.1,sorbitol dehydrogenase-like,4103
NC_035783.1,21096406,21100919,21096406,21100919,111128407,XM_022474004.1,3-hydroxybutyryl-CoA dehydrogenase-like,4513
NC_035781.1,278286,283001,278286,283001,111122441,XM_022464239.1,octopine dehydrogenase-like,4715
NC_035784.1,83954019,83958736,83954019,83958736,111133902,XM_022482634.1,sorbitol dehydrogenase-like,4717
NC_035784.1,33311974,33317039,33311974,33317039,111132312,XM_022480109.1,hydroxyproline dehydrogenase-like,5065
NC_035784.1,33895743,33900838,33895745,33900838,111136064,XM_022486652.1,hydroxyproline dehydrogenase-like,5093
NC_035788.1,67353321,67360641,67355455,67360641,111115257,XM_022453922.1,L-galactose dehydrogenase-like,5186
NC_035781.1,48086257,48091616,48086257,48091616,111122144,XM_022463729.1,opine dehydrogenase-like,5359
NC_035785.1,36353192,36358732,36353192,36358732,111099744,XM_022431173.1,D-beta-hydroxybutyrate dehydrogenase-like,5540
NC_035785.1,41516336,41522022,41516386,41522022,111100326,XM_022432064.1,D-beta-hydroxybutyrate dehydrogenase-like,5636
NC_035789.1,4699712,4705430,4699712,4705430,111116211,XM_022455195.1,D-beta-hydroxybutyrate dehydrogenase-like,5718
NC_035781.1,49802160,49820721,49802160,49808120,111119820,XM_022460330.1,opine dehydrogenase-like,5960
NC_035788.1,72579671,72585862,72579671,72585862,111115614,XM_022454425.1,4-trimethylaminobutyraldehyde dehydrogenase-like,6191
NC_035788.1,67353321,67360641,67353725,67360641,111115257,XM_022453923.1,L-galactose dehydrogenase-like,6916
NC_035788.1,67353321,67360641,67353321,67360641,111115257,XM_022453924.1,L-galactose dehydrogenase-like,7320
NC_035783.1,26028344,26035770,26028344,26035770,111128111,XM_022473567.1,sorbitol dehydrogenase-like,7426
NC_035789.1,4712417,4724107,4713833,4721293,111117567,XM_022456715.1,D-beta-hydroxybutyrate dehydrogenase-like,7460
NC_035781.1,49825093,49825906,49825093,49825906,111120370,XM_022461090.1,opine dehydrogenase-like,813
NC_035788.1,74751515,74759648,74751515,74759648,111111318,XM_022448220.1,D-3-phosphoglycerate dehydrogenase-like,8133
NC_035783.1,40965253,40973850,40965253,40973850,111129662,XM_022476124.1,sorbitol dehydrogenase-like,8597
NC_035789.1,4712417,4724107,4712417,4721293,111117567,XM_022456714.1,D-beta-hydroxybutyrate dehydrogenase-like,8876
NC_035783.1,27358275,27367276,27358275,27367276,111131432,XM_022478952.1,sorbitol dehydrogenase-like,9001
NC_035789.1,4753518,4762954,4753520,4762595,111116661,XM_022455657.1,D-beta-hydroxybutyrate dehydrogenase-like,9075
NC_035789.1,4753518,4762954,4753519,4762595,111116661,XM_022455658.1,D-beta-hydroxybutyrate dehydrogenase-like,9076
NC_035789.1,4753518,4762954,4753518,4762954,111116661,XM_022455659.1,D-beta-hydroxybutyrate dehydrogenase-like,9436
NC_035782.1,23809634,23828715,23809634,23828715,111122830,XM_022464829.1,L-aminoadipate-semialdehyde dehydrogenase-phosphopantetheinyl transferase-like,19081
NC_035780.1,61046264,61060061,61046264,61060061,111105600,XM_022439968.1,xanthine dehydrogenase/oxidase-like,13797
NC_035783.1,10055349,10076563,10061129,10076563,111131269,XM_022478708.1,xanthine dehydrogenase/oxidase-like,15434
NC_035783.1,10131402,10152629,10136431,10152629,111129061,XM_022475136.1,xanthine dehydrogenase/oxidase-like,16198
NC_035787.1,46970580,46988817,46970850,46988817,111107393,XM_022442576.1,xanthine dehydrogenase/oxidase-like,17967
NC_035787.1,46970580,46988817,46970681,46988816,111107393,XM_022442574.1,xanthine dehydrogenase/oxidase-like,18135
NC_035787.1,46970580,46988817,46970580,46988816,111107393,XM_022442575.1,xanthine dehydrogenase/oxidase-like,18236
NC_035787.1,46939234,46965556,46939234,46959044,111108476,XM_022444394.1,xanthine dehydrogenase/oxidase-like,19810
NC_035787.1,46939234,46965556,46939234,46959621,111108476,XM_022444393.1,xanthine dehydrogenase/oxidase-like,20387
NC_035783.1,10055349,10076563,10055349,10076562,111131269,XM_022478707.1,xanthine dehydrogenase/oxidase-like,21213
NC_035783.1,10131402,10152629,10131402,10152629,111129061,XM_022475135.1,xanthine dehydrogenase/oxidase-like,21227
NC_035787.1,46939234,46965556,46939234,46961002,111108476,XM_022444392.1,xanthine dehydrogenase/oxidase-like,21768
NC_035787.1,46939234,46965556,46939234,46963748,111108476,XM_022444389.1,xanthine dehydrogenase/oxidase-like,24514
NC_035787.1,46939234,46965556,46939234,46965556,111108476,XM_022444391.1,xanthine dehydrogenase/oxidase-like,26322
NC_035781.1,7589782,7641768,7589782,7641768,111120066,XM_022460718.1,short-chain dehydrogenase/reductase family 42E member 1-like,51986
NC_035783.1,18829588,18845254,18829588,18845254,111128402,XM_022473997.1,degenerin del-1-like,15666
NC_035781.1,53276429,53284695,53276429,53284695,111121538,XM_022462856.1,enoyl-CoA delta isomerase 1,8266
NC_035783.1,19807803,19814537,19807803,19814537,111127974,XM_022473304.1,sphingolipid delta(4)-desaturase DES1-like,6734
NC_035784.1,96704184,96711092,96704184,96711092,111135839,XM_022486234.1,probable delta-1-pyrroline-5-carboxylate synthase,6908
NC_035780.1,14187682,14209323,14188585,14202932,111116519,XM_022455567.1,catenin delta-2-like,14347
NC_035780.1,14548251,14572076,14553562,14570994,111114913,XM_022454087.1,catenin delta-2-like,17432
NC_035780.1,14187682,14209323,14188585,14207311,111116519,XM_022455560.1,catenin delta-2-like,18726
NC_035780.1,14187682,14209323,14188585,14207313,111116519,XM_022455531.1,catenin delta-2-like,18728
NC_035780.1,14187682,14209323,14188585,14208192,111116519,XM_022455574.1,catenin delta-2-like,19607
NC_035780.1,14187682,14209323,14188585,14208231,111116519,XM_022455552.1,catenin delta-2-like,19646
NC_035780.1,14548251,14572076,14550270,14570994,111114913,XM_022454005.1,catenin delta-2-like,20724
NC_035780.1,14548251,14572076,14550269,14570994,111114913,XM_022453628.1,catenin delta-2-like,20725
NC_035780.1,14187682,14209323,14188585,14209323,111116519,XM_022455523.1,catenin delta-2-like,20738
NC_035780.1,14187682,14209323,14187682,14209323,111116519,XM_022455516.1,catenin delta-2-like,21641
NC_035780.1,14548251,14572076,14549344,14570994,111114913,XM_022453866.1,catenin delta-2-like,21650
NC_035780.1,14548251,14572076,14549304,14570994,111114913,XM_022453943.1,catenin delta-2-like,21690
NC_035780.1,14548251,14572076,14548251,14570994,111114913,XM_022453790.1,catenin delta-2-like,22743
NC_035780.1,14548251,14572076,14548251,14572076,111114913,XM_022453496.1,catenin delta-2-like,23825
NC_035784.1,26366689,26377424,26366689,26377424,111135961,XM_022486463.1,polymerase delta-interacting protein 2-like,10735
NC_035780.1,23680356,23686739,23680356,23686739,111111819,XM_022448977.1,lysine-specific demethylase 8-like,6383
NC_035782.1,28761282,28769709,28761282,28769709,111122525,XM_022464309.1,outer dense fiber protein 3-like,8427
NC_035785.1,32414052,32416782,32414052,32416782,111099469,XM_022430757.1,low density lipoprotein receptor adapter protein 1-like,2730
NC_035782.1,66995667,67004140,66995667,67004140,111123978,XM_022466760.1,probable deoxyhypusine synthase,8473
NC_035781.1,30490827,30497684,30490827,30497684,111119373,XM_022459467.1,putative deoxyribonuclease TATDN1,6857
NC_035781.1,25151499,25155938,25152741,25155938,111122071,XM_022463625.1,acyl-CoA desaturase-like,3197
NC_035781.1,25151499,25155938,25151610,25155938,111122071,XM_022463624.1,acyl-CoA desaturase-like,4328
NC_035781.1,25151499,25155938,25151499,25155938,111122071,XM_022463623.1,acyl-CoA desaturase-like,4439
NC_035781.1,25690623,25695475,25690835,25695475,111118955,XM_022458688.1,acyl-CoA desaturase-like,4640
NC_035781.1,25690623,25695475,25690623,25695475,111118955,XM_022458687.1,acyl-CoA desaturase-like,4852
NC_035781.1,25696159,25702596,25696159,25702596,111118956,XM_022458690.1,acyl-CoA desaturase-like,6437
NC_035781.1,25157141,25163991,25157141,25163991,111122073,XM_022463626.1,acyl-CoA desaturase-like,6850
NC_035784.1,57135167,57143236,57135167,57143236,111136090,XM_022486692.1,cysteine desulfurase,8069
NC_035785.1,33117329,33126090,33117329,33126090,111099585,XM_022430907.1,lys-63-specific deubiquitinase BRCC36-like,8761
NC_035782.1,54712061,54712984,54712061,54712984,111124310,XM_022467162.1,craniofacial development protein 2-like,923
NC_035787.1,1097332,1106003,1097332,1106003,111109461,XM_022445578.1,interferon-related developmental regulator 1-like,8671
NC_035781.1,43893486,43905875,43893486,43905875,111120484,XM_022461217.1,sn1-specific diacylglycerol lipase beta-like,12389
NC_035783.1,13884630,13893870,13884630,13893870,111130098,XM_022476792.1,probable diaminopimelate decarboxylase,9240
NC_035782.1,69775866,69797718,69775866,69797718,111125745,XM_022469827.1,protein diaphanous homolog 2-like,21852
NC_035781.1,37370028,37377133,37370028,37377133,111118567,XM_022458102.1,mitochondrial dicarboxylate carrier-like,7105
NC_035780.1,8954063,8955756,8954063,8955756,111114939,XM_022453497.1,myeloid differentiation primary response protein MyD88-like,1693
NC_035781.1,15059901,15071454,15059901,15071454,111118417,XM_022457888.1,ganglioside-induced differentiation-associated protein 1-like,11553
NC_035784.1,18168600,18180465,18168600,18180465,111132890,XM_022480813.1,synapse differentiation-inducing gene protein 1-like,11865
NC_035782.1,61366793,61371994,61366793,61371994,111122652,XM_022464504.1,endothelial differentiation-related factor 1 homolog,5201
NC_035782.1,62408712,62417832,62408712,62417832,111127200,XM_022472278.1,NADPH-dependent diflavin oxidoreductase 1-like,9120
NC_035784.1,81875080,81881439,81875080,81881439,111134814,XM_022484235.1,max dimerization protein 1-like,6359
NC_035781.1,64081,73148,64081,73148,111122450,XM_022464255.1,probable dimethyladenosine transferase,9067
NC_035781.1,42118767,42136101,42119757,42136101,111121427,XM_022462715.1,tRNA dimethylallyltransferase,16344
NC_035781.1,42118767,42136101,42119048,42136096,111121427,XM_022462714.1,tRNA dimethylallyltransferase,17048
NC_035781.1,42118767,42136101,42118767,42136101,111121427,XM_022462713.1,tRNA dimethylallyltransferase,17334
NC_035780.1,14250564,14251727,14250564,14251727,111116748,XM_022455743.1,2-oxoglutarate-dependent dioxygenase mpl2-like,1163
NC_035784.1,72254701,72268898,72254701,72265366,111132862,XM_022480765.1,trimethyllysine dioxygenase,10665
NC_035784.1,72254701,72268898,72254701,72267095,111132862,XM_022480764.1,trimethyllysine dioxygenase,12394
NC_035784.1,72254701,72268898,72254701,72268898,111132862,XM_022480763.1,trimethyllysine dioxygenase,14197
NC_035787.1,33118644,33123712,33118644,33123712,111107491,XM_022442713.1,phytanoyl-CoA dioxygenase,5068
NC_035787.1,32744131,32749213,32744131,32749213,111108762,XM_022444821.1,phytanoyl-CoA dioxygenase,5082
NC_035787.1,32734979,32742596,32734979,32742596,111108763,XM_022444822.1,phytanoyl-CoA dioxygenase,7617
NC_035787.1,33125503,33134328,33125503,33134328,111107492,XM_022442714.1,phytanoyl-CoA dioxygenase,8825
NC_035784.1,63173402,63177993,63173402,63177993,111134596,XM_022483760.1,4-hydroxyphenylpyruvate dioxygenase-like protein,4591
NC_035782.1,42317845,42330875,42317886,42330875,111125861,XM_022470062.1,ectoine dioxygenase-like,12989
NC_035782.1,42309577,42311715,42309578,42311714,111125862,XM_022470063.1,ectoine dioxygenase-like,2136
NC_035782.1,42309577,42311715,42309577,42311715,111125862,XM_022470064.1,ectoine dioxygenase-like,2138
NC_035782.1,31134437,31138347,31134437,31138347,111126358,XM_022470923.1,ectoine dioxygenase-like,3910
NC_035782.1,69293052,69297052,69293052,69297047,111124922,XM_022468230.1,ectoine dioxygenase-like,3995
NC_035782.1,69293052,69297052,69293052,69297052,111124922,XM_022468229.1,ectoine dioxygenase-like,4000
NC_035781.1,55119890,55123933,55119890,55123933,111118520,XM_022458038.1,ectoine dioxygenase-like,4043
NC_035782.1,42317845,42330875,42317845,42322531,111125861,XM_022470061.1,ectoine dioxygenase-like,4686
NC_035782.1,42317845,42330875,42323640,42330874,111125861,XM_022470060.1,ectoine dioxygenase-like,7234
NC_035782.1,6348735,6357760,6348735,6356068,111125373,XM_022469123.1,ectoine dioxygenase-like,7333
NC_035782.1,31140493,31147902,31140493,31147902,111126357,XM_022470922.1,ectoine dioxygenase-like,7409
NC_035782.1,6348735,6357760,6348736,6357760,111125373,XM_022469125.1,ectoine dioxygenase-like,9024
NC_035782.1,19034465,19035451,19034465,19035451,111126141,XM_022470558.1,2-aminoethanethiol dioxygenase-like,986
NC_035782.1,53743168,53745287,53743168,53745287,111126765,XM_022471615.1,alpha-aspartyl dipeptidase-like,2119
NC_035782.1,53723871,53726075,53723871,53726075,111123988,XM_022466797.1,alpha-aspartyl dipeptidase-like,2204
NC_035784.1,528985,534058,528985,534058,111133730,XM_022482350.1,xaa-Pro dipeptidase-like,5073
NC_035784.1,1683653,1689666,1683653,1689666,111136000,XM_022486538.1,xaa-Pro dipeptidase-like,6013
NC_035784.1,1705895,1712239,1705895,1712239,111135287,XM_022485219.1,xaa-Pro dipeptidase-like,6344
NC_035784.1,549202,556103,549202,556103,111133725,XM_022482344.1,xaa-Pro dipeptidase-like,6901
NC_035787.1,60015034,60018359,60015034,60018359,111108701,XM_022444738.1,m7GpppX diphosphatase-like,3325
NC_035781.1,33264502,33265992,33264502,33265992,111120031,XM_022460668.1,nucleoside diphosphate kinase homolog 5-like,1490
NC_035782.1,52194427,52203344,52194427,52203344,111126996,XM_022471962.1,nucleoside diphosphate-linked moiety X motif 6-like,8917
NC_035780.1,22660984,22668299,22660984,22668299,111104113,XM_022437876.1,A disintegrin and metalloproteinase with thrombospondin motifs adt-2-like,7315
NC_035786.1,53102568,53106486,53102568,53106486,111102390,XM_022435096.1,superoxide dismutase [Mn],3918
NC_035783.1,20219898,20226236,20219898,20226236,111130293,XM_022477145.1,protein dispatched homolog 1-like,6338
NC_035781.1,40955043,40961219,40955043,40961219,111121042,XM_022462141.1,nuclear distribution protein nudE homolog 1-like,6176
NC_035780.1,33461973,33479797,33461973,33479797,111125951,XM_022470244.1,protein disulfide-isomerase A5-like,17824
NC_035781.1,7403250,7409017,7403250,7409017,111120591,XM_022461404.1,protein disulfide-isomerase-like,5767
NC_035784.1,68836173,68846605,68836173,68846605,111135786,XM_022486142.1,ecto-NOX disulfide-thiol exchanger 2-like,10432
NC_035780.1,63011473,63019501,63011473,63019501,111114636,XM_022453031.1,cell division control protein 42 homolog,8028
NC_035780.1,10516145,10528481,10516145,10528480,111122131,XM_022463721.1,probable dolichyl pyrophosphate Glc1Man9GlcNAc2 alpha-1,12335
NC_035780.1,4023314,4027505,4023314,4027505,111130195,XM_022476975.1,PR domain zinc finger protein 2-like,4191
NC_035782.1,71500801,71510880,71500801,71510880,111126745,XM_022471584.1,POU domain,10079
NC_035782.1,13715178,13727316,13715178,13727316,111127122,XM_022472155.1,POU domain,12138
NC_035788.1,53313494,53329959,53313494,53326083,111114450,XM_022452744.1,POU domain,12589
NC_035786.1,25142829,25144269,25142829,25144269,111104174,XM_022437979.1,POU domain,1440
NC_035782.1,72729459,72745491,72729459,72745491,111127064,XM_022472066.1,POU domain,16032
NC_035788.1,53313494,53329959,53313494,53329959,111114450,XM_022452743.1,POU domain,16465
NC_035782.1,71500801,71510880,71507958,71510880,111126745,XM_022471581.1,POU domain,2922
NC_035782.1,72729459,72745491,72729459,72732438,111127064,XM_022472063.1,POU domain,2979
NC_035782.1,71500801,71510880,71503206,71510880,111126745,XM_022471582.1,POU domain,7674
NC_035782.1,72729459,72745491,72729459,72737214,111127064,XM_022472064.1,POU domain,7755
NC_035782.1,72729459,72745491,72729459,72739149,111127064,XM_022472067.1,POU domain,9690
NC_035782.1,71500801,71510880,71501028,71510880,111126745,XM_022471583.1,POU domain,9852
NC_035782.1,72729459,72745491,72729459,72739412,111127064,XM_022472065.1,POU domain,9953
NC_035781.1,28635624,28653886,28635624,28653886,111120219,XM_022460948.1,NACHT domain- and WD repeat-containing protein 1-like,18262
NC_035788.1,12973932,13040233,12973932,13040233,111114721,XM_022453160.1,transformation/transcription domain-associated protein-like,66301
NC_035782.1,10688344,10717322,10688344,10717322,111124871,XM_022468125.1,prion-like-(Q/N-rich) domain-bearing protein 25,28978
NC_035780.1,57106952,57119896,57106952,57119896,111137026,XM_022488255.1,SH3 domain-binding protein 5-like,12944
NC_035780.1,604924,622983,604924,622983,111138315,XM_022490210.1,R3H domain-containing protein 1-like,18059
NC_035781.1,1157798,1164287,1159092,1164287,111120648,XM_022461523.1,KH domain-containing,5195
NC_035787.1,10478109,10497435,10478109,10497435,111107410,XM_022442604.1,EGF domain-specific O-linked N-acetylglucosamine transferase-like,19326
NC_035784.1,3917727,3953351,3917727,3953351,111136148,XM_022486787.1,helicase domino-like,35624
NC_035782.1,51531042,51532611,51531042,51532611,111122655,XM_022464508.1,D(2) dopamine receptor-like,1569
NC_035786.1,49002263,49028264,49002263,49028264,111103322,XM_022436508.1,protein dopey-1-like,26001
NC_035786.1,46269992,46278054,46269992,46278054,111104642,XM_022438706.1,protein downstream neighbor of son homolog,8062
NC_035783.1,53356624,53358904,53356624,53358904,111131242,XM_022478680.1,protein dpy-30 homolog,2280
NC_035784.1,68292179,68302506,68292179,68302506,111133886,XM_022482597.1,protein draper-like,10327
NC_035788.1,13876082,13886602,13876082,13886602,111112376,XM_022449842.1,protein draper-like,10520
NC_035786.1,18742241,18848314,18742241,18848314,111103030,XM_022436028.1,protein draper-like,106073
NC_035789.1,23553154,23583429,23553158,23563925,111117670,XM_022456837.1,protein draper-like,10767
NC_035784.1,62671358,62682216,62671358,62682216,111137132,XM_022488439.1,protein draper-like,10858
NC_035788.1,95550492,95561403,95550492,95561403,111112850,XM_022450703.1,protein draper-like,10911
NC_035784.1,42967332,42978372,42967332,42978372,111099147,XM_022430531.1,protein draper-like,11040
NC_035787.1,33916938,33954805,33943625,33954805,111108071,XM_022443593.1,protein draper-like,11180
NC_035788.1,10989381,11001642,10989381,11000674,111112827,XM_022450665.1,protein draper-like,11293
NC_035786.1,18476186,18487481,18476186,18487481,111104903,XM_022439073.1,protein draper-like,11295
NC_035782.1,12980731,13003474,12991718,13003474,111125688,XM_022469746.1,protein draper-like,11756
NC_035788.1,57522730,57534613,57522730,57534613,111113007,XM_022450925.1,protein draper-like,11883
NC_035788.1,7585475,7597434,7585475,7597434,111112546,XM_022450071.1,protein draper-like,11959
NC_035788.1,10989381,11001642,10989381,11001642,111112827,XM_022450663.1,protein draper-like,12261
NC_035788.1,13684987,13697360,13685005,13697360,111112374,XM_022449834.1,protein draper-like,12355
NC_035788.1,45857232,45869595,45857232,45869595,111113184,XM_022451266.1,protein draper-like,12363
NC_035788.1,13684987,13697360,13684987,13697360,111112374,XM_022449836.1,protein draper-like,12373
NC_035789.1,29114804,29127939,29114804,29127939,111116561,XM_022455559.1,protein draper-like,13135
NC_035788.1,36327515,36341083,36327515,36341083,111113796,XM_022452087.1,protein draper-like,13568
NC_035787.1,23379202,23393475,23379202,23393475,111110286,XM_022446712.1,protein draper-like,14273
NC_035787.1,39657042,39663704,39662228,39663704,111109919,XM_022446186.1,protein draper-like,1476
NC_035787.1,20697069,20712056,20697069,20712056,111106413,XM_022441078.1,protein draper-like,14987
NC_035788.1,9350726,9366019,9350726,9366019,111113463,XM_022451760.1,protein draper-like,15293
NC_035788.1,12456139,12505567,12490235,12505566,111114724,XM_022453171.1,protein draper-like,15331
NC_035788.1,97260519,97276052,97260519,97276052,111112924,XM_022450812.1,protein draper-like,15533
NC_035788.1,12456139,12505567,12489666,12505565,111114724,XM_022453168.1,protein draper-like,15899
NC_035788.1,12456139,12505567,12489665,12505566,111114724,XM_022453169.1,protein draper-like,15901
NC_035788.1,12456139,12505567,12489664,12505566,111114724,XM_022453167.1,protein draper-like,15902
NC_035789.1,32160263,32176439,32160263,32176439,111117118,XM_022456206.1,protein draper-like,16176
NC_035788.1,33237712,33254000,33237712,33254000,111113252,XM_022451354.1,protein draper-like,16288
NC_035789.1,23334598,23354269,23334598,23351138,111117400,XM_022456510.1,protein draper-like,16540
NC_035789.1,23638248,23655218,23638248,23655218,111117673,XM_022456840.1,protein draper-like,16970
NC_035789.1,24625284,24642320,24625284,24642320,111117643,XM_022456800.1,protein draper-like,17036
NC_035788.1,97642169,97659756,97642169,97659756,111114373,XM_022452666.1,protein draper-like,17587
NC_035789.1,29077741,29095888,29077741,29095888,111116560,XM_022455558.1,protein draper-like,18147
NC_035786.1,7836933,8020653,7836933,8020653,111103574,XM_022436930.1,protein draper-like,183720
NC_035788.1,7793998,7795938,7793998,7795938,111112693,XM_022450417.1,protein draper-like,1940
NC_035789.1,23334598,23354269,23334598,23354016,111117400,XM_022456511.1,protein draper-like,19418
NC_035789.1,23334598,23354269,23334598,23354267,111117400,XM_022456513.1,protein draper-like,19669
NC_035789.1,23334598,23354269,23334598,23354269,111117400,XM_022456509.1,protein draper-like,19671
NC_035786.1,12904905,12924737,12904905,12924737,111103753,XM_022437210.1,protein draper-like,19832
NC_035788.1,26497922,26518477,26497922,26518477,111112708,XM_022450441.1,protein draper-like,20555
NC_035786.1,26224325,26226451,26224325,26226451,111104963,XM_022439142.1,protein draper-like,2126
NC_035786.1,16396300,16417891,16396300,16417891,111104882,XM_022439049.1,protein draper-like,21591
NC_035788.1,34280523,34282894,34280523,34282894,111113770,XM_022452059.1,protein draper-like,2371
NC_035787.1,49625042,49650125,49625042,49650125,111106787,XM_022441608.1,protein draper-like,25083
NC_035780.1,52449450,52451960,52449450,52451960,111126404,XM_022471057.1,protein draper-like,2510
NC_035786.1,25353201,25355840,25353201,25355840,111104957,XM_022439134.1,protein draper-like,2639
NC_035786.1,7836933,8020653,7836933,7839593,111103574,XM_022436928.1,protein draper-like,2660
NC_035788.1,9124455,9154030,9124455,9152135,111115663,XM_022454488.1,protein draper-like,27680
NC_035788.1,31818247,31821017,31818247,31821017,111110709,XM_022447296.1,protein draper-like,2770
NC_035788.1,18265071,18267880,18265071,18267880,111115585,XM_022454375.1,protein draper-like,2809
NC_035787.1,20809694,20838472,20809694,20838471,111106409,XM_022441073.1,protein draper-like,28777
NC_035787.1,20809694,20838472,20809694,20838472,111106409,XM_022441072.1,protein draper-like,28778
NC_035788.1,100648765,100677604,100648765,100677604,111114400,XM_022452694.1,protein draper-like,28839
NC_035788.1,41349937,41352834,41349937,41352834,111112521,XM_022450052.1,protein draper-like,2897
NC_035787.1,20108387,20111292,20108387,20111292,111110534,XM_022447074.1,protein draper-like,2905
NC_035788.1,9124455,9154030,9124455,9154030,111115663,XM_022454489.1,protein draper-like,29575
NC_035787.1,68666733,68696311,68666733,68696311,111106914,XM_022441794.1,protein draper-like,29578
NC_035789.1,23553154,23583429,23553154,23583429,111117670,XM_022456836.1,protein draper-like,30275
NC_035789.1,24737111,24769053,24737111,24768990,111117346,XM_022456431.1,protein draper-like,31879
NC_035789.1,24737111,24769053,24737111,24769053,111117346,XM_022456428.1,protein draper-like,31942
NC_035781.1,50205580,50243326,50205580,50237578,111120801,XM_022461777.1,protein draper-like,31998
NC_035789.1,10312166,10315577,10312166,10315577,111116270,XM_022455257.1,protein draper-like,3411
NC_035781.1,50205580,50243326,50205580,50243326,111120801,XM_022461775.1,protein draper-like,37746
NC_035787.1,33916938,33954805,33916938,33954805,111108071,XM_022443592.1,protein draper-like,37867
NC_035780.1,31000341,31004144,31000341,31004144,111126000,XM_022470352.1,protein draper-like,3803
NC_035787.1,70279142,70317302,70279142,70317302,111106135,XM_022440679.1,protein draper-like,38160
NC_035784.1,39187303,39192793,39188947,39192793,111136355,XM_022487162.1,protein draper-like,3846
NC_035786.1,19061160,19065106,19061160,19065106,111104762,XM_022438875.1,protein draper-like,3946
NC_035784.1,38832641,38836720,38832641,38836720,111136361,XM_022487167.1,protein draper-like,4079
NC_035786.1,25516003,25520088,25516003,25520088,111105484,XM_022439805.1,protein draper-like,4085
NC_035786.1,26156404,26160530,26156404,26160530,111104961,XM_022439139.1,protein draper-like,4126
NC_035785.1,47945886,47950147,47945886,47950147,111101574,XM_022434105.1,protein draper-like,4261
NC_035784.1,84565813,84570243,84565813,84570243,111138240,XM_022490111.1,protein draper-like,4430
NC_035781.1,8015042,8021964,8015042,8019481,111118317,XM_022457721.1,protein draper-like,4439
NC_035788.1,7283758,7288276,7283758,7288276,111112543,XM_022450069.1,protein draper-like,4518
NC_035784.1,68317954,68325247,68317954,68322496,111132296,XM_022480093.1,protein draper-like,4542
NC_035781.1,8015042,8021964,8015042,8019646,111118317,XM_022457723.1,protein draper-like,4604
NC_035784.1,11986659,11991420,11986659,11991420,111135014,XM_022484691.1,protein draper-like,4761
NC_035788.1,27931673,27936458,27931673,27936458,111114509,XM_022452844.1,protein draper-like,4785
NC_035786.1,22162201,22167114,22162201,22167114,111105533,XM_022439881.1,protein draper-like,4913
NC_035786.1,9437701,9442615,9437701,9442615,111104411,XM_022438338.1,protein draper-like,4914
NC_035788.1,12456139,12505567,12456139,12505567,111114724,XM_022453170.1,protein draper-like,49428
NC_035784.1,39187303,39192793,39187319,39192793,111136355,XM_022487160.1,protein draper-like,5474
NC_035784.1,39187303,39192793,39187303,39192793,111136355,XM_022487158.1,protein draper-like,5490
NC_035788.1,34868622,34874441,34868622,34874441,111111924,XM_022449115.1,protein draper-like,5819
NC_035788.1,33220091,33226017,33220091,33226017,111113747,XM_022452034.1,protein draper-like,5926
NC_035789.1,23542868,23549478,23543527,23549478,111116622,XM_022455619.1,protein draper-like,5951
NC_035788.1,57418653,57424674,57418657,57424672,111113003,XM_022450920.1,protein draper-like,6015
NC_035788.1,57418653,57424674,57418653,57424674,111113003,XM_022450921.1,protein draper-like,6021
NC_035788.1,95550492,95561403,95550492,95556894,111112850,XM_022450704.1,protein draper-like,6402
NC_035788.1,99113927,99199118,99113927,99178212,111113084,XM_022451057.1,protein draper-like,64285
NC_035788.1,99113927,99199118,99113927,99178267,111113084,XM_022451058.1,protein draper-like,64340
NC_035786.1,44943745,44950233,44943745,44950233,111102983,XM_022435948.1,protein draper-like,6488
NC_035784.1,68317954,68325247,68317954,68324535,111132296,XM_022480091.1,protein draper-like,6581
NC_035789.1,23542868,23549478,23542868,23549478,111116622,XM_022455621.1,protein draper-like,6610
NC_035787.1,33837988,33844603,33837988,33844603,111108070,XM_022443591.1,protein draper-like,6615
NC_035787.1,39657042,39663704,39657042,39663704,111109919,XM_022446185.1,protein draper-like,6662
NC_035788.1,99113927,99199118,99113927,99180584,111113084,XM_022451056.1,protein draper-like,66657
NC_035781.1,8015042,8021964,8015042,8021964,111118317,XM_022457720.1,protein draper-like,6922
NC_035784.1,68317954,68325247,68317954,68325247,111132296,XM_022480092.1,protein draper-like,7293
NC_035786.1,18366155,18373713,18366155,18373713,111104900,XM_022439070.1,protein draper-like,7558
NC_035787.1,20859041,20866844,20859041,20866844,111106414,XM_022441081.1,protein draper-like,7803
NC_035787.1,39593487,39601719,39593487,39601719,111110468,XM_022446973.1,protein draper-like,8232
NC_035788.1,25539137,25547445,25539137,25547445,111113653,XM_022451945.1,protein draper-like,8308
NC_035780.1,39862576,39871078,39862576,39871078,111120422,XM_022461139.1,protein draper-like,8502
NC_035789.1,24715015,24723577,24715015,24723577,111116514,XM_022455508.1,protein draper-like,8562
NC_035789.1,10512873,10521878,10512873,10521878,111116275,XM_022455263.1,protein draper-like,9005
NC_035788.1,25488664,25497802,25488664,25497802,111115507,XM_022454273.1,protein draper-like,9138
NC_035788.1,45857232,45869595,45857232,45866536,111113184,XM_022451268.1,protein draper-like,9304
NC_035789.1,23553154,23583429,23573729,23583429,111117670,XM_022456834.1,protein draper-like,9700
NC_035781.1,56266920,56281582,56266920,56281582,111120659,XM_022461550.1,CMT1A duplicated region transcript 1 protein-like,14662
NC_035788.1,37571469,37617775,37571469,37617775,111111453,XM_022448449.1,bacterial dynamin-like protein,46306
NC_035780.1,23613390,23631708,23613390,23631708,111126828,XM_022471753.1,cytoplasmic dynein 1 intermediate chain 2-like,18318
NC_035782.1,51666541,51668298,51666541,51668298,111125757,XM_022469843.1,immediate early response gene 5-like protein,1757
NC_035781.1,38979946,38990264,38979946,38990264,111120741,XM_022461674.1,protein ecdysoneless homolog,10318
NC_035786.1,12627702,12629807,12627702,12629807,111102377,XM_022435074.1,snaclec echicetin subunit beta-like,2105
NC_035780.1,41936146,42011576,41936146,42011576,111135999,XM_022486542.1,alanyl-tRNA editing protein Aarsd1-like,75430
NC_035782.1,13780462,13783863,13780462,13783863,111123153,XM_022465306.1,death effector domain-containing protein-like,3401
NC_035780.1,22302036,22304438,22302036,22304438,111125038,XM_022468475.1,major egg antigen-like,2402
NC_035782.1,8078370,8085914,8078370,8085914,111122692,XM_022464566.1,chymotrypsin-like elastase family member 2A,7544
NC_035781.1,31133996,31149350,31133996,31149350,111119727,XM_022460166.1,TATA element modulatory factor-like,15354
NC_035782.1,2190979,2203743,2190979,2203743,111123344,XM_022465625.1,metal-response element-binding transcription factor 2-like,12764
NC_035780.1,44496556,44506042,44496556,44506042,111112060,XM_022449359.1,transcription elongation factor B polypeptide 3-like,9486
NC_035783.1,29181168,29198673,29181168,29198673,111129366,XM_022475710.1,putative elongator complex protein 1,17505
NC_035781.1,2872776,2886951,2872776,2886951,111121357,XM_022462600.1,maternal embryonic leucine zipper kinase-like,14175
NC_035783.1,19113293,19113970,19113293,19113970,111129530,XM_022475984.1,transmembrane emp24 domain-containing protein 7-like,677
NC_035781.1,18533148,18534132,18533148,18534132,111120153,XM_022460879.1,protein enabled homolog,984
NC_035784.1,12699167,12700499,12699167,12700499,111133337,XM_022481640.1,non-homologous end-joining factor 1-like,1332
NC_035783.1,39550262,39560512,39550262,39560512,111130914,XM_022478186.1,mannan endo-1,10250
NC_035780.1,63191103,63192579,63191103,63192579,111109225,XM_022445310.1,bifunctional endo-1,1476
NC_035784.1,75675311,75680082,75675311,75680082,111137508,XM_022488977.1,mannan endo-1,4771
NC_035782.1,16261771,16270258,16261771,16270258,111127115,XM_022472143.1,mannan endo-1,8487
NC_035783.1,42196340,42205654,42196340,42205654,111130764,XM_022477996.1,mannan endo-1,9314
NC_035782.1,16852131,16861755,16852131,16861755,111124954,XM_022468320.1,mannan endo-1,9624
NC_035786.1,33768442,33771195,33768442,33771195,111103326,XM_022436510.1,glycoprotein endo-alpha-1,2753
NC_035781.1,17763447,17786517,17770394,17785600,111120068,XM_022460721.1,cytosolic endo-beta-N-acetylglucosaminidase-like,15206
NC_035781.1,17763447,17786517,17770381,17786517,111120068,XM_022460719.1,cytosolic endo-beta-N-acetylglucosaminidase-like,16136
NC_035781.1,17763447,17786517,17765483,17785600,111120068,XM_022460722.1,cytosolic endo-beta-N-acetylglucosaminidase-like,20117
NC_035781.1,17763447,17786517,17763447,17785600,111120068,XM_022460720.1,cytosolic endo-beta-N-acetylglucosaminidase-like,22153
NC_035781.1,17763447,17786517,17779844,17785600,111120068,XM_022460723.1,cytosolic endo-beta-N-acetylglucosaminidase-like,5756
NC_035781.1,18818989,18826507,18820280,18826507,111120727,XM_022461656.1,cytosolic endo-beta-N-acetylglucosaminidase-like,6227
NC_035781.1,18818989,18826507,18820262,18826507,111120727,XM_022461655.1,cytosolic endo-beta-N-acetylglucosaminidase-like,6245
NC_035781.1,18818989,18826507,18818989,18826507,111120727,XM_022461654.1,cytosolic endo-beta-N-acetylglucosaminidase-like,7518
NC_035781.1,48268815,48276465,48268815,48276465,111121390,XM_022462658.1,probable endochitinase,7650
NC_035780.1,31290091,31295838,31290091,31295838,111124329,XM_022467184.1,tRNA-splicing endonuclease subunit Sen34-like,5747
NC_035780.1,2768318,2771708,2768318,2771708,111136873,XM_022488024.1,GDH/6PGL endoplasmic bifunctional protein-like,3390
NC_035786.1,35463004,35475038,35463005,35475038,111103856,XM_022437410.1,PC3-like endoprotease variant B,12033
NC_035781.1,29833345,29838577,29833345,29838577,111121319,XM_022462535.1,poly(U)-specific endoribonuclease-B-like,5232
NC_035784.1,34987790,34991545,34987790,34991545,111133265,XM_022481475.1,poly(U)-specific endoribonuclease-C-like,3755
NC_035784.1,34857829,34862403,34857829,34862403,111133266,XM_022481476.1,poly(U)-specific endoribonuclease-C-like,4574
NC_035780.1,14669359,14671743,14669359,14671743,111131407,XM_022478913.1,poly(U)-specific endoribonuclease-like,2384
NC_035780.1,14091823,14098076,14091823,14098076,111099064,XM_022430414.1,poly(U)-specific endoribonuclease-like,6253
NC_035783.1,25258994,25280820,25258994,25280820,111130456,XM_022477538.1,early endosome antigen 1-like,21826
NC_035780.1,52351290,52353818,52351290,52353818,111123765,XM_022470433.1,platelet endothelial aggregation receptor 1-like,2528
NC_035780.1,23836618,23854745,23836618,23854745,111130354,XM_022477344.1,connector enhancer of kinase suppressor of ras 2-like,18127
NC_035788.1,39870760,39875353,39870760,39875353,111113821,XM_022452111.1,interleukin enhancer-binding factor 2 homolog,4593
NC_035781.1,15711391,15717793,15711391,15717793,111122412,XM_022464197.1,mitochondrial enolase superfamily member 1-like,6402
NC_035780.1,43518139,43523191,43518139,43523191,111119548,XM_022459797.1,putative enoyl-CoA hydratase/isomerase YngF,5052
NC_035780.1,9092949,9103065,9092949,9103065,111110435,XM_022446937.1,nuclear envelope integral membrane protein 1-like,10116
NC_035780.1,3571851,3586138,3571851,3586138,111126102,XM_022470508.1,ubiquitin-conjugating enzyme E2 Z-like,14287
NC_035782.1,18075712,18079513,18075712,18079513,111123489,XM_022465831.1,fibrinolytic enzyme,3801
NC_035782.1,17709552,17713487,17709552,17713487,111127609,XM_022472866.1,fibrinolytic enzyme,3935
NC_035782.1,8853524,8858377,8853524,8858377,111123660,XM_022466148.1,fibrinolytic enzyme,4853
NC_035782.1,8067533,8072459,8067533,8072459,111123628,XM_022466083.1,fibrinolytic enzyme,4926
NC_035782.1,8822165,8827972,8822165,8827972,111122788,XM_022464719.1,fibrinolytic enzyme,5807
NC_035782.1,8097567,8104390,8097567,8104390,111126930,XM_022471877.1,fibrinolytic enzyme,6823
NC_035782.1,10134483,10142272,10134483,10142272,111126994,XM_022471959.1,fibrinolytic enzyme,7789
NC_035785.1,36599500,36615552,36605477,36615552,111101895,XM_022434547.1,insulin-degrading enzyme-like,10075
NC_035780.1,23696487,23707290,23696487,23707290,111101340,XM_022433798.1,angiotensin-converting enzyme-like,10803
NC_035784.1,27514924,27526713,27514924,27526713,111137463,XM_022488927.1,angiotensin-converting enzyme-like,11789
NC_035787.1,14270487,14285016,14270487,14285016,111109462,XM_022445579.1,acylamino-acid-releasing enzyme-like,14529
NC_035785.1,36599500,36615552,36599500,36615552,111101895,XM_022434546.1,insulin-degrading enzyme-like,16052
NC_035780.1,58228460,58244519,58228460,58244519,111107787,XM_022443140.1,angiotensin-converting enzyme-like,16059
NC_035780.1,43120733,43128480,43120733,43128480,111116311,XM_022455299.1,mRNA-capping enzyme-like,7747
NC_035781.1,30911770,30916435,30911770,30916435,111119557,XM_022459815.1,mammalian ependymin-related protein 1-like,4665
NC_035780.1,9324834,9326769,9324834,9326769,111120647,XM_022461521.1,multiple epidermal growth factor-like domains protein 10,1935
NC_035783.1,32664594,32671463,32664687,32671463,111128123,XM_022473582.1,methylmalonyl-CoA epimerase,6776
NC_035783.1,32664594,32671463,32664594,32671460,111128123,XM_022473581.1,methylmalonyl-CoA epimerase,6866
NC_035788.1,41826338,41841693,41831576,41841693,111112515,XM_022450045.1,NAD(P)H-hydrate epimerase-like,10117
NC_035788.1,41317010,41327229,41317010,41327201,111112513,XM_022450042.1,NAD(P)H-hydrate epimerase-like,10191
NC_035788.1,41317010,41327229,41317010,41327229,111112513,XM_022450041.1,NAD(P)H-hydrate epimerase-like,10219
NC_035788.1,41300866,41312331,41300866,41312331,111111116,XM_022447898.1,NAD(P)H-hydrate epimerase-like,11465
NC_035788.1,44581170,44751054,44585492,44599287,111112266,XM_022449681.1,NAD(P)H-hydrate epimerase-like,13795
NC_035788.1,41826338,41841693,41826338,41841693,111112515,XM_022450046.1,NAD(P)H-hydrate epimerase-like,15355
NC_035788.1,44581170,44751054,44585485,44751054,111112266,XM_022449682.1,NAD(P)H-hydrate epimerase-like,165569
NC_035788.1,41423707,41440996,41423707,41440996,111113836,XM_022452128.1,NAD(P)H-hydrate epimerase-like,17289
NC_035788.1,44502147,44506959,44502147,44506959,111113875,XM_022452168.1,NAD(P)H-hydrate epimerase-like,4812
NC_035788.1,44774834,44779913,44774834,44779913,111113879,XM_022452172.1,NAD(P)H-hydrate epimerase-like,5079
NC_035788.1,43918603,43923765,43918603,43923765,111116121,XM_022455109.1,NAD(P)H-hydrate epimerase-like,5162
NC_035788.1,45077217,45082892,45077217,45082892,111112906,XM_022450782.1,NAD(P)H-hydrate epimerase-like,5675
NC_035788.1,41317010,41327229,41317010,41324237,111112513,XM_022450043.1,NAD(P)H-hydrate epimerase-like,7227
NC_035788.1,43909949,43918466,43909949,43918466,111113867,XM_022452160.1,NAD(P)H-hydrate epimerase-like,8517
NC_035788.1,44581170,44751054,44585488,44595122,111112266,XM_022449683.1,NAD(P)H-hydrate epimerase-like,9634
NC_035780.1,60602848,60617169,60602848,60617169,111130661,XM_022477843.1,tubulin epsilon chain-like,14321
NC_035782.1,45365984,45374674,45365984,45374674,111125180,XM_022468719.1,probable ergosterol biosynthetic protein 28,8690
NC_035784.1,78362457,78380762,78362457,78380762,111137585,XM_022489097.1,macrophage erythroblast attacher-like,18305
NC_035782.1,20967010,20968400,20967010,20968400,111123830,XM_022466454.1,ring-infected erythrocyte surface antigen-like,1390
NC_035780.1,10285891,10294212,10285891,10294212,111115167,XM_022453812.1,myosin-2 essential light chain-like,8321
NC_035781.1,24508030,24511037,24508030,24511037,111120469,XM_022461188.1,cocaine esterase-like,3007
NC_035784.1,66709962,66716765,66709962,66716765,111134539,XM_022483664.1,para-nitrobenzyl esterase-like,6803
NC_035781.1,30326920,30342933,30326920,30342933,111119347,XM_022459415.1,GPI ethanolamine phosphate transferase 2-like,16013
NC_035786.1,29152956,29192155,29152956,29192155,111104403,XM_022438325.1,protein eva-1 homolog C-like,39199
NC_035780.1,8401040,8404074,8401040,8404074,111120471,XM_022461195.1,homeobox even-skipped homolog protein 2-like,3034
NC_035780.1,17014414,17023602,17014414,17023602,111122911,XM_022464949.1,Na(+)/H(+) exchange regulatory cofactor NHE-RF2-like,9188
NC_035780.1,20434565,20451700,20434565,20451700,111136967,XM_022488200.1,sodium/hydrogen exchanger 10-like,17135
NC_035781.1,11817630,11820002,11817630,11820002,111120860,XM_022461864.1,DNA excision repair protein ERCC-8-like,2372
NC_035781.1,5288154,5296584,5288154,5296584,111120909,XM_022461944.1,RNA exonuclease 5-like,8430
NC_035781.1,5296793,5301232,5296793,5301232,111118703,XM_022458284.1,ERI1 exoribonuclease 2-like,4439
NC_035783.1,4557806,4564800,4557806,4564800,111130279,XM_022477122.1,protein expanded-like,6994
NC_035783.1,6535626,6543175,6535626,6543175,111130241,XM_022477029.1,protein expanded-like,7549
NC_035781.1,30193709,30202897,30193709,30202897,111122197,XM_022463822.1,lymphocyte expansion molecule-like,9188
NC_035781.1,9232380,9238688,9232380,9238688,111121417,XM_022462699.1,mRNA export factor-like,6308
NC_035780.1,34466578,34471140,34466578,34471140,111129968,XM_022476573.1,differentially expressed in FDCP 8 homolog A-like,4562
NC_035780.1,6239612,6242277,6239612,6242277,111137796,XM_022489450.1,myelin expression factor 2-like,2665
NC_035783.1,706845,714936,706845,714936,111130678,XM_022477870.1,receptor expression-enhancing protein 5-like,8091
NC_035783.1,34892806,34895151,34892806,34895151,111128146,XM_022473612.1,proline-rich extensin-like protein EPR1,2345
NC_035781.1,43216652,43244545,43216652,43244545,111118932,XM_022458650.1,FRAS1-related extracellular matrix protein 1-like,27893
NC_035780.1,63645812,63648359,63645812,63648359,111099594,XM_022430932.1,cat eye syndrome critical region protein 2-like,2547
NC_035780.1,38145258,38157043,38145258,38157043,111115537,XM_022454309.1,major facilitator superfamily domain-containing protein 6-like,11785
NC_035780.1,3672033,3679631,3672033,3679631,111134929,XM_022484502.1,ADP-ribosylation factor 6,7598
NC_035782.1,74964926,74972388,74964926,74972388,111124731,XM_022467879.1,ribosome-recycling factor,7462
NC_035786.1,33759938,33768367,33759938,33768367,111103325,XM_022436509.1,splicing factor,8429
NC_035784.1,39829191,39838370,39829191,39838370,111135697,XM_022485983.1,splicing factor,9179
NC_035781.1,17006271,17014877,17006271,17014877,111121901,XM_022463381.1,ADP-ribosylation factor-binding protein GGA1-like,8606
NC_035780.1,2919222,2924444,2919222,2924444,111105302,XM_022439543.1,ADP-ribosylation factor-like protein 1,5222
NC_035785.1,16306320,16307341,16306320,16307341,111101555,XM_022434091.1,C1q-related factor-like,1021
NC_035788.1,63714865,63725823,63714865,63725823,111114834,XM_022453330.1,ADP-ribosylation factor-like,10958
NC_035787.1,49600684,49611776,49600684,49611776,111110375,XM_022446854.1,C1q-related factor-like,11092
NC_035788.1,36649795,36650972,36649795,36650972,111112984,XM_022450888.1,C1q-related factor-like,1177
NC_035789.1,31111168,31112366,31111168,31112366,111117656,XM_022456817.1,C1q-related factor-like,1198
NC_035780.1,17762609,17763888,17762609,17763888,111106082,XM_022440613.1,C1q-related factor-like,1279
NC_035780.1,17780298,17781648,17780298,17781648,111136378,XM_022487220.1,C1q-related factor-like,1350
NC_035781.1,32985923,32987278,32985923,32987278,111119545,XM_022459790.1,ADP-ribosylation factor-like,1355
NC_035781.1,32987559,32990019,32988574,32990019,111119546,XM_022459791.1,ADP-ribosylation factor-like,1445
NC_035781.1,32983370,32985064,32983370,32985064,111119544,XM_022459789.1,ADP-ribosylation factor-like,1694
NC_035780.1,17791647,17793386,17791647,17793386,111136446,XM_022487344.1,C1q-related factor-like,1739
NC_035781.1,32964265,32966016,32964265,32966016,111121218,XM_022462383.1,ADP-ribosylation factor-like,1751
NC_035781.1,32977345,32979166,32977345,32979166,111119543,XM_022459788.1,ADP-ribosylation factor-like,1821
NC_035780.1,17802381,17811835,17802381,17804242,111122616,XM_022464448.1,C1q-related factor-like,1861
NC_035781.1,49092230,49094352,49092230,49094352,111118264,XM_022457635.1,ADP-ribosylation factor-like,2122
NC_035786.1,53021648,53023789,53021648,53023789,111105430,XM_022439720.1,C1q-related factor-like,2141
NC_035780.1,45773678,45775877,45773678,45775877,111107752,XM_022443098.1,C1q-related factor-like,2199
NC_035781.1,32987559,32990019,32987559,32990019,111119546,XM_022459792.1,ADP-ribosylation factor-like,2460
NC_035785.1,16171919,16175035,16171919,16175035,111101627,XM_022434194.1,C1q-related factor-like,3116
NC_035780.1,17802381,17811835,17808544,17811830,111122616,XM_022464439.1,C1q-related factor-like,3286
NC_035784.1,11067267,11070906,11067267,11070906,111137179,XM_022488504.1,PCNA-associated factor-like,3639
NC_035782.1,52439444,52443095,52439444,52443095,111125961,XM_022470272.1,NF-kappa-B-repressing factor-like,3651
NC_035787.1,3985865,3989540,3985865,3989540,111107407,XM_022442596.1,G-box-binding factor-like,3675
NC_035788.1,30544234,30544608,30544234,30544608,111113708,XM_022451998.1,C1q-related factor-like,374
NC_035783.1,52515631,52519811,52515631,52519788,111128263,XM_022473799.1,barrier-to-autointegration factor-like,4157
NC_035783.1,52515631,52519811,52515631,52519811,111128263,XM_022473798.1,barrier-to-autointegration factor-like,4180
NC_035788.1,63714865,63725823,63721203,63725823,111114834,XM_022453329.1,ADP-ribosylation factor-like,4620
NC_035783.1,52541016,52546169,52541018,52546160,111131486,XM_022479034.1,barrier-to-autointegration factor-like,5142
NC_035783.1,52541016,52546169,52541016,52546169,111131486,XM_022479036.1,barrier-to-autointegration factor-like,5153
NC_035786.1,29219704,29226140,29219704,29226140,111105588,XM_022439946.1,C1q-related factor-like,6436
NC_035783.1,7305614,7306534,7305614,7306534,111128462,XM_022474074.1,G-box-binding factor-like,920
NC_035780.1,17802381,17811835,17802381,17811835,111122616,XM_022464430.1,C1q-related factor-like,9454
NC_035781.1,51804775,51811232,51804775,51811232,111118459,XM_022457952.1,ADP-ribosylation factor-related protein 1-like,6457
NC_035780.1,219451,225076,219451,225076,111113860,XM_022452155.1,sulfotransferase family cytosolic 1B member 1-like,5625
NC_035780.1,38209799,38243110,38209799,38243110,111122940,XM_022464980.1,rho family-interacting cell polarization regulator 2-like,33311
NC_035784.1,43909001,43926485,43909001,43926485,111133378,XM_022481718.1,protein fantom-like,17484
NC_035783.1,40634197,40645486,40634197,40645486,111128154,XM_022473626.1,protein farnesyltransferase subunit beta-like,11289
NC_035784.1,88284299,88295065,88284299,88295065,111137241,XM_022488620.1,protein farnesyltransferase/geranylgeranyltransferase type-1 subunit alpha-like,10766
NC_035782.1,63069359,63076795,63069359,63076795,111125501,XM_022469404.1,long-chain fatty acid transport protein 1-like,7436
NC_035781.1,5161826,5164718,5161826,5164718,111118112,XM_022457426.1,protein fem-1 homolog CG6966-like,2892
NC_035781.1,43914166,43930790,43914166,43930790,111120485,XM_022461222.1,putative ferric-chelate reductase 1,16624
NC_035784.1,15185572,15186968,15185572,15186968,111138040,XM_022489817.1,soma ferritin-like,1396
NC_035786.1,56272661,56274099,56272661,56274099,111104407,XM_022438331.1,soma ferritin-like,1438
NC_035784.1,70403543,70408206,70403543,70408206,111133323,XM_022481588.1,yolk ferritin-like,4663
NC_035780.1,63490870,63492954,63490870,63492954,111103953,XM_022437609.1,lens fiber membrane intrinsic protein-like,2084
NC_035783.1,34871737,34882679,34871737,34882679,111128211,XM_022473711.1,acidic fibroblast growth factor intracellular-binding protein-like,10942
NC_035780.1,59034545,59040323,59034545,59040323,111126056,XM_022470450.1,malignant fibrous histiocytoma-amplified sequence 1 homolog,5778
NC_035786.1,29297825,29300428,29297825,29300428,111103317,XM_022436503.1,intermediate filament protein ifa-1-like,2603
NC_035780.1,3821736,3830259,3821736,3830259,111119020,XM_022458815.1,zinc finger protein 385B-like,8523
NC_035781.1,1569058,1573042,1569058,1573042,111119364,XM_022459453.1,PHD finger-like domain-containing protein 5A,3984
NC_035780.1,32301033,32306564,32301033,32306564,111128589,XM_022474298.1,mitochondrial fission factor-like,5531
NC_035781.1,23290814,23314585,23290814,23314585,111120598,XM_022461435.1,sperm flagellar protein 2-like,23771
NC_035781.1,13195913,13205964,13195914,13205964,111119088,XM_022458910.1,probable flavin-containing monoamine oxidase A,10050
NC_035781.1,47009209,47025687,47009209,47025687,111121108,XM_022462234.1,protein flightless-1 homolog,16478
NC_035783.1,48940623,48957522,48940623,48957522,111131151,XM_022478551.1,protein flp-like,16899
NC_035782.1,56535391,56554654,56535391,56554654,111123956,XM_022466704.1,protein flp-like,19263
NC_035782.1,57212485,57232029,57212485,57232029,111124895,XM_022468160.1,protein flp-like,19544
NC_035782.1,56535391,56554654,56535391,56542033,111123956,XM_022466705.1,protein flp-like,6642
NC_035783.1,53112376,53119556,53112376,53119556,111130464,XM_022477556.1,protein flp-like,7180
NC_035780.1,5739590,5745436,5739590,5745436,111103390,XM_022436636.1,mitochondrial folate transporter/carrier-like,5846
NC_035784.1,8309399,8321189,8309399,8321189,111136328,XM_022487095.1,required for meiotic nuclear division protein 1 homolog,11790
NC_035784.1,5580216,5597140,5580216,5593762,111133392,XM_022481747.1,kynurenine formamidase-like,13546
NC_035784.1,5580216,5597140,5580216,5593912,111133392,XM_022481749.1,kynurenine formamidase-like,13696
NC_035784.1,6425814,6446840,6425814,6440632,111133757,XM_022482395.1,kynurenine formamidase-like,14818
NC_035784.1,5580216,5597140,5580216,5597085,111133392,XM_022481748.1,kynurenine formamidase-like,16869
NC_035784.1,5580216,5597140,5580219,5597140,111133392,XM_022481746.1,kynurenine formamidase-like,16921
NC_035786.1,57065697,57082934,57065697,57082934,111102934,XM_022435889.1,kynurenine formamidase-like,17237
NC_035784.1,6425814,6446840,6425818,6446840,111133757,XM_022482396.1,kynurenine formamidase-like,21022
NC_035788.1,67608388,67633795,67608388,67633795,111113161,XM_022451180.1,kynurenine formamidase-like,25407
NC_035788.1,67695190,67699455,67695190,67699455,111115481,XM_022454239.1,kynurenine formamidase-like,4265
NC_035788.1,67536496,67541241,67536496,67541241,111111329,XM_022448232.1,kynurenine formamidase-like,4745
NC_035788.1,67659113,67663879,67659113,67663879,111115661,XM_022454484.1,kynurenine formamidase-like,4766
NC_035788.1,67672546,67678495,67672546,67678495,111110770,XM_022447383.1,kynurenine formamidase-like,5949
NC_035784.1,5599892,5600791,5599892,5600791,111136614,XM_022487590.1,kynurenine formamidase-like,899
NC_035784.1,6449446,6450425,6449446,6450425,111136717,XM_022487794.1,kynurenine formamidase-like,979
NC_035782.1,4814669,4825918,4814669,4825918,111125557,XM_022469489.1,inverted formin-2-like,11249
NC_035782.1,42948868,42970694,42958669,42970694,111126416,XM_022471050.1,inverted formin-2-like,12025
NC_035789.1,5189546,5203018,5189546,5203018,111117189,XM_022456266.1,inverted formin-2-like,13472
NC_035782.1,42948868,42970694,42953685,42970693,111126416,XM_022471047.1,inverted formin-2-like,17008
NC_035782.1,42948868,42970694,42952719,42970693,111126416,XM_022471048.1,inverted formin-2-like,17974
NC_035782.1,42948868,42970694,42952690,42970693,111126416,XM_022471049.1,inverted formin-2-like,18003
NC_035782.1,42948868,42970694,42948868,42970693,111126416,XM_022471046.1,inverted formin-2-like,21825
NC_035782.1,43960763,43996121,43970057,43996121,111125799,XM_022469934.1,inverted formin-2-like,26064
NC_035782.1,43960763,43996121,43965305,43996121,111125799,XM_022469932.1,inverted formin-2-like,30816
NC_035782.1,43960763,43996121,43964222,43996121,111125799,XM_022469933.1,inverted formin-2-like,31899
NC_035782.1,43960763,43996121,43960763,43996121,111125799,XM_022469930.1,inverted formin-2-like,35358
NC_035789.1,5148054,5157990,5148054,5157990,111117188,XM_022456265.1,inverted formin-2-like,9936
NC_035788.1,30247271,30254450,30247271,30254450,111112960,XM_022450853.1,methionyl-tRNA formyltransferase,7179
NC_035788.1,36908666,36917359,36908682,36917359,111115204,XM_022453861.1,methionyl-tRNA formyltransferase,8677
NC_035788.1,36908666,36917359,36908666,36917359,111115204,XM_022453860.1,methionyl-tRNA formyltransferase,8693
NC_035784.1,9231490,9236203,9231490,9236203,111132078,XM_022479729.1,WAP four-disulfide core domain protein 1-like,4713
NC_035784.1,70365667,70374193,70365667,70374193,111137215,XM_022488578.1,nuclear fragile X mental retardation-interacting protein 1-like,8526
NC_035784.1,19611353,19621765,19611353,19621765,111137968,XM_022489699.1,DNA fragmentation factor subunit beta-like,10412
NC_035780.1,55338575,55344493,55338575,55344493,111118000,XM_022457268.1,secreted frizzled-related protein 3-like,5918
NC_035782.1,28912262,28983137,28912262,28983137,111125534,XM_022469452.1,triple functional domain protein-like,70875
NC_035789.1,6633165,6641004,6633165,6641004,111117714,XM_022456884.1,putative fungistatic metabolite,7839
NC_035782.1,55249372,55287577,55249372,55287577,111126608,XM_022471365.1,protein furry-like,38205
NC_035781.1,5489256,5490430,5489256,5490430,111121581,XM_022462919.1,pentraxin fusion protein-like,1174
NC_035780.1,44347172,44360145,44347172,44360145,111120590,XM_022461407.1,protein fuzzy homolog,12973
NC_035782.1,69981541,69991816,69981541,69991816,111125659,XM_022469680.1,procollagen galactosyltransferase 1-like,10275
NC_035785.1,3959949,4049091,3959949,4049091,111101424,XM_022433912.1,dynein gamma chain,89142
NC_035788.1,54891058,54898661,54891058,54898661,111115784,XM_022454627.1,tubulin gamma-1 chain,7603
NC_035782.1,41700132,41712206,41700132,41712206,111126800,XM_022471674.1,protocadherin gamma-B1-like,12074
NC_035782.1,40997463,41041345,40997463,41008652,111125407,XM_022469189.1,protocadherin gamma-B4-like,11189
NC_035782.1,40997463,41041345,40997463,41009833,111125407,XM_022469190.1,protocadherin gamma-B4-like,12370
NC_035782.1,40997463,41041345,40997463,41012536,111125407,XM_022469192.1,protocadherin gamma-B4-like,15073
NC_035782.1,40997463,41041345,40997463,41018974,111125407,XM_022469187.1,protocadherin gamma-B4-like,21511
NC_035782.1,40997463,41041345,40997463,41020711,111125407,XM_022469185.1,protocadherin gamma-B4-like,23248
NC_035782.1,40997463,41041345,40997463,41033544,111125407,XM_022469188.1,protocadherin gamma-B4-like,36081
NC_035782.1,40997463,41041345,40997463,41041345,111125407,XM_022469186.1,protocadherin gamma-B4-like,43882
NC_035782.1,41352645,41364025,41352645,41364025,111125406,XM_022469181.1,protocadherin gamma-B7-like,11380
NC_035786.1,19221034,19239705,19221034,19237252,111104078,XM_022437810.1,protocadherin gamma-B7-like,16218
NC_035786.1,19221034,19239705,19221034,19239705,111104078,XM_022437811.1,protocadherin gamma-B7-like,18671
NC_035782.1,41352645,41364025,41352645,41359380,111125406,XM_022469183.1,protocadherin gamma-B7-like,6735
NC_035782.1,41352645,41364025,41352645,41359397,111125406,XM_022469184.1,protocadherin gamma-B7-like,6752
NC_035782.1,41352645,41364025,41352645,41359680,111125406,XM_022469179.1,protocadherin gamma-B7-like,7035
NC_035782.1,41352645,41364025,41352645,41361220,111125406,XM_022469182.1,protocadherin gamma-B7-like,8575
NC_035783.1,14931470,14950302,14931470,14950302,111130742,XM_022477962.1,probable gamma-butyrobetaine dioxygenase,18832
NC_035780.1,27813411,27816838,27813411,27816838,111124723,XM_022467868.1,putative gamma-glutamylcyclotransferase CG2811,3427
NC_035781.1,25909812,25928892,25909812,25928892,111122278,XM_022463930.1,putative gamma-glutamyltransferase YwrD,19080
NC_035784.1,15165516,15182515,15167290,15182515,111134684,XM_022483949.1,synergin gamma-like,15225
NC_035784.1,15165516,15182515,15165516,15182515,111134684,XM_022483952.1,synergin gamma-like,16999
NC_035781.1,40545618,40552664,40545618,40552664,111122141,XM_022463726.1,cystathionine gamma-lyase-like,7046
NC_035784.1,21531159,21539804,21531159,21539804,111132244,XM_022480034.1,L-methionine gamma-lyase-like,8645
NC_035784.1,23192743,23204394,23192743,23204394,111137399,XM_022488846.1,twisted gastrulation protein homolog 1-B-like,11651
NC_035780.1,32543945,32545527,32543945,32545527,111128487,XM_022474102.1,macrophage-expressed gene 1 protein-like,1582
NC_035785.1,19342644,19367129,19342644,19367129,111101230,XM_022433651.1,calcitonin gene-related peptide type 1 receptor-like,24485
NC_035783.1,16870761,16899679,16870761,16899679,111131327,XM_022478801.1,mitochondrial genome maintenance exonuclease 1-like,28918
NC_035781.1,22898163,22915582,22898163,22915582,111120512,XM_022461273.1,lethal(2) giant larvae protein homolog 1-like,17419
NC_035783.1,10023790,10035701,10023790,10035701,111131271,XM_022478712.1,protein giant-like,11911
NC_035783.1,10103830,10115778,10103830,10115778,111131017,XM_022478338.1,protein giant-like,11948
NC_035784.1,2813963,2815676,2813963,2815676,111137505,XM_022488973.1,protein giant-like,1713
NC_035783.1,10103830,10115778,10103830,10107623,111131017,XM_022478337.1,protein giant-like,3793
NC_035783.1,10023790,10035701,10023790,10027595,111131271,XM_022478711.1,protein giant-like,3805
NC_035783.1,10023790,10035701,10023790,10028038,111131271,XM_022478713.1,protein giant-like,4248
NC_035783.1,10103830,10115778,10103830,10108079,111131017,XM_022478339.1,protein giant-like,4249
NC_035784.1,28333527,28334959,28333527,28334959,111099173,XM_022430583.1,submaxillary gland androgen-regulated protein 3B-like,1432
NC_035784.1,69008314,69011499,69008314,69011499,111132552,XM_022480375.1,protein glass-like,3185
NC_035781.1,602693,618781,602693,618781,111119597,XM_022459927.1,probable global transcription activator SNF2L2,16088
NC_035783.1,21962373,21966867,21962373,21966867,111127779,XM_022473023.1,ADP-dependent glucokinase-like,4494
NC_035783.1,33733353,33737861,33733353,33737861,111130458,XM_022477543.1,ADP-dependent glucokinase-like,4508
NC_035783.1,27038982,27041910,27038982,27041910,111128802,XM_022474664.1,probable gluconokinase,2928
NC_035783.1,26363208,26366474,26363208,26366474,111129363,XM_022475701.1,probable gluconokinase,3266
NC_035780.1,44011671,44017434,44011671,44017434,111111370,XM_022448320.1,probable glucosamine 6-phosphate N-acetyltransferase,5763
NC_035784.1,4530331,4533458,4530331,4533458,111133528,XM_022481997.1,sodium-dependent glucose transporter 1B-like,3127
NC_035783.1,36439332,36446521,36439332,36446521,111128311,XM_022473871.1,putative glucose-6-phosphate 1-epimerase,7189
NC_035784.1,72763671,72766785,72763671,72766785,111137033,XM_022488261.1,mannosyl-oligosaccharide glucosidase-like,3114
NC_035783.1,17387810,17392697,17387810,17392697,111129258,XM_022475527.1,protein-glucosylgalactosylhydroxylysine glucosidase-like,4887
NC_035783.1,15575361,15582508,15575361,15582508,111131461,XM_022479002.1,protein-glucosylgalactosylhydroxylysine glucosidase-like,7147
NC_035783.1,15582688,15590232,15582688,15590232,111131462,XM_022479003.1,protein-glucosylgalactosylhydroxylysine glucosidase-like,7544
NC_035783.1,56668692,56695653,56668692,56695653,111129077,XM_022475159.1,non-lysosomal glucosylceramidase-like,26961
NC_035785.1,37599388,37630716,37599388,37630716,111102146,XM_022434795.1,UDP-glucose:glycoprotein glucosyltransferase 1-like,31328
NC_035784.1,18983408,18993900,18983408,18993900,111135173,XM_022484998.1,ceramide glucosyltransferase-like,10492
NC_035783.1,6596748,6616805,6597543,6609240,111131692,XM_022479334.1,ceramide glucosyltransferase-like,11697
NC_035783.1,4479470,4500966,4487060,4500966,111130733,XM_022477946.1,ceramide glucosyltransferase-like,13906
NC_035783.1,6596748,6616805,6597543,6611497,111131692,XM_022479333.1,ceramide glucosyltransferase-like,13954
NC_035783.1,4479470,4500966,4484869,4500966,111130733,XM_022477947.1,ceramide glucosyltransferase-like,16097
NC_035783.1,6596748,6616805,6597543,6616486,111131692,XM_022479332.1,ceramide glucosyltransferase-like,18943
NC_035783.1,6596748,6616805,6596748,6616805,111131692,XM_022479331.1,ceramide glucosyltransferase-like,20057
NC_035783.1,4479470,4500966,4479770,4500966,111130733,XM_022477945.1,ceramide glucosyltransferase-like,21196
NC_035783.1,4479470,4500966,4479470,4500966,111130733,XM_022477944.1,ceramide glucosyltransferase-like,21496
NC_035780.1,4014035,4018721,4014035,4018721,111119709,XM_022460143.1,salivary glue protein Sgs-3-like,4686
NC_035780.1,42753974,42797529,42753974,42797529,111111362,XM_022448308.1,vesicular glutamate transporter 1-like,43555
NC_035785.1,33555221,33561989,33555221,33561989,111099857,XM_022431329.1,probable glutamate--tRNA ligase,6768
NC_035784.1,38053817,38056166,38053817,38056166,111132853,XM_022480742.1,PAXIP1-associated glutamate-rich protein 1-like,2349
NC_035783.1,25954233,25977997,25954233,25977997,111130105,XM_022476804.1,bifunctional glutamate/proline--tRNA ligase-like,23764
NC_035781.1,4515892,4523307,4515892,4523307,111120016,XM_022460635.1,small glutamine-rich tetratricopeptide repeat-containing protein beta-like,7415
NC_035781.1,55319951,55322255,55319951,55322255,111121161,XM_022462310.1,microsomal glutathione S-transferase 1-like,2304
NC_035783.1,29075612,29078662,29075612,29078662,111129425,XM_022475800.1,putative glutathione-specific gamma-glutamylcyclotransferase 2,3050
NC_035784.1,43650021,43658488,43650021,43657230,111136469,XM_022487342.1,phosphatidylinositol glycan anchor biosynthesis class U protein-like,7209
NC_035785.1,31555544,31567404,31555544,31567404,111100599,XM_022432653.1,putative glycerol kinase 5,11860
NC_035785.1,33079535,33084114,33079535,33084114,111100902,XM_022433072.1,poly(ADP-ribose) glycohydrolase ARH3-like,4579
NC_035781.1,52827200,52843155,52827207,52839130,111119358,XM_022459434.1,poly(ADP-ribose) glycohydrolase-like,11923
NC_035781.1,52827200,52843155,52827207,52839894,111119358,XM_022459433.1,poly(ADP-ribose) glycohydrolase-like,12687
NC_035781.1,52827200,52843155,52827232,52843155,111119358,XM_022459431.1,poly(ADP-ribose) glycohydrolase-like,15923
NC_035781.1,52827200,52843155,52827207,52843155,111119358,XM_022459430.1,poly(ADP-ribose) glycohydrolase-like,15948
NC_035781.1,52827200,52843155,52827200,52843155,111119358,XM_022459432.1,poly(ADP-ribose) glycohydrolase-like,15955
NC_035780.1,8761499,8763551,8761499,8763551,111132259,XM_022480054.1,microfibril-associated glycoprotein 4-like,2052
NC_035786.1,33789490,33792130,33789490,33792126,111104786,XM_022438918.1,histidine-rich glycoprotein-like,2636
NC_035786.1,33789490,33792130,33789490,33792130,111104786,XM_022438919.1,histidine-rich glycoprotein-like,2640
NC_035782.1,22307767,22308723,22307767,22308723,111124115,XM_022466979.1,histidine-rich glycoprotein-like,956
NC_035784.1,80210096,80220761,80210096,80220761,111133661,XM_022482198.1,uracil-DNA glycosylase-like,10665
NC_035788.1,90428369,90440296,90428369,90440296,111114668,XM_022453078.1,uracil-DNA glycosylase-like,11927
NC_035788.1,90428369,90440296,90435780,90440296,111114668,XM_022453077.1,uracil-DNA glycosylase-like,4516
NC_035780.1,8044163,8051650,8044163,8051650,111137420,XM_022488875.1,dolichyl-diphosphooligosaccharide--protein glycosyltransferase subunit STT3A-like,7487
NC_035781.1,10776423,10787637,10776425,10787637,111119894,XM_022460465.1,glutathione-independent glyoxalase HSP31-like,11212
NC_035782.1,33103190,33112494,33103190,33107788,111123221,XM_022465411.1,RAB6-interacting golgin-like,4598
NC_035782.1,33103190,33112494,33103190,33107924,111123221,XM_022465410.1,RAB6-interacting golgin-like,4734
NC_035782.1,33103190,33112494,33103190,33112494,111123221,XM_022465408.1,RAB6-interacting golgin-like,9304
NC_035783.1,39293746,39326852,39293746,39304578,111130460,XM_022477544.1,protein grainyhead-like,10832
NC_035783.1,39293746,39326852,39293746,39305172,111130460,XM_022477545.1,protein grainyhead-like,11426
NC_035781.1,35022776,35057503,35022776,35034278,111120743,XM_022461676.1,protein grainyhead-like,11502
NC_035783.1,39293746,39326852,39293746,39310407,111130460,XM_022477549.1,protein grainyhead-like,16661
NC_035781.1,35022776,35057503,35022777,35039559,111120743,XM_022461680.1,protein grainyhead-like,16782
NC_035781.1,35022776,35057503,35022777,35042159,111120743,XM_022461678.1,protein grainyhead-like,19382
NC_035783.1,39293746,39326852,39293746,39313258,111130460,XM_022477546.1,protein grainyhead-like,19512
NC_035783.1,39293746,39326852,39293746,39326852,111130460,XM_022477547.1,protein grainyhead-like,33106
NC_035781.1,35022776,35057503,35022777,35057503,111120743,XM_022461679.1,protein grainyhead-like,34726
NC_035780.1,873286,876502,873286,876502,111104259,XM_022438108.1,trithorax group protein osa-like,3216
NC_035780.1,7077445,7102942,7077445,7102942,111125887,XM_022470111.1,opioid growth factor receptor-like protein 1,25497
NC_035784.1,75697806,75704997,75697807,75704997,111133335,XM_022481634.1,cell growth-regulating nucleolar protein-like,7190
NC_035780.1,10410134,10453000,10410134,10453000,111108095,XM_022443698.1,secretion-regulating guanine nucleotide exchange factor-like,42866
NC_035783.1,44258441,44292520,44258441,44292520,111129997,XM_022476576.1,ras guanyl-releasing protein 3-like,34079
NC_035780.1,8752736,8768743,8752736,8768741,111132223,XM_022480015.1,soluble guanylate cyclase 88E-like,16005
NC_035782.1,22739823,22753554,22739823,22753554,111124900,XM_022468169.1,mannose-1-phosphate guanyltransferase alpha-A-like,13731
NC_035784.1,70617150,70645932,70617150,70645932,111132202,XM_022479980.1,retinal guanylyl cyclase 2-like,28782
NC_035782.1,63422279,63427366,63422279,63427365,111127223,XM_022472309.1,fucose-1-phosphate guanylyltransferase-like,5086
NC_035782.1,63422279,63427366,63422279,63427366,111127223,XM_022472310.1,fucose-1-phosphate guanylyltransferase-like,5087
NC_035780.1,44413882,44423312,44413882,44423312,111119573,XM_022459900.1,testicular haploid expressed gene protein-like,9430
NC_035783.1,32635350,32637033,32635350,32637033,111130954,XM_022478260.1,fork head domain-containing protein FD4-like,1683
NC_035781.1,13373636,13380930,13373636,13380930,111121200,XM_022462358.1,calcium-regulated heat stable protein 1-like,7294
NC_035784.1,2668491,2717065,2668491,2717065,111134514,XM_022483616.1,maestro heat-like repeat-containing protein family member 1,48574
NC_035780.1,17682628,17684915,17682628,17684915,111103862,XM_022437423.1,myosin-2 heavy chain,2287
NC_035780.1,33560870,33616353,33560870,33616353,111134017,XM_022482792.1,sonic hedgehog protein-like,55483
NC_035780.1,47363079,47377019,47363079,47377019,111123065,XM_022465158.1,DNA helicase MCM8-like,13940
NC_035782.1,46463158,46481635,46463158,46481635,111125248,XM_022468835.1,lymphocyte-specific helicase-like,18477
NC_035784.1,44494015,44543924,44501332,44543924,111132030,XM_022479662.1,lymphoid-specific helicase-like,42592
NC_035784.1,44494015,44543924,44494015,44543924,111132030,XM_022479663.1,lymphoid-specific helicase-like,49909
NC_035782.1,42678088,42683920,42678088,42683920,111126650,XM_022471436.1,basic helix-loop-helix transcription factor scleraxis-like,5832
NC_035783.1,34830494,34843697,34830494,34843697,111127918,XM_022473247.1,non-symbiotic hemoglobin 1-like,13203
NC_035786.1,56466405,56472301,56466405,56472301,111105201,XM_022439370.1,protein henna-like,5896
NC_035786.1,56448266,56457545,56448266,56457545,111103022,XM_022436019.1,protein henna-like,9279
NC_035781.1,7948746,7969899,7948746,7969899,111119817,XM_022460319.1,bifunctional heparan sulfate N-deacetylase/N-sulfotransferase 4-like,21153
NC_035781.1,30099310,30116007,30099310,30116007,111118818,XM_022458456.1,inositol hexakisphosphate kinase 1-like,16697
NC_035780.1,6525805,6532825,6525805,6532825,111128259,XM_022473796.1,cytadherence high molecular weight protein 2-like,7020
NC_035781.1,51829886,51836308,51829886,51836308,111122099,XM_022463657.1,minor histocompatibility antigen H13-like,6422
NC_035780.1,7386723,7414898,7386723,7414898,111123891,XM_022466548.1,lysine-specific histone demethylase 1B-like,28175
NC_035782.1,27125593,27176337,27125593,27176337,111123265,XM_022465504.1,probable histone-lysine N-methyltransferase PRDM7,50744
NC_035780.1,8024566,8035529,8024566,8035529,111103508,XM_022436831.1,ALX homeobox protein 1-like,10963
NC_035780.1,20853720,20871764,20853720,20871764,111126972,XM_022471951.1,putative homeodomain transcription factor 2,18044
NC_035781.1,13798229,13837496,13798229,13837496,111118013,XM_022457281.1,calcium homeostasis endoplasmic reticulum protein-like,39267
NC_035780.1,28743633,28757413,28743633,28757413,111113188,XM_022451280.1,dnaJ homolog subfamily C member 25 homolog,13780
NC_035783.1,17346347,17347410,17346347,17347410,111130881,XM_022478149.1,cdc42 homolog,1063
NC_035782.1,36065186,36075847,36065189,36075845,111126413,XM_022471041.1,ataxin-2 homolog,10656
NC_035782.1,36065186,36075847,36065186,36075847,111126413,XM_022471043.1,ataxin-2 homolog,10661
NC_035783.1,17327878,17328945,17327878,17328945,111130430,XM_022477502.1,cdc42 homolog,1067
NC_035784.1,33014042,33024809,33014042,33024809,111135561,XM_022485722.1,anamorsin homolog,10767
NC_035787.1,51537068,51547974,51537191,51547974,111107118,XM_022442115.1,neurocalcin homolog,10783
NC_035780.1,50694048,50802720,50694048,50802720,111133629,XM_022482447.1,peroxidasin homolog,108672
NC_035783.1,17365918,17367007,17365918,17367007,111130620,XM_022477786.1,cdc42 homolog,1089
NC_035787.1,51537068,51547974,51537068,51547974,111107118,XM_022442116.1,neurocalcin homolog,10906
NC_035784.1,33607574,33618634,33607574,33618634,111135616,XM_022485840.1,anamorsin homolog,11060
NC_035783.1,17313231,17314487,17313231,17314487,111130659,XM_022477837.1,cdc42 homolog,1256
NC_035780.1,48716718,48729673,48716718,48729673,111125135,XM_022468638.1,peroxidasin homolog,12955
NC_035789.1,14292830,14294263,14292830,14294263,111116345,XM_022455329.1,titin homolog,1433
NC_035781.1,4468574,4470072,4468574,4470072,111122341,XM_022464066.1,neurocalcin homolog,1498
NC_035784.1,4483157,4484901,4483157,4484901,111135052,XM_022484751.1,neurocalcin homolog,1744
NC_035784.1,4847351,4849248,4847351,4849248,111136325,XM_022487089.1,neurocalcin homolog,1897
NC_035787.1,50086072,50087998,50086072,50087998,111110211,XM_022446607.1,neurocalcin homolog,1926
NC_035780.1,50694048,50802720,50783359,50802720,111133629,XM_022482360.1,peroxidasin homolog,19361
NC_035787.1,52923151,52925341,52923151,52925341,111106497,XM_022441201.1,cystinosin homolog,2190
NC_035781.1,4658290,4691112,4668997,4691112,111119732,XM_022460179.1,neurocalcin homolog,22115
NC_035781.1,4658290,4691112,4668228,4691112,111119732,XM_022460177.1,neurocalcin homolog,22884
NC_035781.1,4658290,4691112,4666189,4691112,111119732,XM_022460178.1,neurocalcin homolog,24923
NC_035786.1,42328902,42331460,42328902,42331460,111105529,XM_022439876.1,IST1 homolog,2558
NC_035783.1,27773536,27800371,27773536,27800371,111129585,XM_022476040.1,titin homolog,26835
NC_035783.1,31965798,31968656,31965798,31968656,111128538,XM_022474194.1,DET1 homolog,2858
NC_035782.1,36451033,36511644,36482132,36511643,111124002,XM_022466840.1,titin homolog,29511
NC_035781.1,4658290,4691112,4661499,4691112,111119732,XM_022460175.1,neurocalcin homolog,29613
NC_035782.1,19775983,19778973,19775983,19778973,111124092,XM_022466956.1,cubilin homolog,2990
NC_035782.1,37380902,37437918,37407341,37437916,111124650,XM_022467727.1,titin homolog,30575
NC_035780.1,50694048,50802720,50772081,50802720,111133629,XM_022482185.1,peroxidasin homolog,30639
NC_035780.1,50694048,50802720,50771541,50802720,111133629,XM_022482280.1,peroxidasin homolog,31179
NC_035783.1,32280440,32283578,32280440,32283578,111128539,XM_022474195.1,DET1 homolog,3138
NC_035781.1,4658290,4691112,4658290,4691112,111119732,XM_022460176.1,neurocalcin homolog,32822
NC_035784.1,40071679,40075141,40071679,40075141,111134146,XM_022482980.1,cdc42 homolog,3462
NC_035780.1,50550117,50587524,50552562,50587524,111110109,XM_022446480.1,peroxidasin homolog,34962
NC_035783.1,53199342,53202969,53199342,53202969,111128186,XM_022473671.1,cdc42 homolog,3627
NC_035780.1,48824523,48861770,48824523,48861770,111125121,XM_022468608.1,peroxidasin homolog,37247
NC_035780.1,50550117,50587524,50550117,50587524,111110109,XM_022446473.1,peroxidasin homolog,37407
NC_035781.1,4658290,4691112,4687304,4691112,111119732,XM_022460180.1,neurocalcin homolog,3808
NC_035786.1,33866892,33871071,33866892,33871071,111105314,XM_022439533.1,lambda-crystallin homolog,4179
NC_035780.1,48761298,48806276,48763794,48806276,111125102,XM_022468586.1,peroxidasin homolog,42482
NC_035786.1,57110976,57153659,57110976,57153659,111103866,XM_022437425.1,titin homolog,42683
NC_035780.1,48761298,48806276,48761298,48806276,111125102,XM_022468578.1,peroxidasin homolog,44978
NC_035787.1,47582450,47636561,47586743,47636561,111108271,XM_022444042.1,titin homolog,49818
NC_035783.1,13232411,13237529,13232411,13237529,111130934,XM_022478224.1,cdc42 homolog,5118
NC_035787.1,47582450,47636561,47582450,47636561,111108271,XM_022444041.1,titin homolog,54111
NC_035782.1,36451033,36511644,36455595,36511644,111124002,XM_022466830.1,titin homolog,56049
NC_035782.1,37380902,37437918,37380903,37437917,111124650,XM_022467725.1,titin homolog,57014
NC_035782.1,37380902,37437918,37380902,37437918,111124650,XM_022467719.1,titin homolog,57016
NC_035782.1,36451033,36511644,36451036,36511643,111124002,XM_022466838.1,titin homolog,60607
NC_035782.1,36451033,36511644,36451034,36511643,111124002,XM_022466837.1,titin homolog,60609
NC_035782.1,36451033,36511644,36451034,36511644,111124002,XM_022466829.1,titin homolog,60610
NC_035782.1,36451033,36511644,36451033,36511644,111124002,XM_022466833.1,titin homolog,60611
NC_035784.1,32650173,32657389,32650173,32657389,111136744,XM_022487836.1,cornifelin homolog,7216
NC_035781.1,20544657,20552513,20544657,20552513,111118917,XM_022458630.1,titin homolog,7856
NC_035784.1,32679220,32687230,32679220,32687230,111133849,XM_022482546.1,cornifelin homolog,8010
NC_035780.1,54885906,54893942,54885914,54893939,111111136,XM_022447953.1,titin homolog,8025
NC_035780.1,54885906,54893942,54885913,54893940,111111136,XM_022447970.1,titin homolog,8027
NC_035780.1,54885906,54893942,54885908,54893941,111111136,XM_022447946.1,titin homolog,8033
NC_035780.1,54885906,54893942,54885906,54893942,111111136,XM_022447961.1,titin homolog,8036
NC_035780.1,54126897,54135045,54126897,54135045,111110360,XM_022446838.1,smoothened homolog,8148
NC_035787.1,51537068,51547974,51539560,51547974,111107118,XM_022442117.1,neurocalcin homolog,8414
NC_035782.1,50236622,50245098,50236622,50245098,111124615,XM_022467642.1,BUD13 homolog,8476
NC_035783.1,19079200,19087879,19079200,19087836,111131690,XM_022479328.1,ESF1 homolog,8636
NC_035783.1,19079200,19087879,19079200,19087879,111131690,XM_022479327.1,ESF1 homolog,8679
NC_035784.1,38133310,38142461,38133310,38142451,111134439,XM_022483445.1,lissencephaly-1 homolog,9141
NC_035784.1,38133310,38142461,38133310,38142461,111134439,XM_022483446.1,lissencephaly-1 homolog,9151
NC_035787.1,51537068,51547974,51538585,51547974,111107118,XM_022442114.1,neurocalcin homolog,9389
NC_035784.1,33607574,33618634,33607574,33617102,111135616,XM_022485841.1,anamorsin homolog,9528
NC_035783.1,17383800,17384774,17383800,17384774,111131081,XM_022478428.1,cdc42 homolog,974
NC_035780.1,23946020,23950917,23946020,23950917,111130484,XM_022477606.1,ETS homologous factor-like,4897
NC_035780.1,6388510,6406759,6388510,6406759,111134598,XM_022483767.1,pleckstrin homology domain-containing family F member 2-like,18249
NC_035782.1,43532828,43595954,43532828,43595953,111123648,XM_022466115.1,pleckstrin homology-like domain family B member 2,63125
NC_035780.1,1848220,1849477,1848220,1849477,111115024,XM_022453603.1,growth hormone secretagogue receptor type 1-like,1257
NC_035781.1,2534440,2538278,2534440,2538278,111120766,XM_022461726.1,growth hormone-inducible transmembrane protein-like,3838
NC_035781.1,20079208,20081370,20079208,20081370,111122224,XM_022463864.1,prepro-gonadotropin-releasing hormone-like protein,2162
NC_035784.1,91294064,91307485,91294064,91307485,111135523,XM_022485671.1,growth hormone-regulated TBC protein 1-A-like,13421
NC_035780.1,47132326,47160838,47132326,47160838,111113027,XM_022450960.1,parathyroid hormone/parathyroid hormone-related peptide receptor-like,28512
NC_035785.1,36230415,36270023,36230415,36270023,111101036,XM_022433272.1,protein hu-li tai shao-like,39608
NC_035780.1,52931441,52934275,52931441,52934275,111107994,XM_022443467.1,protein hunchback-like,2834
NC_035780.1,36105719,36111285,36105719,36111285,111103072,XM_022436078.1,enoyl-CoA hydratase domain-containing protein 3,5566
NC_035783.1,45608688,45628581,45608688,45628581,111130667,XM_022477846.1,fumarate hydratase,19893
NC_035781.1,7391965,7397121,7391965,7397121,111120704,XM_022461629.1,enoyl-CoA hydratase,5156
NC_035787.1,56522661,56530833,56523182,56530833,111105879,XM_022440336.1,methylglutaconyl-CoA hydratase,7651
NC_035787.1,56522661,56530833,56522661,56530833,111105879,XM_022440335.1,methylglutaconyl-CoA hydratase,8172
NC_035781.1,2190639,2199508,2190639,2199508,111121719,XM_022463107.1,aconitate hydratase,8869
NC_035781.1,1692048,1701794,1692048,1701794,111121721,XM_022463109.1,aconitate hydratase,9746
NC_035787.1,23980656,23993865,23980656,23993865,111108448,XM_022444346.1,urocanate hydratase-like,13209
NC_035787.1,25852584,25868985,25852584,25868985,111109637,XM_022445842.1,urocanate hydratase-like,16401
NC_035782.1,25547144,25564887,25547144,25564887,111123365,XM_022465652.1,aryl hydrocarbon receptor nuclear translocator-like protein 1,17743
NC_035780.1,19313926,19320596,19313926,19318824,111136839,XM_022487977.1,voltage-gated hydrogen channel 1-like,4898
NC_035780.1,55063833,55072147,55063833,55072147,111123684,XM_022466190.1,putative hydrolase RBBP9,8314
NC_035780.1,11506776,11511377,11506936,11511377,111118132,XM_022457453.1,3-hydroxyisobutyryl-CoA hydrolase,4441
NC_035780.1,11506776,11511377,11506776,11511377,111118132,XM_022457461.1,3-hydroxyisobutyryl-CoA hydrolase,4601
NC_035780.1,10739576,10744853,10739576,10744702,111116870,XM_022455928.1,3-hydroxyisobutyryl-CoA hydrolase,5126
NC_035780.1,10739576,10744853,10739576,10744733,111116870,XM_022455910.1,3-hydroxyisobutyryl-CoA hydrolase,5157
NC_035780.1,10739576,10744853,10739576,10744853,111116870,XM_022455919.1,3-hydroxyisobutyryl-CoA hydrolase,5277
NC_035788.1,75588290,75595546,75588697,75595546,111113116,XM_022451101.1,hydroxyacylglutathione hydrolase,6849
NC_035788.1,75588290,75595546,75588681,75595546,111113116,XM_022451102.1,hydroxyacylglutathione hydrolase,6865
NC_035788.1,75588290,75595546,75588290,75595546,111113116,XM_022451100.1,hydroxyacylglutathione hydrolase,7256
NC_035787.1,35455805,35488449,35455805,35488449,111107029,XM_022441966.1,S-adenosylhomocysteine hydrolase-like protein 1,32644
NC_035784.1,61770128,61781548,61770128,61781548,111136681,XM_022487719.1,S-formylglutathione hydrolase-like,11420
NC_035784.1,20946769,20958801,20946769,20958801,111135928,XM_022486414.1,acyloxyacyl hydrolase-like,12032
NC_035782.1,41851049,41865159,41851063,41865159,111124868,XM_022468109.1,5-hydroxyisourate hydrolase-like,14096
NC_035782.1,41851049,41865159,41851049,41865157,111124868,XM_022468113.1,5-hydroxyisourate hydrolase-like,14108
NC_035784.1,26784993,26800712,26784993,26800712,111133596,XM_022482105.1,bleomycin hydrolase-like,15719
NC_035784.1,26422699,26442552,26422699,26442552,111099156,XM_022430545.1,bleomycin hydrolase-like,19853
NC_035782.1,62014050,62034846,62014050,62034846,111124008,XM_022466849.1,phosphonoacetaldehyde hydrolase-like,20796
NC_035784.1,40779043,40800052,40779043,40800052,111136395,XM_022487214.1,lactase-phlorizin hydrolase-like,21009
NC_035784.1,40776813,40779000,40776813,40779000,111132365,XM_022480169.1,lactase-phlorizin hydrolase-like,2187
NC_035782.1,41851049,41865159,41862183,41865152,111124868,XM_022468110.1,5-hydroxyisourate hydrolase-like,2969
NC_035784.1,20925192,20930390,20925192,20930390,111135929,XM_022486415.1,acyloxyacyl hydrolase-like,5198
NC_035783.1,48923437,48929651,48923437,48929266,111128057,XM_022473458.1,gamma-glutamyl hydrolase-like,5829
NC_035783.1,48923437,48929651,48923437,48929325,111128057,XM_022473457.1,gamma-glutamyl hydrolase-like,5888
NC_035783.1,24891623,24897619,24891623,24897619,111131610,XM_022479221.1,m7GpppN-mRNA hydrolase-like,5996
NC_035783.1,48923437,48929651,48923437,48929651,111128057,XM_022473456.1,gamma-glutamyl hydrolase-like,6214
NC_035784.1,40770531,40776753,40770531,40776753,111136394,XM_022487213.1,lactase-phlorizin hydrolase-like,6222
NC_035784.1,2766970,2774700,2767156,2774700,111137256,XM_022488646.1,valacyclovir hydrolase-like,7544
NC_035784.1,2766970,2774700,2766983,2774700,111137256,XM_022488645.1,valacyclovir hydrolase-like,7717
NC_035784.1,2766970,2774700,2766970,2774700,111137256,XM_022488644.1,valacyclovir hydrolase-like,7730
NC_035782.1,41851049,41865159,41856716,41865156,111124868,XM_022468111.1,5-hydroxyisourate hydrolase-like,8440
NC_035782.1,56385906,56391266,56385906,56391266,111124754,XM_022467917.1,cysteine-rich hydrophobic domain-containing protein 2-like,5360
NC_035781.1,2694444,2697453,2694444,2697453,111121226,XM_022462396.1,5-demethoxyubiquinone hydroxylase,3009
NC_035780.1,29266127,29270281,29266127,29270281,111124350,XM_022467203.1,phytanoyl-CoA hydroxylase-interacting protein-like,4154
NC_035781.1,23507357,23511046,23507357,23511046,111118381,XM_022457822.1,deoxyhypusine hydroxylase-like,3689
NC_035781.1,23926052,23931634,23926052,23931634,111119039,XM_022458847.1,deoxyhypusine hydroxylase-like,5582
NC_035781.1,49239796,49244353,49239796,49244353,111122125,XM_022463708.1,serine hydroxymethyltransferase,4557
NC_035781.1,48628840,48633676,48628840,48633676,111121920,XM_022463410.1,serine hydroxymethyltransferase,4836
NC_035780.1,8090370,8098992,8090370,8098992,111114229,XM_022452549.1,serine hydroxymethyltransferase,8622
NC_035783.1,26461198,26522292,26461198,26522292,111129269,XM_022475546.1,potassium/sodium hyperpolarization-activated cyclic nucleotide-gated channel 3-like,61094
NC_035787.1,48240184,48244290,48240184,48244290,111108524,XM_022444482.1,probable imidazolonepropionase,4106
NC_035784.1,40580653,40582666,40580653,40582666,111138364,XM_022490292.1,secretory immunoglobulin A-binding protein EsiB-like,2013
NC_035784.1,96563973,96580029,96563973,96580029,111134239,XM_022483118.1,basic immunoglobulin-like variable motif-containing protein,16056
NC_035784.1,33098011,33107608,33098011,33107608,111137461,XM_022488925.1,T-cell immunomodulatory protein-like,9597
NC_035781.1,38543282,38544791,38543282,38544791,111121610,XM_022462963.1,mitochondrial import inner membrane translocase subunit Tim29-like,1509
NC_035780.1,3211541,3232507,3211541,3232507,111105807,XM_022440491.1,hypermethylated in cancer 2 protein-like,20966
NC_035782.1,68610004,68610944,68610004,68610944,111124404,XM_022467256.1,probable inactive tRNA-specific adenosine deaminase-like protein 3,940
NC_035780.1,58160353,58169836,58160353,58169836,111135589,XM_022485794.1,serine incorporator 3-like,9483
NC_035780.1,3233170,3235688,3233170,3235688,111106831,XM_022441700.1,M-phase inducer phosphatase-like,2518
NC_035781.1,56935229,56941898,56935229,56941898,111119953,XM_022460544.1,mesoderm induction early response protein 1-like,6669
NC_035786.1,34659880,34664524,34659880,34664524,111102935,XM_022435890.1,allograft inflammatory factor 1-like,4644
NC_035784.1,52007698,52011859,52007698,52011859,111134037,XM_022482807.1,altered inheritance of mitochondria protein 3-like,4161
NC_035780.1,8679665,8683977,8679665,8683977,111109472,XM_022445638.1,proteasome inhibitor PI31 subunit-like,4312
NC_035784.1,26181278,26203653,26181278,26203653,111135002,XM_022484659.1,NF-kappa-B inhibitor-interacting Ras-like protein 1,22375
NC_035782.1,73606080,73610917,73606080,73610917,111125938,XM_022470199.1,NF-kappa-B inhibitor-like protein 1,4837
NC_035789.1,9133002,9135508,9133002,9135508,111117019,XM_022456079.1,protease inhibitors-like,2506
NC_035781.1,3137398,3138910,3137398,3138910,111118859,XM_022458543.1,vesicular inhibitory amino acid transporter-like,1512
NC_035780.1,10621038,10627178,10621038,10627178,111099614,XM_022430976.1,translation initiation factor eIF-2B subunit delta-like,6140
NC_035780.1,273173,278473,273173,278473,111101273,XM_022433714.1,mitochondrial inner membrane protein COX18-like,5300
NC_035781.1,56811565,56835995,56811565,56835995,111119955,XM_022460546.1,multiple inositol polyphosphate phosphatase 1-like,24430
NC_035781.1,5810942,5836786,5810942,5836786,111120139,XM_022460867.1,GPI inositol-deacylase-like,25844
NC_035788.1,62928944,62940464,62928944,62940464,111115720,XM_022454555.1,protein inscuteable homolog,11520
NC_035788.1,16946232,16962100,16946232,16962100,111113398,XM_022451646.1,selenocysteine insertion sequence-binding protein 2-like,15868
NC_035780.1,6852667,6856461,6852667,6856461,111130821,XM_022478066.1,probable insulin-like peptide 7,3794
NC_035782.1,52381126,52383325,52381126,52383325,111125981,XM_022470303.1,glucose-dependent insulinotropic receptor-like,2199
NC_035784.1,26414608,26420689,26414608,26420689,111138039,XM_022489815.1,small integral membrane protein 14-like,6081
NC_035784.1,62711452,62721073,62711452,62721073,111136639,XM_022487634.1,vesicular integral-membrane protein VIP36-like,9621
NC_035780.1,13801448,13829339,13801448,13829339,111137004,XM_022488229.1,bridging integrator 2-like,27891
NC_035788.1,82887759,82894717,82887759,82894717,111111360,XM_022448296.1,corepressor interacting with RBPJ 1-like,6958
NC_035782.1,15996448,16008942,15996448,16008942,111126543,XM_022471253.1,krev interaction trapped protein 1-like,12494
NC_035783.1,4926148,4948802,4926148,4948802,111130734,XM_022477948.1,AT-rich interactive domain-containing protein 3A-like,22654
NC_035780.1,57338440,57354103,57338440,57354103,111126450,XM_022471112.1,abl interactor 1-like,15663
NC_035783.1,3267975,3279363,3267975,3279363,111128907,XM_022474859.1,axin interactor,11388
NC_035784.1,61362944,61368757,61362944,61368757,111136099,XM_022486705.1,ATM interactor-like,5813
NC_035781.1,4318890,4320972,4318890,4320972,111120058,XM_022460705.1,transcription intermediary factor 1-beta-like,2082
NC_035781.1,17028720,17035550,17028720,17035550,111121989,XM_022463502.1,dynein intermediate chain 3,6830
NC_035784.1,36661554,36663830,36661554,36663830,111137041,XM_022488269.1,mitochondrial intermembrane space import and assembly protein 40-like,2276
NC_035788.1,54153459,54192553,54153459,54192553,111114455,XM_022452750.1,vasoactive intestinal polypeptide receptor 1-like,39094
NC_035781.1,15997737,16006294,15997737,16006294,111121469,XM_022462764.1,trimeric intracellular cation channel type 1B.1-like,8557
NC_035782.1,61031278,61045460,61034570,61045459,111126123,XM_022470535.1,protein inturned-like,10889
NC_035782.1,61031278,61045460,61031278,61045459,111126123,XM_022470534.1,protein inturned-like,14181
NC_035782.1,61031278,61045460,61031278,61045460,111126123,XM_022470533.1,protein inturned-like,14182
NC_035782.1,75248616,75262885,75248616,75262885,111124715,XM_022467841.1,protein inturned-like,14269
NC_035785.1,10364724,10379815,10364724,10379815,111100292,XM_022431999.1,T-lymphoma invasion and metastasis-inducing protein 1-like,15091
NC_035780.1,10549432,10554574,10549432,10554574,111100895,XM_022433061.1,acid-sensing ion channel 1-like,5142
NC_035781.1,47997788,48008190,47997788,48008190,111117976,XM_022457231.1,NFU1 iron-sulfur cluster scaffold homolog,10402
NC_035781.1,45940832,45953291,45940832,45953291,111117944,XM_022457185.1,peptidylprolyl isomerase domain and WD repeat-containing protein 1-like,12459
NC_035783.1,10374858,10389298,10374858,10389298,111129960,XM_022476520.1,maleylacetoacetate isomerase-like,14440
NC_035784.1,97219087,97234984,97219087,97234984,111133304,XM_022481573.1,mannose-6-phosphate isomerase-like,15897
NC_035784.1,98689045,98694167,98689045,98694167,111132797,XM_022480618.1,mannose-6-phosphate isomerase-like,5122
NC_035781.1,37456106,37461323,37456106,37461323,111118569,XM_022458105.1,xylose isomerase-like,5217
NC_035784.1,3683160,3688454,3683160,3688454,111132917,XM_022480853.1,triosephosphate isomerase-like,5294
NC_035784.1,97468323,97474669,97468323,97474669,111132784,XM_022480602.1,mannose-6-phosphate isomerase-like,6346
NC_035784.1,23426435,23433939,23426435,23433939,111136543,XM_022487462.1,glucose-6-phosphate isomerase-like,7504
NC_035784.1,23222304,23229938,23222304,23229938,111137391,XM_022488835.1,glucose-6-phosphate isomerase-like,7634
NC_035781.1,50460804,50468522,50460804,50468522,111118323,XM_022457728.1,methylthioribose-1-phosphate isomerase-like,7718
NC_035783.1,10392307,10400233,10392307,10400233,111129959,XM_022476519.1,maleylacetoacetate isomerase-like,7926
NC_035782.1,37908877,37917813,37908877,37917813,111124565,XM_022467527.1,ribose-5-phosphate isomerase-like,8936
NC_035786.1,51249930,51252317,51249930,51252317,111102792,XM_022435662.1,carotenoid isomerooxygenase-like,2387
NC_035780.1,9457293,9462855,9457293,9462855,111128808,XM_022474684.1,SUMO-specific isopeptidase USPL1-like,5562
NC_035781.1,1705023,1711879,1705023,1711879,111121734,XM_022463124.1,probable isoprenylcysteine alpha-carbonyl methylesterase ICME,6856
NC_035788.1,42465677,42478466,42465677,42478466,111110956,XM_022447638.1,protein jagged-1-like,12789
NC_035789.1,25411287,25442785,25411287,25424956,111117638,XM_022456795.1,protein jagged-1-like,13669
NC_035789.1,25411287,25442785,25411287,25442785,111117638,XM_022456794.1,protein jagged-1-like,31498
NC_035787.1,3171801,3175552,3171801,3175552,111107472,XM_022442689.1,protein jagged-1-like,3751
NC_035781.1,37967548,37971970,37967548,37971970,111118574,XM_022458109.1,protein jagged-1-like,4422
NC_035788.1,32480154,32497282,32480154,32497282,111113729,XM_022452018.1,protein jagged-1b-like,17128
NC_035783.1,34293565,34341092,34293565,34341092,111131696,XM_022479341.1,protein jagged-1b-like,47527
NC_035783.1,43977727,44027708,43977727,44027708,111130290,XM_022477141.1,protein jagged-1b-like,49981
NC_035788.1,44167006,44174225,44167006,44174225,111111749,XM_022448883.1,protein jagged-1b-like,7219
NC_035786.1,49372080,49374447,49372080,49374447,111105251,XM_022439425.1,protein jagunal homolog 1-like,2367
NC_035781.1,13518345,13540734,13518345,13540734,111120979,XM_022462057.1,crossover junction endonuclease EME1-like,22389
NC_035783.1,47852668,47857617,47852668,47857617,111128877,XM_022474800.1,tight junction-associated protein 1-like,4949
NC_035780.1,8698514,8701494,8698514,8701494,111137068,XM_022488315.1,33 kDa inner dynein arm light chain,2980
NC_035784.1,12074644,12081024,12074644,12081024,111136572,XM_022487516.1,trichoplein keratin filament-binding protein-like,6380
NC_035780.1,8644724,8669554,8644724,8669554,111108835,XM_022445023.1,glutaminase kidney isoform,24830
NC_035780.1,6419625,6431055,6419625,6431055,111125571,XM_022469537.1,serine/threonine-protein kinase 3-like,11430
NC_035781.1,3519054,3525395,3519054,3525395,111121137,XM_022462276.1,thymidine kinase,6341
NC_035782.1,38826437,38833635,38826437,38833635,111126385,XM_022470979.1,acylglycerol kinase,7198
NC_035782.1,38194460,38201736,38194460,38201736,111124876,XM_022468132.1,acylglycerol kinase,7276
NC_035784.1,6187763,6196401,6187763,6196401,111099062,XM_022430410.1,MAP kinase-activated protein kinase 5-like,8638
NC_035780.1,54082941,54118322,54082941,54118322,111108068,XM_022443594.1,MAP kinase-activating death domain protein-like,35381
NC_035783.1,14022691,14026046,14022691,14026046,111130507,XM_022477651.1,G kinase-anchoring protein 1-like,3355
NC_035780.1,26240099,26243067,26240099,26243067,111099982,XM_022431568.1,S-phase kinase-associated protein 1,2968
NC_035781.1,13791268,13798115,13791268,13798115,111118004,XM_022457270.1,MAP kinase-interacting serine/threonine-protein kinase 1-like,6847
NC_035781.1,35675709,35690548,35675709,35690548,111120502,XM_022461250.1,uridine-cytidine kinase-like 1,14839
NC_035784.1,43926773,43940326,43929273,43940326,111133381,XM_022481736.1,ceramide kinase-like,11053
NC_035782.1,56782175,56793706,56782175,56793706,111127001,XM_022471967.1,glycerol kinase-like,11531
NC_035784.1,43926773,43940326,43926773,43939915,111133381,XM_022481732.1,ceramide kinase-like,13142
NC_035784.1,43926773,43940326,43926773,43939918,111133381,XM_022481735.1,ceramide kinase-like,13145
NC_035785.1,10002505,10017287,10002505,10017287,111100516,XM_022432474.1,taurocyamine kinase-like,14782
NC_035787.1,35935527,35952736,35935527,35952736,111108630,XM_022444629.1,ceramide kinase-like,17209
NC_035780.1,61451252,61468889,61451252,61468889,111099557,XM_022430883.1,choline/ethanolamine kinase-like,17637
NC_035786.1,55921821,55947301,55921821,55940036,111105636,XM_022440017.1,pyridoxal kinase-like,18215
NC_035787.1,30645962,30670414,30652001,30670414,111105814,XM_022440216.1,deoxynucleoside kinase-like,18413
NC_035783.1,34423599,34425501,34423599,34425501,111131711,XM_022479362.1,phosphomevalonate kinase-like,1902
NC_035781.1,20426768,20446077,20426768,20446077,111119409,XM_022459549.1,cyclin-G-associated kinase-like,19309
NC_035784.1,37431952,37451322,37431952,37451317,111136200,XM_022486869.1,NAD kinase-like,19365
NC_035784.1,94896409,94918743,94896659,94918742,111134976,XM_022484612.1,hydroxylysine kinase-like,22083
NC_035784.1,89101986,89124175,89101986,89124175,111135776,XM_022486112.1,xylulose kinase-like,22189
NC_035784.1,94896409,94918743,94896487,94918742,111134976,XM_022484613.1,hydroxylysine kinase-like,22255
NC_035784.1,94896409,94918743,94896409,94918743,111134976,XM_022484611.1,hydroxylysine kinase-like,22334
NC_035787.1,30645962,30670414,30645962,30670414,111105814,XM_022440215.1,deoxynucleoside kinase-like,24452
NC_035784.1,21651841,21654424,21651841,21654424,111136727,XM_022487812.1,TP53-regulating kinase-like,2583
NC_035783.1,44116504,44119448,44116504,44119448,111127753,XM_022472994.1,phosphomevalonate kinase-like,2944
NC_035780.1,53951112,53954197,53951112,53954197,111105240,XM_022439414.1,hydroxylysine kinase-like,3085
NC_035781.1,39836562,39839730,39836562,39839730,111121227,XM_022462397.1,methylthioribose kinase-like,3168
NC_035783.1,15333608,15336889,15333608,15336889,111127791,XM_022473039.1,adenosine kinase-like,3281
NC_035782.1,35390721,35443395,35390722,35394035,111125194,XM_022468731.1,guanylate kinase-like,3313
NC_035782.1,35390721,35443395,35390721,35394035,111125194,XM_022468732.1,guanylate kinase-like,3314
NC_035781.1,40224690,40228208,40224690,40228208,111118263,XM_022457634.1,UMP-CMP kinase-like,3518
NC_035781.1,39006643,39010185,39006643,39010185,111121143,XM_022462288.1,methylthioribose kinase-like,3542
NC_035784.1,91691934,91695482,91691934,91695482,111135530,XM_022485679.1,thymidylate kinase-like,3548
NC_035784.1,80322862,80323293,80322862,80323293,111132636,XM_022480462.1,4-diphosphocytidyl-2-C-methyl-D-erythritol kinase-like,431
NC_035782.1,35390721,35443395,35398862,35443395,111125194,XM_022468733.1,guanylate kinase-like,44533
NC_035784.1,71607285,71611803,71607285,71611803,111137605,XM_022489134.1,hydroxylysine kinase-like,4518
NC_035784.1,35789543,35794062,35789543,35794062,111132335,XM_022480136.1,mevalonate kinase-like,4519
NC_035784.1,26206843,26254901,26206931,26254900,111135841,XM_022486244.1,L-fucose kinase-like,47969
NC_035784.1,26206843,26254901,26206929,26254900,111135841,XM_022486243.1,L-fucose kinase-like,47971
NC_035784.1,26206843,26254901,26206857,26254900,111135841,XM_022486242.1,L-fucose kinase-like,48043
NC_035784.1,26206843,26254901,26206843,26254900,111135841,XM_022486241.1,L-fucose kinase-like,48057
NC_035784.1,26206843,26254901,26206843,26254901,111135841,XM_022486245.1,L-fucose kinase-like,48058
NC_035782.1,35390721,35443395,35390727,35443395,111125194,XM_022468734.1,guanylate kinase-like,52668
NC_035780.1,61451252,61468889,61451252,61457361,111099557,XM_022430876.1,choline/ethanolamine kinase-like,6109
NC_035784.1,43951598,43958184,43952039,43958184,111133383,XM_022481739.1,ceramide kinase-like,6145
NC_035784.1,91574915,91584275,91574915,91581297,111135526,XM_022485675.1,thymidylate kinase-like,6382
NC_035785.1,36793791,36800375,36793791,36800375,111100356,XM_022432123.1,L-seryl-tRNA(Sec) kinase-like,6584
NC_035784.1,43951598,43958184,43951598,43958183,111133383,XM_022481738.1,ceramide kinase-like,6585
NC_035788.1,103052787,103059415,103052787,103059415,111111035,XM_022447774.1,phosphoglycerate kinase-like,6628
NC_035783.1,56860005,56866936,56860005,56866936,111127757,XM_022472996.1,dolichol kinase-like,6931
NC_035782.1,42098318,42106276,42098318,42105730,111122533,XM_022464318.1,glycerol kinase-like,7412
NC_035782.1,23851208,23858657,23851208,23858657,111122808,XM_022464767.1,phosphoglycerate kinase-like,7449
NC_035783.1,15251143,15258793,15251143,15258793,111129356,XM_022475692.1,ceramide kinase-like,7650
NC_035787.1,46830911,46839005,46830911,46839005,111108492,XM_022444423.1,glycerate kinase-like,8094
NC_035783.1,57289427,57297702,57289427,57297702,111130537,XM_022477685.1,N-acetylgalactosamine kinase-like,8275
NC_035786.1,55921821,55947301,55921821,55930480,111105636,XM_022440015.1,pyridoxal kinase-like,8659
NC_035786.1,54077635,54086483,54077635,54086483,111102977,XM_022435936.1,pyridoxal kinase-like,8848
NC_035785.1,37259209,37268535,37259209,37268535,111101532,XM_022434055.1,N-acetyl-D-glucosamine kinase-like,9326
NC_035784.1,91574915,91584275,91574915,91584275,111135526,XM_022485674.1,thymidylate kinase-like,9360
NC_035784.1,43926773,43940326,43926773,43936342,111133381,XM_022481734.1,ceramide kinase-like,9569
NC_035784.1,37431952,37451322,37441359,37451322,111136200,XM_022486868.1,NAD kinase-like,9963
NC_035781.1,12980147,12997540,12980147,12997540,111120876,XM_022461892.1,serine/threonine-protein kinase/endoribonuclease IRE1-like,17393
NC_035782.1,55046613,55054710,55046613,55054710,111127096,XM_022472114.1,cyclin-dependent kinases regulatory subunit 1-like,8097
NC_035782.1,28779944,28791716,28779944,28791716,111127380,XM_022472539.1,chromosome-associated kinesin KIF4-like,11772
NC_035782.1,70095099,70115522,70095099,70115522,111122887,XM_022464915.1,trafficking kinesin-binding protein 1-like,20423
NC_035781.1,4857699,4862528,4857699,4862528,111120939,XM_022461998.1,probable kinetochore protein NUF2,4829
NC_035783.1,36388618,36394335,36388618,36394335,111129160,XM_022475319.1,protein kintoun-like,5717
NC_035787.1,15180844,15183166,15180844,15183166,111107796,XM_022443152.1,protein kish-B-like,2322
NC_035782.1,61829517,61842416,61829517,61842416,111123584,XM_022466006.1,thrombospondin-type laminin G domain and EAR repeat-containing protein-like,12899
NC_035781.1,43360157,43391468,43360157,43391468,111122172,XM_022463787.1,disks large homolog 5-like,31311
NC_035780.1,37967008,37992759,37967008,37992759,111123126,XM_022465247.1,disks large-associated protein 4-like,25751
NC_035786.1,31822156,31825214,31822156,31825214,111103408,XM_022436686.1,protein lava lamp-like,3058
NC_035780.1,51092502,51110087,51092502,51110087,111120262,XM_022461034.1,peroxisomal leader peptide-processing protease-like,17585
NC_035784.1,14670726,14675631,14670726,14675631,111138339,XM_022490256.1,pathogenesis-related leaf protein 4-like,4905
NC_035784.1,65538888,65570680,65538888,65570680,111134842,XM_022484287.1,sodium leak channel non-selective protein-like,31792
NC_035782.1,37730869,37738508,37730869,37738508,111124217,XM_022467076.1,C-type lectin mannose-binding isoform-like,7639
NC_035784.1,3802919,3817263,3802919,3817263,111138097,XM_022489904.1,C-type lectin-like,14344
NC_035780.1,8608694,8611342,8608694,8611342,111123984,XM_022466791.1,hepatic lectin-like,2648
NC_035787.1,52875322,52878108,52875322,52878108,111109172,XM_022445254.1,C-type lectin-like,2786
NC_035785.1,17803257,17806433,17803257,17806433,111101515,XM_022434038.1,hepatic lectin-like,3176
NC_035785.1,16840042,16843753,16840042,16843753,111101523,XM_022434047.1,hepatic lectin-like,3711
NC_035789.1,11776763,11782328,11776763,11782328,111116293,XM_022455281.1,alpha-N-acetylgalactosamine-specific lectin-like,5565
NC_035782.1,70316031,70322252,70316031,70322252,111124419,XM_022467271.1,alpha-N-acetylgalactosamine-specific lectin-like,6221
NC_035786.1,19470123,19476445,19470123,19476445,111104608,XM_022438633.1,hepatic lectin-like,6322
NC_035786.1,19496939,19503623,19496939,19503623,111104609,XM_022438634.1,hepatic lectin-like,6684
NC_035786.1,63176,80215,63176,80215,111102631,XM_022435453.1,telomere length regulation protein TEL2 homolog,17039
NC_035784.1,34186459,34212481,34186459,34212481,111136080,XM_022486675.1,protein let-653-like,26022
NC_035782.1,46920042,46933078,46920042,46933078,111126412,XM_022471040.1,male-specific lethal 3 homolog,13036
NC_035780.1,30516169,30522684,30516169,30522684,111105133,XM_022439309.1,basic leucine zipper and W2 domain-containing protein 1-like,6515
NC_035784.1,61066705,61080923,61066705,61080923,111133426,XM_022481850.1,probable leucine--tRNA ligase,14218
NC_035781.1,21861181,21863104,21861181,21863104,111120180,XM_022460907.1,pollen-specific leucine-rich repeat extensin-like protein 1,1923
NC_035782.1,31313389,31330321,31313389,31330321,111123492,XM_022465845.1,pre-B-cell leukemia transcription factor 1-like,16932
NC_035780.1,23070221,23074431,23070221,23074431,111105122,XM_022439298.1,cysteinyl leukotriene receptor 2-like,4210
NC_035782.1,51694978,51704826,51694978,51704825,111126295,XM_022470817.1,protein lev-9-like,9847
NC_035782.1,51694978,51704826,51694978,51704826,111126295,XM_022470818.1,protein lev-9-like,9848
NC_035780.1,17064927,17082520,17064927,17082520,111102753,XM_022435621.1,protein lifeguard 3-like,17593
NC_035782.1,53207570,53235228,53207570,53235228,111123990,XM_022466799.1,cys-loop ligand-gated ion channel-like,27658
NC_035785.1,35611771,35614506,35611771,35614506,111099523,XM_022430836.1,CD40 ligand-like,2735
NC_035780.1,62685492,62698419,62685492,62698419,111133693,XM_022482306.1,glutamate--cysteine ligase catalytic subunit-like,12927
NC_035783.1,20316095,20326249,20316095,20326249,111128976,XM_022474957.1,asparagine--tRNA ligase,10154
NC_035785.1,3687578,3697850,3687617,3697850,111101832,XM_022434453.1,tyrosine--tRNA ligase,10233
NC_035785.1,3687578,3697850,3687578,3697849,111101832,XM_022434452.1,tyrosine--tRNA ligase,10271
NC_035783.1,56234145,56245500,56234244,56245500,111130118,XM_022476839.1,threonine--tRNA ligase,11256
NC_035783.1,56234145,56245500,56234145,56245498,111130118,XM_022476840.1,threonine--tRNA ligase,11353
NC_035783.1,31157849,31169260,31157849,31169260,111130116,XM_022476836.1,isoleucine--tRNA ligase,11411
NC_035783.1,31499349,31510794,31499349,31510794,111130233,XM_022477020.1,isoleucine--tRNA ligase,11445
NC_035780.1,26370603,26382185,26370603,26382185,111118963,XM_022458698.1,aspartate--tRNA ligase,11582
NC_035780.1,52978276,53040799,53028715,53040799,111119553,XM_022459829.1,cysteine--tRNA ligase,12084
NC_035783.1,58938388,58951061,58938388,58951061,111128617,XM_022474348.1,threonine--tRNA ligase,12673
NC_035780.1,52687879,52749705,52687880,52700691,111118652,XM_022458229.1,cysteine--tRNA ligase,12811
NC_035780.1,52687879,52749705,52687880,52700700,111118652,XM_022458238.1,cysteine--tRNA ligase,12820
NC_035785.1,31035723,31049158,31035723,31049158,111099623,XM_022430987.1,methionine--tRNA ligase,13435
NC_035787.1,15163235,15179925,15163235,15178700,111108148,XM_022443765.1,isoleucine--tRNA ligase,15465
NC_035787.1,15163235,15179925,15163235,15178899,111108148,XM_022443763.1,isoleucine--tRNA ligase,15664
NC_035787.1,15163235,15179925,15163235,15179022,111108148,XM_022443761.1,isoleucine--tRNA ligase,15787
NC_035787.1,13241015,13258446,13242397,13258446,111108055,XM_022443557.1,isoleucine--tRNA ligase,16049
NC_035787.1,13241015,13258446,13242270,13258446,111108055,XM_022443556.1,isoleucine--tRNA ligase,16176
NC_035787.1,15163235,15179925,15163235,15179871,111108148,XM_022443762.1,isoleucine--tRNA ligase,16636
NC_035787.1,15163235,15179925,15163235,15179925,111108148,XM_022443764.1,isoleucine--tRNA ligase,16690
NC_035785.1,30993346,31010038,30993346,31010038,111100996,XM_022433203.1,methionine--tRNA ligase,16692
NC_035787.1,13241015,13258446,13241015,13258446,111108055,XM_022443558.1,isoleucine--tRNA ligase,17431
NC_035783.1,57047287,57065152,57047287,57065152,111129859,XM_022476346.1,alanine--tRNA ligase,17865
NC_035780.1,20532613,20551630,20532613,20551630,111136976,XM_022488180.1,methionine--tRNA ligase,19017
NC_035781.1,31048830,31068663,31048830,31068663,111120899,XM_022461926.1,tyrosine--tRNA ligase,19833
NC_035782.1,22888683,22912683,22888683,22912658,111126003,XM_022470354.1,leucine--tRNA ligase,23975
NC_035782.1,22888683,22912683,22888683,22912683,111126003,XM_022470355.1,leucine--tRNA ligase,24000
NC_035784.1,47458912,47484374,47458912,47484374,111135733,XM_022486044.1,alanine--tRNA ligase,25462
NC_035783.1,51479500,51508260,51479500,51508260,111130025,XM_022476631.1,phenylalanine--tRNA ligase,28760
NC_035782.1,75576599,75611211,75576599,75611211,111125541,XM_022469466.1,arginine--tRNA ligase,34612
NC_035782.1,70697100,70733120,70697100,70733120,111125113,XM_022468588.1,arginine--tRNA ligase,36020
NC_035782.1,15592413,15596191,15592413,15596191,111125186,XM_022468723.1,tryptophan--tRNA ligase,3778
NC_035785.1,29850051,29855240,29850051,29855240,111101460,XM_022433961.1,tryptophan--tRNA ligase,5189
NC_035781.1,31048830,31068663,31048830,31054222,111120899,XM_022461925.1,tyrosine--tRNA ligase,5392
NC_035780.1,52687879,52749705,52687879,52748679,111118652,XM_022458223.1,cysteine--tRNA ligase,60800
NC_035780.1,52978276,53040799,52979301,53040799,111119553,XM_022459819.1,cysteine--tRNA ligase,61498
NC_035780.1,52687879,52749705,52687879,52749705,111118652,XM_022458213.1,cysteine--tRNA ligase,61826
NC_035780.1,52978276,53040799,52978276,53040799,111119553,XM_022459810.1,cysteine--tRNA ligase,62523
NC_035782.1,22474633,22481064,22474633,22481064,111125723,XM_022469790.1,histidine--tRNA ligase,6431
NC_035783.1,11727257,11734477,11727257,11734477,111130020,XM_022476620.1,tryptophan--tRNA ligase,7220
NC_035783.1,8092466,8100171,8092473,8100171,111130709,XM_022477917.1,serine--tRNA ligase,7698
NC_035783.1,8092466,8100171,8092466,8100171,111130709,XM_022477916.1,serine--tRNA ligase,7705
NC_035784.1,8321340,8329594,8321342,8329594,111135543,XM_022485695.1,aspartate--tRNA ligase,8252
NC_035784.1,8321340,8329594,8321340,8329594,111135543,XM_022485694.1,aspartate--tRNA ligase,8254
NC_035786.1,13847396,13855812,13847396,13855812,111104253,XM_022438101.1,tryptophan--tRNA ligase,8416
NC_035787.1,64533269,64542245,64533269,64542245,111110313,XM_022446751.1,serine--tRNA ligase,8976
NC_035782.1,15615205,15624297,15615205,15624297,111125817,XM_022469974.1,tryptophan--tRNA ligase,9092
NC_035783.1,51479500,51508260,51498989,51508260,111130025,XM_022476630.1,phenylalanine--tRNA ligase,9271
NC_035782.1,62307385,62314040,62307385,62311460,111123705,XM_022466236.1,4-coumarate--CoA ligase-like 7,4075
NC_035787.1,23002047,23013394,23002047,23013394,111110532,XM_022447073.1,glutamine--tRNA ligase-like,11347
NC_035787.1,26825123,26836623,26825123,26836623,111110195,XM_022446590.1,glutamine--tRNA ligase-like,11500
NC_035782.1,32409104,32421955,32409104,32421829,111125665,XM_022469703.1,valine--tRNA ligase-like,12725
NC_035782.1,32409104,32421955,32409104,32421955,111125665,XM_022469704.1,valine--tRNA ligase-like,12851
NC_035784.1,29172370,29186636,29172370,29186636,111136015,XM_022486565.1,lysine--tRNA ligase-like,14266
NC_035783.1,49387437,49409162,49387437,49409162,111129323,XM_022475619.1,4-coumarate--CoA ligase-like,21725
NC_035783.1,9371235,9395669,9371235,9395669,111129115,XM_022475235.1,diphthine--ammonia ligase-like,24434
NC_035784.1,69160714,69189341,69160714,69189341,111135439,XM_022485513.1,biotin--protein ligase-like,28627
NC_035784.1,23461857,23465130,23461857,23465130,111132874,XM_022480788.1,DNA ligase-like,3273
NC_035787.1,9101405,9105274,9101405,9105274,111109574,XM_022445750.1,long-chain-fatty-acid--CoA ligase-like,3869
NC_035783.1,51949442,51953493,51949442,51953493,111128710,XM_022474495.1,tubulin--tyrosine ligase-like,4051
NC_035782.1,35617465,35660194,35617465,35660194,111123900,XM_022466578.1,valine--tRNA ligase-like,42729
NC_035787.1,11915981,11921044,11915981,11921044,111106845,XM_022441693.1,long-chain-fatty-acid--CoA ligase-like,5063
NC_035780.1,15464159,15469265,15464160,15469265,111110954,XM_022447637.1,biotin--protein ligase-like,5105
NC_035780.1,15464159,15469265,15464159,15469265,111110954,XM_022447645.1,biotin--protein ligase-like,5106
NC_035780.1,22669366,22675872,22669366,22675872,111134767,XM_022484111.1,phosphopantothenate--cysteine ligase-like,6506
NC_035783.1,49387437,49409162,49387437,49395696,111129323,XM_022475620.1,4-coumarate--CoA ligase-like,8259
NC_035788.1,64951690,64960841,64951690,64960841,111115725,XM_022454561.1,glycine--tRNA ligase-like,9151
NC_035780.1,3914300,3918047,3914300,3918047,111115748,XM_022454597.1,clathrin light chain B-like,3747
NC_035784.1,35909012,35919545,35909012,35919545,111138175,XM_022490023.1,O-acyltransferase like protein-like,10533
NC_035780.1,10556125,10565682,10556125,10565682,111100900,XM_022433074.1,protein limb expression 1 homolog,9557
NC_035786.1,19245479,19271695,19245479,19271311,111102434,XM_022435178.1,protein lin-28 homolog,25832
NC_035784.1,44130365,44130733,44130365,44130733,111132390,XM_022480192.1,protein lin-32-like,368
NC_035787.1,13740280,13744469,13740280,13744469,111109397,XM_022445477.1,protein lin-37 homolog,4189
NC_035781.1,55634420,55635514,55634420,55635514,111120404,XM_022461119.1,protein lin-41-like,1094
NC_035781.1,59960814,59961233,59960814,59961233,111120449,XM_022461161.1,protein lin-41-like,419
NC_035787.1,52573775,52574233,52573775,52574233,111109165,XM_022445247.1,protein lin-41-like,458
NC_035788.1,42831132,42831599,42831132,42831599,111113856,XM_022452148.1,protein lin-41-like,467
NC_035781.1,58317905,58318674,58317905,58318674,111120431,XM_022461145.1,protein lin-41-like,769
NC_035783.1,53611876,53614458,53611876,53614458,111128091,XM_022473533.1,protein lin-52 homolog,2582
NC_035781.1,16791373,16805806,16791373,16805806,111120757,XM_022461700.1,protein lin-54 homolog,14433
NC_035780.1,56070304,56073851,56070304,56073851,111137271,XM_022488670.1,protein lin-7 homolog C-like,3547
NC_035780.1,59224636,59243458,59224636,59243458,111115224,XM_022453887.1,protein lin-9 homolog,18822
NC_035783.1,39800847,39836435,39800847,39836435,111128460,XM_022474071.1,protein lingerer-like,35588
NC_035783.1,51575810,51584780,51575810,51584780,111129196,XM_022475440.1,cleft lip and palate transmembrane protein 1 homolog,8970
NC_035783.1,8295751,8310129,8295751,8310129,111128491,XM_022474104.1,monoacylglycerol lipase ABHD12-like,14378
NC_035787.1,3574829,3586947,3574829,3586947,111110436,XM_022446934.1,monoglyceride lipase-like,12118
NC_035787.1,4987892,5001280,4987892,5001280,111110678,XM_022447282.1,monoglyceride lipase-like,13388
NC_035787.1,3532105,3548698,3532105,3548698,111109765,XM_022445992.1,monoglyceride lipase-like,16593
NC_035787.1,3568397,3573214,3568397,3573214,111107477,XM_022442693.1,monoglyceride lipase-like,4817
NC_035787.1,5019414,5024371,5019414,5024371,111110521,XM_022447062.1,monoglyceride lipase-like,4957
NC_035787.1,3549893,3554949,3549893,3554949,111110581,XM_022447137.1,monoglyceride lipase-like,5056
NC_035787.1,5003411,5008799,5003411,5008799,111107515,XM_022442741.1,monoglyceride lipase-like,5388
NC_035787.1,5025566,5032125,5025566,5032125,111110488,XM_022447002.1,monoglyceride lipase-like,6559
NC_035782.1,67432275,67442038,67432275,67442038,111125303,XM_022468924.1,hormone-sensitive lipase-like,9763
NC_035781.1,494850,504314,494850,504314,111120904,XM_022461932.1,pancreatic lipase-related protein 2-like,9464
NC_035783.1,32775773,32791117,32775773,32791117,111130541,XM_022477689.1,stAR-related lipid transfer protein 5-like,15344
NC_035781.1,23406778,23409047,23406778,23409047,111122230,XM_022463870.1,non-specific lipid-transfer protein-like,2269
NC_035780.1,29916036,29955105,29916036,29955105,111126518,XM_022471227.1,low-density lipoprotein receptor-related protein 4-like,39069
NC_035785.1,41569427,41571404,41569427,41571404,111100964,XM_022433145.1,putative lipoyltransferase 2,1977
NC_035782.1,38371614,38376706,38371614,38376706,111122879,XM_022464899.1,calcium load-activated calcium channel-like,5092
NC_035782.1,65218679,65235376,65218679,65235376,111125237,XM_022468812.1,circadian locomoter output cycles protein kaput-like,16697
NC_035780.1,4712962,4726844,4712962,4726844,111130260,XM_022477087.1,neurogenic locus notch homolog protein 1-like,13882
NC_035784.1,40238725,40247166,40238725,40247166,111137027,XM_022488253.1,sphingoid long chain base kinase 4-like,8441
NC_035783.1,2429952,2437325,2429952,2437325,111130535,XM_022477683.1,very long-chain acyl-CoA synthetase-like,7373
NC_035781.1,14204328,14214497,14204328,14214497,111120530,XM_022461321.1,very low-density lipoprotein receptor-like,10169
NC_035781.1,33681213,33685180,33681213,33685180,111118667,XM_022458234.1,ER lumen protein-retaining receptor 2,3967
NC_035781.1,1735250,1743961,1735250,1743961,111121731,XM_022463122.1,sphingosine-1-phosphate lyase 1-like,8711
NC_035780.1,59691035,59699010,59691035,59699010,111116092,XM_022455087.1,hydroxymethylglutaryl-CoA lyase,7975
NC_035780.1,32184043,32194212,32184043,32194212,111124154,XM_022467053.1,sphingosine-1-phosphate lyase-like,10169
NC_035784.1,54658497,54668997,54658497,54668997,111135773,XM_022486109.1,argininosuccinate lyase-like,10500
NC_035783.1,48138226,48151256,48138226,48151256,111129073,XM_022475153.1,lactoylglutathione lyase-like,13030
NC_035788.1,54778579,54794360,54778579,54794360,111115321,XM_022453998.1,adenylosuccinate lyase-like,15781
NC_035785.1,8334141,8336221,8334141,8336221,111099837,XM_022431302.1,N-acetylneuraminate lyase-like,2080
NC_035785.1,8365146,8368333,8365146,8368333,111100777,XM_022432868.1,N-acetylneuraminate lyase-like,3187
NC_035781.1,11109479,11114125,11109479,11114125,111121053,XM_022462156.1,N-acetylneuraminate lyase-like,4646
NC_035782.1,2102142,2107022,2102142,2107022,111123349,XM_022465630.1,N-glycosylase/DNA lyase-like,4880
NC_035782.1,5565677,5570619,5565677,5570619,111125609,XM_022469587.1,N-glycosylase/DNA lyase-like,4942
NC_035784.1,51025934,51032383,51026196,51032383,111132139,XM_022479871.1,selenocysteine lyase-like,6187
NC_035784.1,51025934,51032383,51025938,51032383,111132139,XM_022479869.1,selenocysteine lyase-like,6445
NC_035784.1,51025934,51032383,51025934,51032383,111132139,XM_022479870.1,selenocysteine lyase-like,6449
NC_035785.1,8313250,8320947,8313250,8320947,111099829,XM_022431292.1,N-acetylneuraminate lyase-like,7697
NC_035785.1,8336436,8337325,8336436,8337325,111099836,XM_022431301.1,N-acetylneuraminate lyase-like,889
NC_035784.1,54658497,54668997,54659759,54668997,111135773,XM_022486108.1,argininosuccinate lyase-like,9238
NC_035783.1,42859068,42873199,42859068,42873199,111130001,XM_022476587.1,mucosa-associated lymphoid tissue lymphoma translocation protein 1-like,14131
NC_035780.1,40003512,40022490,40003512,40022490,111123204,XM_022465432.1,B-cell lymphoma 6 protein homolog,18978
NC_035783.1,24703060,24724248,24703060,24724248,111128833,XM_022474724.1,B-cell lymphoma/leukemia 11A-like,21188
NC_035787.1,69268178,69279210,69268178,69279210,111109767,XM_022445995.1,EEF1A lysine methyltransferase 2-like,11032
NC_035786.1,49681903,49685916,49681903,49685916,111102806,XM_022435679.1,high-affinity lysophosphatidic acid receptor-like,4013
NC_035781.1,684193,702526,684193,702526,111121639,XM_022462997.1,sodium-dependent lysophosphatidylcholine symporter 1-like,18333
NC_035780.1,24218680,24228020,24218680,24228020,111130501,XM_022477646.1,gamma-interferon-inducible lysosomal thiol reductase-like,9340
NC_035780.1,30691285,30693992,30691285,30693992,111133395,XM_022481758.1,AAC-rich mRNA clone AAC4 protein-like,2707
NC_035782.1,58126811,58128282,58126811,58128282,111126278,XM_022470796.1,protein mab-21-like 2,1471
NC_035784.1,28636603,28640580,28636603,28640580,111133501,XM_022481954.1,translation machinery-associated protein 16-like,3977
NC_035782.1,73325079,73334511,73325079,73334511,111122768,XM_022464667.1,protein maelstrom homolog,9432
NC_035784.1,80369937,80374474,80369937,80374474,111133765,XM_022482404.1,membrane magnesium transporter 1-like,4537
NC_035781.1,42053325,42057549,42053325,42057549,111120984,XM_022462065.1,protein mago nashi homolog 2,4224
NC_035780.1,48394159,48426283,48394159,48426283,111102211,XM_022434866.1,structural maintenance of chromosomes flexible hinge domain-containing protein 1-like,32124
NC_035780.1,27853948,27859021,27853948,27859021,111131799,XM_022479510.1,putative malate dehydrogenase 1B,5073
NC_035786.1,11838518,11849100,11838518,11849100,111102676,XM_022435513.1,NADP-dependent malic enzyme-like,10582
NC_035781.1,27311261,27315359,27311261,27315359,111122235,XM_022463876.1,acidic mammalian chitinase-like,4098
NC_035783.1,34968677,34970283,34968677,34970283,111130680,XM_022477872.1,putative mannan endo-1,1606
NC_035780.1,23634031,23670294,23634031,23670294,111132794,XM_022480628.1,macrophage mannose receptor 1-like,36263
NC_035784.1,7904808,7918132,7904808,7918132,111136731,XM_022487816.1,cation-dependent mannose-6-phosphate receptor-like,13324
NC_035780.1,6379352,6383718,6379352,6383718,111119818,XM_022460329.1,GPI mannosyltransferase 2-like,4366
NC_035786.1,16850736,16853596,16850736,16853596,111104887,XM_022439055.1,proliferation marker protein Ki-67-like,2860
NC_035782.1,4542424,4575004,4542424,4575004,111124722,XM_022467861.1,pericentriolar material 1 protein-like,32580
NC_035780.1,9770393,9779044,9770393,9779044,111121700,XM_022463071.1,cartilage matrix protein-like,8651
NC_035782.1,73460581,73488585,73460581,73488585,111127274,XM_022472378.1,SWI/SNF-related matrix-associated actin-dependent regulator of chromatin subfamily A member 5-like,28004
NC_035780.1,59023526,59047678,59023526,59047678,111126066,XM_022470461.1,lipase maturation factor 2-like,24152
NC_035783.1,41111092,41121298,41111255,41121298,111130850,XM_022478103.1,protein max-like,10043
NC_035783.1,41111092,41121298,41111092,41121286,111130850,XM_022478105.1,protein max-like,10194
NC_035783.1,41111092,41121298,41111092,41121288,111130850,XM_022478106.1,protein max-like,10196
NC_035783.1,40620953,40631421,40620965,40631421,111130852,XM_022478110.1,protein max-like,10456
NC_035783.1,40620953,40631421,40620963,40631421,111130852,XM_022478111.1,protein max-like,10458
NC_035783.1,40620953,40631421,40620953,40631421,111130852,XM_022478108.1,protein max-like,10468
NC_035784.1,95753542,95763645,95753542,95763645,111137985,XM_022489724.1,degenerin mec-10-like,10103
NC_035781.1,41942250,41963172,41942250,41963172,111117766,XM_022457014.1,degenerin mec-10-like,20922
NC_035784.1,95727324,95750809,95727324,95750809,111132885,XM_022480808.1,degenerin mec-10-like,23485
NC_035784.1,59665352,59718227,59665352,59718227,111137727,XM_022489347.1,piezo-type mechanosensitive ion channel component 1-like,52875
NC_035782.1,10001970,10014780,10001970,10014780,111125101,XM_022468573.1,hyaluronan mediated motility receptor-like,12810
NC_035780.1,22055606,22060834,22055606,22060834,111126636,XM_022471417.1,putative mediator of RNA polymerase II transcription subunit 12,5228
NC_035780.1,8878802,8890809,8878802,8890809,111126441,XM_022471101.1,neurofilament medium polypeptide-like,12007
NC_035781.1,53236015,53242965,53236015,53242965,111122376,XM_022464133.1,leucine-rich melanocyte differentiation-associated protein-like,6950
NC_035780.1,8692509,8698183,8692509,8698183,111137060,XM_022488304.1,ER membrane protein complex subunit 2-like,5674
NC_035781.1,10070147,10080889,10070151,10080889,111120517,XM_022461283.1,stromal membrane-associated protein 1-like,10738
NC_035784.1,47926817,48044337,47926817,48044337,111135845,XM_022486252.1,basement membrane-specific heparan sulfate proteoglycan core protein-like,117520
NC_035782.1,39936045,39946476,39936045,39946476,111124774,XM_022467961.1,protein mesh-like,10431
NC_035782.1,40225806,40236573,40225806,40236573,111124771,XM_022467948.1,protein mesh-like,10767
NC_035784.1,10784609,10796613,10784609,10796613,111132905,XM_022480836.1,protein mesh-like,12004
NC_035784.1,10802552,10816204,10802552,10816204,111137502,XM_022488972.1,protein mesh-like,13652
NC_035782.1,40193808,40207854,40193808,40207854,111124764,XM_022467936.1,protein mesh-like,14046
NC_035782.1,39831847,39846221,39831847,39846221,111124765,XM_022467937.1,protein mesh-like,14374
NC_035782.1,40259552,40275487,40259552,40275487,111124766,XM_022467938.1,protein mesh-like,15935
NC_035782.1,39850238,39854909,39850238,39854909,111124228,XM_022467087.1,protein mesh-like,4671
NC_035782.1,39876734,39881572,39876734,39881572,111124788,XM_022467979.1,protein mesh-like,4838
NC_035782.1,40238613,40248159,40238613,40248159,111124770,XM_022467946.1,protein mesh-like,9546
NC_035780.1,10856804,10862757,10856804,10862757,111131144,XM_022478528.1,paired mesoderm homeobox protein 2-like,5953
NC_035784.1,33324668,33327195,33324668,33327195,111137961,XM_022489695.1,heavy metal-associated isoprenylated plant protein 33-like,2527
NC_035780.1,6957396,6959364,6957396,6959364,111121419,XM_022462706.1,heavy metal-binding protein HIP-like,1968
NC_035785.1,48950965,48951507,48950965,48951507,111102218,XM_022434870.1,uncharacterized metal-dependent hydrolase YcfH-like,542
NC_035784.1,90976123,90991154,90980906,90991154,111135787,XM_022486147.1,matrix metallopeptidase-21-like,10248
NC_035784.1,90976123,90991154,90979422,90989857,111135787,XM_022486145.1,matrix metallopeptidase-21-like,10435
NC_035784.1,90976123,90991154,90976123,90989857,111135787,XM_022486144.1,matrix metallopeptidase-21-like,13734
NC_035784.1,90976123,90991154,90980069,90989857,111135787,XM_022486146.1,matrix metallopeptidase-21-like,9788
NC_035787.1,23473985,23535498,23473985,23535498,111109671,XM_022445886.1,astacin-like metalloprotease toxin 1,61513
NC_035780.1,9779216,9791313,9779216,9791313,111123006,XM_022465114.1,zinc metalloproteinase nas-15-like,12097
NC_035784.1,6015353,6022849,6015353,6022849,111138285,XM_022490163.1,matrix metalloproteinase-14-like,7496
NC_035784.1,6963930,6973310,6963931,6973309,111137713,XM_022489322.1,matrix metalloproteinase-14-like,9378
NC_035784.1,6963930,6973310,6963930,6973310,111137713,XM_022489323.1,matrix metalloproteinase-14-like,9380
NC_035780.1,10670937,10685519,10670937,10685519,111119437,XM_022459628.1,matrix metalloproteinase-19-like,14582
NC_035784.1,29716214,29719276,29716214,29719276,111138208,XM_022490066.1,matrix metalloproteinase-19-like,3062
NC_035784.1,6992902,7004448,6992902,7004448,111134457,XM_022483475.1,matrix metalloproteinase-2-like,11546
NC_035784.1,6047791,6059947,6047791,6059947,111134505,XM_022483589.1,matrix metalloproteinase-2-like,12156
NC_035785.1,32357085,32363105,32357085,32363105,111099717,XM_022431130.1,matrix metalloproteinase-24-like,6020
NC_035782.1,45715719,45727103,45715719,45727103,111125156,XM_022468679.1,zinc metalloproteinase-disintegrin-like atrase-A,11384
NC_035780.1,44019384,44023725,44019384,44023725,111119349,XM_022459419.1,peptide methionine sulfoxide reductase MsrA-like,4341
NC_035781.1,15113904,15120056,15113904,15120056,111120988,XM_022462068.1,diphthine methyl ester synthase-like,6152
NC_035781.1,20621318,20627158,20621318,20627158,111122078,XM_022463633.1,bifunctional methylenetetrahydrofolate dehydrogenase/cyclohydrolase,5840
NC_035783.1,36394574,36400837,36394574,36400837,111129161,XM_022475320.1,probable methylmalonate-semialdehyde dehydrogenase [acylating],6263
NC_035780.1,33945542,33964892,33945542,33964877,111131186,XM_022478610.1,hemK methyltransferase family member 2-like,19335
NC_035780.1,31970919,31985637,31970919,31985637,111125201,XM_022468761.1,probable methyltransferase-like protein 15 homolog,14718
NC_035784.1,80060246,80070735,80060246,80070735,111132631,XM_022480458.1,arsenite methyltransferase-like,10489
NC_035781.1,59767671,59782634,59767671,59782259,111121075,XM_022462199.1,diphthine methyltransferase-like,14588
NC_035781.1,59767671,59782634,59767671,59782634,111121075,XM_022462201.1,diphthine methyltransferase-like,14963
NC_035784.1,79870328,79915093,79870847,79888628,111135029,XM_022484716.1,arsenite methyltransferase-like,17781
NC_035784.1,79870328,79915093,79870365,79888628,111135029,XM_022484715.1,arsenite methyltransferase-like,18263
NC_035784.1,79870328,79915093,79870338,79888628,111135029,XM_022484714.1,arsenite methyltransferase-like,18290
NC_035784.1,80040142,80058788,80040142,80058788,111132630,XM_022480457.1,arsenite methyltransferase-like,18646
NC_035781.1,48554041,48556342,48554041,48556096,111118907,XM_022458615.1,methylated-DNA--protein-cysteine methyltransferase-like,2055
NC_035784.1,69382866,69385109,69382866,69385103,111135612,XM_022485838.1,demethylmenaquinone methyltransferase-like,2237
NC_035781.1,48554041,48556342,48554041,48556342,111118907,XM_022458614.1,methylated-DNA--protein-cysteine methyltransferase-like,2301
NC_035785.1,805511,850410,825498,850410,111100227,XM_022431893.1,demethylmenaquinone methyltransferase-like,24912
NC_035781.1,49318647,49321593,49318895,49321593,111121007,XM_022462089.1,methylated-DNA--protein-cysteine methyltransferase-like,2698
NC_035781.1,49318647,49321593,49318647,49321593,111121007,XM_022462088.1,methylated-DNA--protein-cysteine methyltransferase-like,2946
NC_035784.1,83461026,83464888,83461923,83464888,111099066,XM_022430412.1,demethylmenaquinone methyltransferase-like,2965
NC_035781.1,59816399,59824298,59816399,59819379,111121074,XM_022462198.1,diphthine methyltransferase-like,2980
NC_035784.1,69396267,69400039,69396267,69399988,111135603,XM_022485827.1,demethylmenaquinone methyltransferase-like,3721
NC_035784.1,69396267,69400039,69396267,69400039,111135603,XM_022485828.1,demethylmenaquinone methyltransferase-like,3772
NC_035784.1,83461026,83464888,83461026,83464888,111099066,XM_022430413.1,demethylmenaquinone methyltransferase-like,3862
NC_035784.1,69388250,69394758,69390835,69394758,111135602,XM_022485825.1,demethylmenaquinone methyltransferase-like,3923
NC_035785.1,805511,850410,806616,850409,111100227,XM_022431894.1,demethylmenaquinone methyltransferase-like,43793
NC_035784.1,79870328,79915093,79870332,79914350,111135029,XM_022484718.1,arsenite methyltransferase-like,44018
NC_035784.1,79870328,79915093,79870328,79914350,111135029,XM_022484719.1,arsenite methyltransferase-like,44022
NC_035784.1,79870328,79915093,79870335,79915093,111135029,XM_022484717.1,arsenite methyltransferase-like,44758
NC_035785.1,805511,850410,805511,850405,111100227,XM_022431891.1,demethylmenaquinone methyltransferase-like,44894
NC_035785.1,724380,728965,724380,728965,111099676,XM_022431067.1,demethylmenaquinone methyltransferase-like,4585
NC_035785.1,828581,833183,828581,833183,111100228,XM_022431895.1,demethylmenaquinone methyltransferase-like,4602
NC_035785.1,805511,850410,805511,810421,111100227,XM_022431892.1,demethylmenaquinone methyltransferase-like,4910
NC_035785.1,805511,850410,845047,850410,111100227,XM_022431889.1,demethylmenaquinone methyltransferase-like,5363
NC_035784.1,69388250,69394758,69388250,69394758,111135602,XM_022485824.1,demethylmenaquinone methyltransferase-like,6508
NC_035784.1,79917202,79924962,79917202,79924962,111132628,XM_022480454.1,arsenite methyltransferase-like,7760
NC_035781.1,59816399,59824298,59816399,59824298,111121074,XM_022462197.1,diphthine methyltransferase-like,7899
NC_035784.1,79928083,80009723,79928083,80009723,111132629,XM_022480455.1,arsenite methyltransferase-like,81640
NC_035784.1,80073400,80082950,80073400,80082950,111132632,XM_022480459.1,arsenite methyltransferase-like,9550
NC_035783.1,49723655,49725745,49723655,49725745,111127839,XM_022473111.1,prostate-associated microseminoprotein-like,2090
NC_035782.1,47524453,47531564,47524453,47531564,111124552,XM_022467495.1,jupiter microtubule associated homolog 1-like,7111
NC_035783.1,29342624,29346896,29342624,29346896,111129388,XM_022475749.1,echinoderm microtubule-associated protein-like CG42247,4272
NC_035783.1,24547501,24555707,24547501,24553950,111130493,XM_022477627.1,metalloprotease mig-17-like,6449
NC_035783.1,24547501,24555707,24547501,24555707,111130493,XM_022477626.1,metalloprotease mig-17-like,8206
NC_035780.1,56979286,56979675,56979286,56979675,111108201,XM_022443875.1,neuronal migration protein doublecortin-like,389
NC_035781.1,26962142,27001766,26962142,27001766,111122089,XM_022463645.1,cell migration-inducing and hyaluronan-binding protein-like,39624
NC_035782.1,66724523,66732180,66724523,66732180,111127326,XM_022472456.1,angio-associated migratory cell protein-like,7657
NC_035783.1,30043571,30056353,30043571,30056353,111127800,XM_022473048.1,protein misato homolog 1-like,12782
NC_035780.1,56207700,56223257,56207700,56223257,111110235,XM_022446641.1,DNA mismatch repair protein Msh6-like,15557
NC_035784.1,60572667,60586891,60572667,60586891,111134728,XM_022484051.1,clustered mitochondria protein homolog,14224
NC_035780.1,27572301,27587822,27572301,27587822,111132332,XM_022480137.1,calcium-binding mitochondrial carrier protein Aralar2-like,15521
NC_035782.1,71364970,71367397,71364970,71367397,111126226,XM_022470712.1,high mobility group-T protein-like,2427
NC_035780.1,19973823,19980059,19973823,19980059,111119998,XM_022460604.1,tRNA modification GTPase GTPBP3,6236
NC_035786.1,7322126,7328877,7322126,7328877,111102463,XM_022435214.1,chromatin modification-related protein MEAF6-like,6751
NC_035782.1,42815688,42820913,42815688,42820913,111124593,XM_022467575.1,ubiquitin-fold modifier 1,5225
NC_035782.1,29542551,29547581,29542551,29547581,111125903,XM_022470128.1,ubiquitin-like modifier-activating enzyme 5,5030
NC_035782.1,56771751,56776228,56771751,56776228,111125853,XM_022470040.1,ubiquitin-fold modifier-conjugating enzyme 1,4477
NC_035783.1,23090522,23118143,23090522,23118143,111131768,XM_022479467.1,SPARC-related modular calcium-binding protein 1-like,27621
NC_035780.1,10072461,10102370,10072461,10102370,111135155,XM_022484947.1,nodal modulator 1-like,29909
NC_035780.1,54895033,54901574,54895033,54901574,111127086,XM_022472104.1,glucocorticoid modulatory element-binding protein 2-like,6541
NC_035780.1,7962010,7966245,7962010,7966245,111109848,XM_022446101.1,low molecular weight phosphotyrosine protein phosphatase 1-like,4235
NC_035780.1,47210334,47221846,47210334,47221846,111118230,XM_022457576.1,adapter molecule Crk-like,11512
NC_035780.1,60242503,60250220,60242503,60250220,111115950,XM_022454879.1,sodium-coupled monocarboxylate transporter 1-like,7717
NC_035787.1,66139742,66163682,66139742,66163682,111105904,XM_022440367.1,protein monoglycylase TTLL8-like,23940
NC_035780.1,39897393,39946457,39897393,39946457,111112899,XM_022450779.1,dimethylaniline monooxygenase [N-oxide-forming] 5-like,49064
NC_035780.1,49399804,49415682,49399806,49415682,111119191,XM_022459098.1,alkylglycerol monooxygenase-like,15876
NC_035780.1,49399804,49415682,49399804,49415682,111119191,XM_022459108.1,alkylglycerol monooxygenase-like,15878
NC_035780.1,47640786,47660529,47640786,47660529,111119013,XM_022458794.1,alkylglycerol monooxygenase-like,19743
NC_035781.1,47687556,47692349,47687556,47692349,111118981,XM_022458715.1,inositol monophosphatase 3-like,4793
NC_035780.1,47384062,47388975,47384062,47388975,111112503,XM_022450026.1,adenosine monophosphate-protein transferase FICD-like,4913
NC_035784.1,26984789,26992978,26984970,26992978,111133575,XM_022482069.1,protein moonraker-like,8008
NC_035784.1,26601540,26609768,26601679,26609768,111133574,XM_022482065.1,protein moonraker-like,8089
NC_035784.1,26984789,26992978,26984789,26992978,111133575,XM_022482068.1,protein moonraker-like,8189
NC_035784.1,26601540,26609768,26601541,26609768,111133574,XM_022482064.1,protein moonraker-like,8227
NC_035784.1,26601540,26609768,26601540,26609768,111133574,XM_022482066.1,protein moonraker-like,8228
NC_035780.1,20237432,20257188,20237432,20257188,111103992,XM_022437670.1,bone morphogenetic protein 1-like,19756
NC_035784.1,73363999,73368248,73363999,73368248,111136408,XM_022487241.1,RNA-binding motif protein,4249
NC_035788.1,74078678,74153039,74078678,74111149,111112585,XM_022450133.1,RNA-binding motif,32471
NC_035788.1,74078678,74153039,74078678,74113585,111112585,XM_022450122.1,RNA-binding motif,34907
NC_035788.1,74078678,74153039,74078678,74117176,111112585,XM_022450130.1,RNA-binding motif,38498
NC_035788.1,74078678,74153039,74078678,74120803,111112585,XM_022450129.1,RNA-binding motif,42125
NC_035788.1,74078678,74153039,74078678,74122824,111112585,XM_022450131.1,RNA-binding motif,44146
NC_035788.1,74078678,74153039,74078678,74135930,111112585,XM_022450125.1,RNA-binding motif,57252
NC_035788.1,74078678,74153039,74078678,74136819,111112585,XM_022450128.1,RNA-binding motif,58141
NC_035788.1,74078678,74153039,74078678,74137022,111112585,XM_022450124.1,RNA-binding motif,58344
NC_035788.1,74078678,74153039,74078678,74138256,111112585,XM_022450126.1,RNA-binding motif,59578
NC_035788.1,74078678,74153039,74078678,74153039,111112585,XM_022450123.1,RNA-binding motif,74361
NC_035780.1,2200370,2214720,2200370,2214720,111132141,XM_022479877.1,tripartite motif-containing protein 2-like,14350
NC_035784.1,92824900,92829049,92824900,92829049,111132206,XM_022479983.1,GPALPP motifs-containing protein 1-like,4149
NC_035780.1,2949747,2953009,2949747,2953009,111119645,XM_022460048.1,cysteine-rich motor neuron 1 protein-like,3262
NC_035780.1,16327115,16335226,16327115,16335226,111115631,XM_022454452.1,integumentary mucin C.1-like,8111
NC_035783.1,56550427,56564167,56550427,56564167,111129331,XM_022475627.1,peroxisomal multifunctional enzyme type 2-like,13740
NC_035781.1,13174213,13175515,13174213,13175515,111120783,XM_022461751.1,charged multivesicular body protein 5-like,1302
NC_035781.1,28128763,28132475,28128763,28132475,111122332,XM_022464049.1,sodium-dependent multivitamin transporter-like,3712
NC_035780.1,51489596,51497583,51489596,51497583,111115415,XM_022454140.1,striated muscle-specific serine/threonine-protein kinase-like,7987
NC_035782.1,57829420,57887933,57829420,57887932,111125890,XM_022470113.1,exonuclease mut-7 homolog,58512
NC_035789.1,8470262,8495674,8470262,8495674,111117044,XM_022456109.1,colorectal mutant cancer protein-like,25412
NC_035784.1,62996260,62998263,62996260,62998263,111099221,XM_022430655.1,fucose mutarotase-like,2003
NC_035788.1,80153532,80184907,80153532,80180584,111114899,XM_022453429.1,methylmalonyl-CoA mutase,27052
NC_035788.1,80153532,80184907,80153532,80181345,111114899,XM_022453428.1,methylmalonyl-CoA mutase,27813
NC_035788.1,80153532,80184907,80153532,80184907,111114899,XM_022453426.1,methylmalonyl-CoA mutase,31375
NC_035780.1,63319232,63321221,63319232,63321221,111113622,XM_022451918.1,phosphoacetylglucosamine mutase-like,1989
NC_035787.1,20986739,21006584,20986739,21006584,111108267,XM_022444036.1,proton myo-inositol cotransporter-like,19845
NC_035783.1,2288944,2335243,2288944,2335243,111131555,XM_022479149.1,unconventional myosin-IXb-like,46299
NC_035780.1,61768986,61796642,61774606,61796642,111128885,XM_022474835.1,unconventional myosin-Ia-like,22036
NC_035780.1,61768986,61796642,61773383,61796642,111128885,XM_022474840.1,unconventional myosin-Ia-like,23259
NC_035780.1,61768986,61796642,61768986,61796642,111128885,XM_022474830.1,unconventional myosin-Ia-like,27656
NC_035780.1,64839012,64871279,64840085,64871279,111127765,XM_022473006.1,unconventional myosin-Ia-like,31194
NC_035780.1,64839012,64871279,64839012,64871279,111127765,XM_022473015.1,unconventional myosin-Ia-like,32267
NC_035784.1,60305404,60347051,60305404,60336214,111138125,XM_022489956.1,unconventional myosin-Ic-like,30810
NC_035784.1,60305404,60347051,60305404,60338567,111138125,XM_022489952.1,unconventional myosin-Ic-like,33163
NC_035784.1,60305404,60347051,60305404,60338957,111138125,XM_022489958.1,unconventional myosin-Ic-like,33553
NC_035784.1,60305404,60347051,60305404,60340373,111138125,XM_022489957.1,unconventional myosin-Ic-like,34969
NC_035784.1,60305404,60347051,60305404,60340787,111138125,XM_022489954.1,unconventional myosin-Ic-like,35383
NC_035784.1,60305404,60347051,60305404,60342275,111138125,XM_022489959.1,unconventional myosin-Ic-like,36871
NC_035780.1,2060215,2063945,2060215,2063945,111129336,XM_022475652.1,unconventional myosin-Ic-like,3730
NC_035784.1,60305404,60347051,60305404,60347051,111138125,XM_022489953.1,unconventional myosin-Ic-like,41647
NC_035788.1,90583170,90634293,90583173,90634293,111112126,XM_022449469.1,unconventional myosin-Id-like,51120
NC_035788.1,90583170,90634293,90583172,90634293,111112126,XM_022449468.1,unconventional myosin-Id-like,51121
NC_035788.1,90583170,90634293,90583171,90634293,111112126,XM_022449464.1,unconventional myosin-Id-like,51122
NC_035788.1,90583170,90634293,90583170,90634293,111112126,XM_022449463.1,unconventional myosin-Id-like,51123
NC_035783.1,35389742,35420983,35389742,35411077,111129526,XM_022475980.1,unconventional myosin-Ie-like,21335
NC_035783.1,35389742,35420983,35389742,35420982,111129526,XM_022475981.1,unconventional myosin-Ie-like,31240
NC_035783.1,35389742,35420983,35389742,35420983,111129526,XM_022475979.1,unconventional myosin-Ie-like,31241
NC_035785.1,10633000,10657203,10635341,10657203,111100344,XM_022432105.1,unconventional myosin-VI-like,21862
NC_035785.1,10633000,10657203,10633478,10657203,111100344,XM_022432104.1,unconventional myosin-VI-like,23725
NC_035785.1,10383667,10408269,10384103,10408269,111100288,XM_022431986.1,unconventional myosin-VI-like,24166
NC_035785.1,10633000,10657203,10633000,10657203,111100344,XM_022432103.1,unconventional myosin-VI-like,24203
NC_035785.1,10383667,10408269,10383667,10408269,111100288,XM_022431985.1,unconventional myosin-VI-like,24602
NC_035781.1,1604740,1625632,1610589,1625632,111118925,XM_022458643.1,unconventional myosin-VIIa-like,15043
NC_035781.1,1604740,1625632,1608332,1625632,111118925,XM_022458644.1,unconventional myosin-VIIa-like,17300
NC_035781.1,1604740,1625632,1607765,1625632,111118925,XM_022458641.1,unconventional myosin-VIIa-like,17867
NC_035781.1,2099736,2117786,2099736,2117786,111121714,XM_022463095.1,unconventional myosin-VIIa-like,18050
NC_035781.1,1604740,1625632,1604740,1625632,111118925,XM_022458640.1,unconventional myosin-VIIa-like,20892
NC_035783.1,19983157,20019233,19983160,20019233,111127906,XM_022473214.1,unconventional myosin-VIIb-like,36073
NC_035783.1,19983157,20019233,19983159,20019233,111127906,XM_022473208.1,unconventional myosin-VIIb-like,36074
NC_035788.1,41209759,41279999,41209759,41279998,111111058,XM_022447818.1,unconventional myosin-Va-like,70239
NC_035788.1,41209759,41279999,41209759,41279999,111111058,XM_022447811.1,unconventional myosin-Va-like,70240
NC_035781.1,49433712,49480539,49441956,49480539,111118407,XM_022457862.1,unconventional myosin-XV-like,38583
NC_035781.1,49433712,49480539,49438363,49480539,111118407,XM_022457864.1,unconventional myosin-XV-like,42176
NC_035781.1,48393077,48436128,48393078,48435384,111118026,XM_022457307.1,unconventional myosin-XV-like,42306
NC_035781.1,48393077,48436128,48393077,48435384,111118026,XM_022457297.1,unconventional myosin-XV-like,42307
NC_035781.1,48393077,48436128,48393077,48435385,111118026,XM_022457306.1,unconventional myosin-XV-like,42308
NC_035781.1,48393077,48436128,48393077,48435386,111118026,XM_022457294.1,unconventional myosin-XV-like,42309
NC_035781.1,49433712,49480539,49437645,49480539,111118407,XM_022457860.1,unconventional myosin-XV-like,42894
NC_035781.1,49433712,49480539,49437644,49480539,111118407,XM_022457877.1,unconventional myosin-XV-like,42895
NC_035781.1,49433712,49480539,49437642,49480539,111118407,XM_022457874.1,unconventional myosin-XV-like,42897
NC_035781.1,49433712,49480539,49437641,49480539,111118407,XM_022457873.1,unconventional myosin-XV-like,42898
NC_035781.1,49433712,49480539,49437640,49480539,111118407,XM_022457871.1,unconventional myosin-XV-like,42899
NC_035781.1,48393077,48436128,48393077,48436128,111118026,XM_022457293.1,unconventional myosin-XV-like,43051
NC_035781.1,49433712,49480539,49436913,49480539,111118407,XM_022457863.1,unconventional myosin-XV-like,43626
NC_035781.1,49433712,49480539,49433712,49480539,111118407,XM_022457861.1,unconventional myosin-XV-like,46827
NC_035784.1,18612707,18659117,18629354,18659117,111136109,XM_022486725.1,unconventional myosin-XVIIIa-like,29763
NC_035784.1,18612707,18659117,18625763,18659117,111136109,XM_022486721.1,unconventional myosin-XVIIIa-like,33354
NC_035784.1,18612707,18659117,18620681,18659117,111136109,XM_022486724.1,unconventional myosin-XVIIIa-like,38436
NC_035784.1,18612707,18659117,18620360,18659117,111136109,XM_022486723.1,unconventional myosin-XVIIIa-like,38757
NC_035784.1,19181265,19237071,19181265,19221384,111136524,XM_022487436.1,unconventional myosin-XVIIIa-like,40119
NC_035784.1,19181265,19237071,19181265,19226858,111136524,XM_022487433.1,unconventional myosin-XVIIIa-like,45593
NC_035784.1,19181265,19237071,19181265,19226861,111136524,XM_022487432.1,unconventional myosin-XVIIIa-like,45596
NC_035784.1,18612707,18659117,18612707,18659117,111136109,XM_022486717.1,unconventional myosin-XVIIIa-like,46410
NC_035788.1,3394526,3399228,3394527,3399227,111116029,XM_022454994.1,unconventional myosin-XVIIIa-like,4700
NC_035788.1,3394526,3399228,3394526,3399228,111116029,XM_022454995.1,unconventional myosin-XVIIIa-like,4702
NC_035784.1,19181265,19237071,19181265,19229074,111136524,XM_022487435.1,unconventional myosin-XVIIIa-like,47809
NC_035784.1,19181265,19237071,19181265,19237070,111136524,XM_022487431.1,unconventional myosin-XVIIIa-like,55805
NC_035784.1,19181265,19237071,19181265,19237071,111136524,XM_022487428.1,unconventional myosin-XVIIIa-like,55806
NC_035784.1,61246235,61280384,61246235,61280384,111134568,XM_022483699.1,protein naked cuticle homolog 2-like,34149
NC_035780.1,39644344,39655089,39644344,39655089,111107444,XM_022442657.1,atrial natriuretic peptide receptor 1-like,10745
NC_035783.1,35688890,35706229,35688890,35706229,111128034,XM_022473423.1,neuron navigator 3-like,17339
NC_035783.1,50153505,50160379,50153505,50160379,111131787,XM_022479491.1,crooked neck-like protein 1,6874
NC_035782.1,35977244,35988215,35977244,35988215,111125492,XM_022469395.1,tumor necrosis factor receptor superfamily member 16-like,10971
NC_035781.1,30399879,30405193,30399879,30405193,111118451,XM_022457944.1,tubulointerstitial nephritis antigen-like,5314
NC_035784.1,14322633,14351553,14322633,14351553,111134353,XM_022483301.1,putative neural-cadherin 2,28920
NC_035784.1,72489894,72509335,72489894,72502972,111135108,XM_022484846.1,protein neuralized-like,13078
NC_035784.1,72489894,72509335,72489894,72504577,111135108,XM_022484845.1,protein neuralized-like,14683
NC_035784.1,72489894,72509335,72489894,72509335,111135108,XM_022484847.1,protein neuralized-like,19441
NC_035780.1,15575193,15587981,15575193,15587981,111125267,XM_022468907.1,motor neuron and pancreas homeobox protein 1-like,12788
NC_035782.1,41051333,41055128,41051333,41055128,111125418,XM_022469203.1,ceroid-lipofuscinosis neuronal protein 5-like,3795
NC_035781.1,41925315,41927608,41925315,41927608,111121387,XM_022462654.1,putative neuropeptide Y receptor type 6,2293
NC_035784.1,87609487,87619565,87609489,87619565,111133878,XM_022482584.1,APGW-amide-related neuropeptide-like,10076
NC_035784.1,87609487,87619565,87609487,87619565,111133878,XM_022482585.1,APGW-amide-related neuropeptide-like,10078
NC_035780.1,40375909,40386796,40375909,40386796,111113216,XM_022451320.1,myomodulin neuropeptides 2-like,10887
NC_035780.1,34838303,34843698,34838303,34843698,111122611,XM_022464465.1,FMRF-amide neuropeptides-like,5395
NC_035780.1,49425687,49432783,49425687,49432783,111119307,XM_022459365.1,FMRF-amide neuropeptides-like,7096
NC_035780.1,47672167,47680282,47672167,47680282,111103730,XM_022437174.1,FMRF-amide neuropeptides-like,8115
NC_035780.1,7429515,7437794,7429515,7437794,111110267,XM_022446692.1,FMRF-amide neuropeptides-like,8279
NC_035781.1,29294554,29303633,29294554,29303633,111121983,XM_022463486.1,sodium-coupled neutral amino acid transporter 9-like,9079
NC_035780.1,61125830,61140417,61125830,61140417,111100168,XM_022431820.1,sorting nexin-10-like,14587
NC_035788.1,60659913,60689838,60659913,60689838,111112703,XM_022450431.1,sorting nexin-13-like,29925
NC_035780.1,46845428,46871436,46845428,46871436,111133196,XM_022481341.1,sorting nexin-14-like,26008
NC_035784.1,29353807,29359934,29354076,29359934,111136832,XM_022487956.1,sorting nexin-16-like,5858
NC_035784.1,29353807,29359934,29353807,29359934,111136832,XM_022487955.1,sorting nexin-16-like,6127
NC_035780.1,26772151,26795420,26772151,26795420,111112096,XM_022449785.1,sorting nexin-17-like,23269
NC_035781.1,53474299,53490876,53474299,53490876,111120575,XM_022461381.1,sorting nexin-19-like,16577
NC_035783.1,22928045,22935240,22928045,22935240,111131214,XM_022478635.1,sorting nexin-2-like,7195
NC_035784.1,36845191,36847261,36845191,36847261,111133489,XM_022481942.1,sorting nexin-20-like,2070
NC_035783.1,26217971,26232477,26217971,26232474,111131114,XM_022478489.1,sorting nexin-24-like,14503
NC_035783.1,27162170,27168570,27162170,27168570,111128749,XM_022474577.1,sorting nexin-24-like,6400
NC_035782.1,26929054,26942150,26929054,26942150,111127480,XM_022472672.1,sorting nexin-25-like,13096
NC_035782.1,26955447,27226612,26955447,26970647,111123257,XM_022465485.1,sorting nexin-25-like,15200
NC_035782.1,26955447,27226612,26955447,26973275,111123257,XM_022465488.1,sorting nexin-25-like,17828
NC_035782.1,26955447,27226612,26955447,26974371,111123257,XM_022465487.1,sorting nexin-25-like,18924
NC_035782.1,26955447,27226612,26955447,27226612,111123257,XM_022465486.1,sorting nexin-25-like,271165
NC_035783.1,36289309,36305981,36289309,36305981,111130418,XM_022477491.1,sorting nexin-27-like,16672
NC_035781.1,56717776,56732980,56717776,56732980,111119744,XM_022460200.1,sorting nexin-29-like,15204
NC_035781.1,57146640,57164102,57146640,57164102,111119948,XM_022460533.1,sorting nexin-29-like,17462
NC_035785.1,585014,589968,585014,588237,111101256,XM_022433691.1,sorting nexin-3-like,3223
NC_035785.1,585014,589968,585014,589968,111101256,XM_022433690.1,sorting nexin-3-like,4954
NC_035781.1,44591181,44597463,44591181,44597463,111122404,XM_022464187.1,sorting nexin-30-like,6282
NC_035781.1,43944231,43952852,43944231,43952852,111118122,XM_022457437.1,sorting nexin-30-like,8621
NC_035780.1,27329123,27357492,27329123,27350191,111135967,XM_022486529.1,sorting nexin-33-like,21068
NC_035780.1,27329123,27357492,27329123,27350192,111135967,XM_022486505.1,sorting nexin-33-like,21069
NC_035780.1,27329123,27357492,27329123,27357492,111135967,XM_022486486.1,sorting nexin-33-like,28369
NC_035780.1,32442550,32450480,32442550,32450480,111112925,XM_022450815.1,sorting nexin-4-like,7930
NC_035782.1,64846950,64853804,64846950,64853804,111122995,XM_022465065.1,sorting nexin-5-like,6854
NC_035783.1,25252328,25258064,25252328,25256221,111130157,XM_022476904.1,sorting nexin-6-like,3893
NC_035783.1,25252328,25258064,25252328,25258064,111130157,XM_022476903.1,sorting nexin-6-like,5736
NC_035781.1,10826951,10838401,10826951,10838401,111118911,XM_022458623.1,sorting nexin-8-like,11450
NC_035783.1,8831038,8845385,8831038,8845385,111129275,XM_022475555.1,egl nine homolog 3-like,14347
NC_035784.1,30557681,30562768,30557681,30562768,111135397,XM_022485425.1,sucrose non-fermenting protein kinase 1-like,5087
NC_035784.1,42781543,42786769,42781543,42786769,111133834,XM_022482525.1,sigma non-opioid intracellular receptor 1-like,5226
NC_035780.1,63937823,63952401,63937823,63952401,111109369,XM_022445466.1,cytosolic non-specific dipeptidase-like,14578
NC_035780.1,56877394,56883871,56877394,56883871,111108192,XM_022443863.1,heterogeneous nuclear ribonucleoprotein A1,6477
NC_035780.1,1547067,1548720,1547067,1548720,111103592,XM_022436969.1,putative nuclease HARBI1,1653
NC_035782.1,55656871,55659450,55656871,55659450,111124317,XM_022467169.1,ice nucleation protein-like,2579
NC_035783.1,8585423,8587754,8585423,8587754,111130503,XM_022477645.1,nuclear nucleic acid-binding protein C1D-like,2331
NC_035783.1,57157745,57161131,57157745,57161131,111129788,XM_022476246.1,lysine-rich nucleolar protein 1-like,3386
NC_035781.1,25953102,25958739,25953102,25958739,111122117,XM_022463701.1,probable nucleoredoxin 1,5637
NC_035783.1,10263326,10275955,10263326,10275955,111130838,XM_022478081.1,equilibrative nucleoside transporter 1-like,12629
NC_035783.1,40744581,40749974,40744581,40749967,111128130,XM_022473592.1,cancer-related nucleoside-triphosphatase-like,5386
NC_035783.1,40744581,40749974,40744581,40749974,111128130,XM_022473593.1,cancer-related nucleoside-triphosphatase-like,5393
NC_035781.1,23511065,23517969,23511065,23517969,111118380,XM_022457820.1,guanine nucleotide exchange C9orf72-like,6904
NC_035780.1,44862460,44864983,44862460,44864983,111134379,XM_022483346.1,guanine nucleotide-binding protein G(s) subunit alpha-like,2523
NC_035784.1,73649728,73660644,73649728,73660644,111137077,XM_022488326.1,pyridine nucleotide-disulfide oxidoreductase domain-containing protein 2-like,10916
NC_035782.1,61176597,61195658,61176597,61195658,111122902,XM_022464936.1,cyclic nucleotide-gated cation channel alpha-3-like,19061
NC_035783.1,17489757,17503262,17489757,17503262,111131750,XM_022479421.1,polyribonucleotide nucleotidyltransferase 1,13505
NC_035783.1,25529233,25546465,25529233,25543604,111129125,XM_022475262.1,protein numb-like,14371
NC_035783.1,25529233,25546465,25529233,25546465,111129125,XM_022475260.1,protein numb-like,17232
NC_035782.1,66697398,66698671,66697398,66698671,111127334,XM_022472463.1,cell number regulator 3-like,1273
NC_035786.1,10023401,10039127,10023401,10039127,111104421,XM_022438355.1,sine oculis-binding protein homolog,15726
NC_035780.1,44069755,44073644,44069755,44073644,111103119,XM_022436168.1,protein odd-skipped-related 1-like,3889
NC_035780.1,8052589,8056490,8052589,8056490,111137407,XM_022488858.1,mediator of RNA polymerase II transcription subunit 30-like,3901
NC_035780.1,38879838,38881858,38879838,38881858,111114454,XM_022452755.1,myelin-associated oligodendrocyte basic protein-like,2020
NC_035781.1,9346594,9363798,9346594,9363798,111121659,XM_022463022.1,conserved oligomeric Golgi complex subunit 3-like,17204
NC_035781.1,61307279,61317423,61307279,61317423,111122414,XM_022464203.1,thimet oligopeptidase-like,10144
NC_035781.1,16103064,16112914,16103064,16112914,111117774,XM_022457016.1,thimet oligopeptidase-like,9850
NC_035783.1,30140290,30154528,30140290,30154528,111128451,XM_022474063.1,phylloquinone omega-hydroxylase CYP4F2-like,14238
NC_035780.1,30606426,30611607,30606426,30611607,111137315,XM_022488749.1,FGFR1 oncogene partner 2 homolog,5181
NC_035784.1,38389775,38409849,38389775,38409849,111133992,XM_022482736.1,ski oncogene-like,20074
NC_035780.1,341638,349379,341638,349379,111113503,XM_022451800.1,F-box only protein 47-like,7741
NC_035780.1,34630994,34651084,34630994,34651084,111104186,XM_022438013.1,kappa-type opioid receptor-like,20090
NC_035780.1,58150257,58155350,58150257,58155350,111135668,XM_022485939.1,MKRN2 opposite strand protein-like,5093
NC_035781.1,54475200,54487289,54475200,54487289,111120090,XM_022460761.1,DNA-(apurinic or apyrimidinic site) lyase-like,12089
NC_035783.1,37183428,37200541,37183428,37200541,111129839,XM_022476323.1,digestive organ expansion factor homolog,17113
NC_035784.1,4638697,4644749,4638698,4644749,111135059,XM_022484763.1,mitotic-spindle organizing protein 2-like,6051
NC_035782.1,12690288,12704338,12690288,12704338,111126622,XM_022471385.1,mitochondrial ornithine transporter 1-like,14050
NC_035781.1,11242951,11274280,11259543,11274264,111122066,XM_022463618.1,protein outspread-like,14721
NC_035781.1,11242951,11274280,11258223,11274265,111122066,XM_022463617.1,protein outspread-like,16042
NC_035781.1,11242951,11274280,11242951,11274276,111122066,XM_022463619.1,protein outspread-like,31325
NC_035781.1,11242951,11274280,11242951,11274277,111122066,XM_022463614.1,protein outspread-like,31326
NC_035781.1,11242951,11274280,11242951,11274278,111122066,XM_022463612.1,protein outspread-like,31327
NC_035781.1,11242951,11274280,11242951,11274279,111122066,XM_022463611.1,protein outspread-like,31328
NC_035781.1,11242951,11274280,11242951,11274280,111122066,XM_022463609.1,protein outspread-like,31329
NC_035783.1,42567933,42595311,42567933,42595311,111130217,XM_022477000.1,MAPK/MAK/MRK overlapping kinase-like,27378
NC_035780.1,43467529,43477166,43467529,43477166,111128645,XM_022474399.1,dual oxidase maturation factor 1-like,9637
NC_035780.1,47737553,47742234,47737553,47742185,111119097,XM_022458926.1,alternative oxidase,4632
NC_035780.1,47737553,47742234,47737553,47742234,111119097,XM_022458936.1,alternative oxidase,4681
NC_035780.1,49506871,49513057,49506885,49513051,111119236,XM_022459221.1,alternative oxidase,6166
NC_035780.1,49506871,49513057,49506871,49513057,111119236,XM_022459230.1,alternative oxidase,6186
NC_035780.1,13090169,13101223,13090169,13101223,111113709,XM_022452002.1,prenylcysteine oxidase-like,11054
NC_035784.1,65683050,65694931,65683050,65694931,111134260,XM_022483150.1,spermine oxidase-like,11881
NC_035783.1,43299006,43300299,43299006,43300299,111130859,XM_022478116.1,L-ascorbate oxidase-like,1293
NC_035784.1,17938013,17951346,17938013,17951346,111136234,XM_022486939.1,D-aspartate oxidase-like,13333
NC_035788.1,70337026,70354376,70337026,70354376,111110787,XM_022447401.1,L-ascorbate oxidase-like,17350
NC_035788.1,71687795,71705811,71687795,71705230,111114596,XM_022452971.1,pyridoxine-5'-phosphate oxidase-like,17435
NC_035788.1,71687795,71705811,71687795,71705811,111114596,XM_022452972.1,pyridoxine-5'-phosphate oxidase-like,18016
NC_035780.1,58423741,58425615,58423741,58425615,111108242,XM_022443996.1,spermine oxidase-like,1874
NC_035783.1,43226887,43229266,43226887,43229266,111131417,XM_022478928.1,L-ascorbate oxidase-like,2379
NC_035788.1,70067500,70091627,70067500,70091627,111110785,XM_022447399.1,L-ascorbate oxidase-like,24127
NC_035780.1,46524845,46553587,46524845,46549375,111136982,XM_022488196.1,dual oxidase-like,24530
NC_035780.1,46524845,46553587,46524845,46553587,111136982,XM_022488192.1,dual oxidase-like,28742
NC_035783.1,43025077,43055594,43025077,43055594,111129818,XM_022476278.1,L-ascorbate oxidase-like,30517
NC_035782.1,56859771,56863329,56859771,56863329,111126384,XM_022470978.1,sulfite oxidase-like,3558
NC_035780.1,43475950,43517509,43477200,43517509,111128630,XM_022474378.1,dual oxidase-like,40309
NC_035780.1,43475950,43517509,43475950,43517509,111128630,XM_022474372.1,dual oxidase-like,41559
NC_035780.1,33000946,33005188,33000946,33005188,111099851,XM_022431325.1,L-ascorbate oxidase-like,4242
NC_035784.1,44965134,45009995,44965134,45009995,111133449,XM_022481882.1,D-aspartate oxidase-like,44861
NC_035781.1,27997056,28002935,27997056,28001573,111118058,XM_022457349.1,D-aspartate oxidase-like,4517
NC_035781.1,29105000,29110537,29105000,29109630,111122379,XM_022464142.1,D-amino-acid oxidase-like,4630
NC_035782.1,42165844,42170583,42165844,42170583,111127563,XM_022472783.1,lathosterol oxidase-like,4739
NC_035781.1,28009906,28015113,28009906,28015113,111118061,XM_022457351.1,D-amino-acid oxidase-like,5207
NC_035781.1,27997056,28002935,27997057,28002392,111118058,XM_022457347.1,D-aspartate oxidase-like,5335
NC_035781.1,29105000,29110537,29105000,29110537,111122379,XM_022464141.1,D-amino-acid oxidase-like,5537
NC_035781.1,28003494,28009058,28003494,28009058,111118059,XM_022457350.1,D-amino-acid oxidase-like,5564
NC_035781.1,29098702,29104429,29098702,29104429,111122381,XM_022464144.1,D-aspartate oxidase-like,5727
NC_035781.1,27997056,28002935,27997057,28002935,111118058,XM_022457348.1,D-aspartate oxidase-like,5878
NC_035783.1,51430603,51436532,51430603,51436532,111131632,XM_022479251.1,N-methyl-L-tryptophan oxidase-like,5929
NC_035780.1,58401569,58407797,58401569,58407797,111112602,XM_022450178.1,spermine oxidase-like,6228
NC_035787.1,44205610,44214961,44205610,44211982,111108560,XM_022444547.1,D-amino-acid oxidase-like,6372
NC_035783.1,51437956,51445792,51437956,51444501,111131631,XM_022479250.1,N-methyl-L-tryptophan oxidase-like,6545
NC_035783.1,51437956,51445792,51437957,51444598,111131631,XM_022479247.1,N-methyl-L-tryptophan oxidase-like,6641
NC_035783.1,43234007,43240924,43234007,43240924,111130542,XM_022477691.1,L-ascorbate oxidase-like,6917
NC_035785.1,36144724,36151669,36144724,36151669,111099584,XM_022430906.1,protoporphyrinogen oxidase-like,6945
NC_035787.1,44205610,44214961,44205610,44212960,111108560,XM_022444544.1,D-amino-acid oxidase-like,7350
NC_035783.1,51437956,51445792,51437956,51445792,111131631,XM_022479249.1,N-methyl-L-tryptophan oxidase-like,7836
NC_035784.1,17952906,17961244,17952906,17961244,111136235,XM_022486940.1,D-aspartate oxidase-like,8338
NC_035781.1,29111702,29120733,29111702,29120733,111122380,XM_022464143.1,D-amino-acid oxidase-like,9031
NC_035788.1,66353649,66362932,66353649,66362932,111114966,XM_022453506.1,L-ascorbate oxidase-like,9283
NC_035787.1,44205610,44214961,44205610,44214960,111108560,XM_022444545.1,D-amino-acid oxidase-like,9350
NC_035787.1,44205610,44214961,44205610,44214961,111108560,XM_022444546.1,D-amino-acid oxidase-like,9351
NC_035780.1,10840847,10851926,10840847,10851926,111120324,XM_022461050.1,nitric oxide synthase-interacting protein-like,11079
NC_035784.1,73201110,73205867,73201110,73205867,111132873,XM_022480787.1,nitric oxide-associated protein 1-like,4757
NC_035781.1,10560197,10583134,10560197,10583134,111119864,XM_022460409.1,FAD-dependent oxidoreductase domain-containing protein 2-like,22937
NC_035789.1,8497822,8507068,8497822,8507068,111117314,XM_022456377.1,sulfide:quinone oxidoreductase,9246
NC_035781.1,30933974,30943418,30933974,30943418,111119152,XM_022459023.1,NADPH:adrenodoxin oxidoreductase,9444
NC_035786.1,49368186,49372080,49368186,49372080,111105250,XM_022439424.1,quinone oxidoreductase-like protein 1,3894
NC_035782.1,52290354,52293095,52290354,52293095,111124473,XM_022467339.1,quinone oxidoreductase-like,2741
NC_035782.1,52312118,52316390,52312577,52316390,111124472,XM_022467336.1,quinone oxidoreductase-like,3813
NC_035782.1,52312118,52316390,52312222,52316390,111124472,XM_022467338.1,quinone oxidoreductase-like,4168
NC_035782.1,52312118,52316390,52312118,52316390,111124472,XM_022467337.1,quinone oxidoreductase-like,4272
NC_035780.1,50041490,50045337,50041490,50045337,111123433,XM_022465749.1,xylosyltransferase oxt-like,3847
NC_035783.1,18047498,18056335,18047498,18056335,111129970,XM_022476535.1,ribosomal oxygenase 1-like,8837
NC_035782.1,55142818,55145183,55142818,55145183,111127562,XM_022472782.1,inositol oxygenase-like,2365
NC_035782.1,39783427,39797726,39783427,39797726,111124804,XM_022467994.1,MAGUK p55 subfamily member 6-like,14299
NC_035788.1,15054251,15064868,15054251,15064742,111115460,XM_022454212.1,nucleoporin p58/p45-like,10491
NC_035788.1,15054251,15064868,15054251,15064749,111115460,XM_022454211.1,nucleoporin p58/p45-like,10498
NC_035788.1,15054251,15064868,15054251,15064868,111115460,XM_022454209.1,nucleoporin p58/p45-like,10617
NC_035785.1,34735549,34748592,34735549,34748463,111101470,XM_022433975.1,nucleoporin p58/p45-like,12914
NC_035785.1,34735549,34748592,34735549,34748465,111101470,XM_022433976.1,nucleoporin p58/p45-like,12916
NC_035785.1,34735549,34748592,34735549,34748592,111101470,XM_022433973.1,nucleoporin p58/p45-like,13043
NC_035783.1,44387783,44404973,44387783,44404973,111129265,XM_022475535.1,katanin p60 ATPase-containing subunit A-like 2,17190
NC_035783.1,25219296,25236019,25219296,25236019,111129643,XM_022476103.1,katanin p80 WD40 repeat-containing subunit B1-like,16723
NC_035782.1,50222717,50236685,50222717,50236685,111124614,XM_022467641.1,Golgi pH regulator-like,13968
NC_035781.1,10536057,10543663,10536057,10543663,111119881,XM_022460448.1,probable palmitoyltransferase ZDHHC4,7606
NC_035780.1,29352775,29360644,29352775,29360644,111110565,XM_022447122.1,inactive pancreatic lipase-related protein 1-like,7869
NC_035781.1,37237020,37279014,37237020,37279014,111118586,XM_022458131.1,protein pangolin,41994
NC_035782.1,58628083,58648644,58628083,58648644,111125210,XM_022468767.1,serum paraoxonase/arylesterase 1-like,20561
NC_035782.1,58654999,58674194,58654999,58674194,111125211,XM_022468768.1,serum paraoxonase/lactonase 3-like,19195
NC_035781.1,3729978,3735200,3729978,3735200,111122160,XM_022463762.1,chromosome partition protein Smc-like,5222
NC_035784.1,7783915,7797675,7783915,7797675,111135872,XM_022486304.1,lipoma-preferred partner homolog,13760
NC_035781.1,4949654,4955273,4949654,4955273,111119646,XM_022460047.1,PCNA-interacting partner-like,5619
NC_035780.1,9429809,9431700,9429809,9431700,111118051,XM_022457342.1,G patch domain-containing protein 11-like,1891
NC_035781.1,16080924,16096513,16080924,16096513,111120833,XM_022461825.1,protein patched homolog 1-like,15589
NC_035784.1,83086361,83088804,83086361,83088804,111132808,XM_022480649.1,glioma pathogenesis-related protein 1-like,2443
NC_035782.1,71122580,71135694,71122580,71135694,111126687,XM_022471499.1,WNT1-inducible-signaling pathway protein 1-like,13114
NC_035783.1,11971628,11992551,11971628,11992551,111129898,XM_022476417.1,protein pellino-like,20923
NC_035784.1,37127549,37133327,37127549,37133327,111132883,XM_022480805.1,protein pelota-like,5778
NC_035782.1,24497688,24504957,24497688,24504957,111125474,XM_022469358.1,caseinolytic peptidase B protein homolog,7269
NC_035784.1,58237900,58251325,58237900,58251325,111132971,XM_022480958.1,leishmanolysin-like peptidase,13425
NC_035783.1,18164197,18173104,18164197,18169403,111129831,XM_022476305.1,leishmanolysin-like peptidase,5206
NC_035783.1,18164197,18173104,18164197,18173104,111129831,XM_022476306.1,leishmanolysin-like peptidase,8907
NC_035786.1,50200051,50203580,50200233,50203580,111102548,XM_022435340.1,kyphoscoliosis peptidase-like,3347
NC_035786.1,50200051,50203580,50200207,50203580,111102548,XM_022435338.1,kyphoscoliosis peptidase-like,3373
NC_035785.1,50452851,50456275,50452851,50456275,111100134,XM_022431759.1,kyphoscoliosis peptidase-like,3424
NC_035786.1,50876876,50880409,50876876,50880306,111102422,XM_022435128.1,kyphoscoliosis peptidase-like,3430
NC_035786.1,50200051,50203580,50200051,50203580,111102548,XM_022435339.1,kyphoscoliosis peptidase-like,3529
NC_035786.1,50876876,50880409,50876876,50880409,111102422,XM_022435129.1,kyphoscoliosis peptidase-like,3533
NC_035784.1,83304996,83309399,83304996,83309399,111133983,XM_022482727.1,kyphoscoliosis peptidase-like,4403
NC_035783.1,31440276,31444852,31440276,31444852,111128824,XM_022474713.1,kyphoscoliosis peptidase-like,4576
NC_035783.1,31225840,31230665,31225840,31230665,111128740,XM_022474555.1,kyphoscoliosis peptidase-like,4825
NC_035785.1,25600651,25605729,25600651,25605729,111101600,XM_022434133.1,kyphoscoliosis peptidase-like,5078
NC_035783.1,27972385,27977475,27972385,27977475,111129587,XM_022476042.1,kyphoscoliosis peptidase-like,5090
NC_035785.1,35932433,35937602,35932440,35937601,111101480,XM_022433989.1,kyphoscoliosis peptidase-like,5161
NC_035785.1,35932433,35937602,35932433,35937602,111101480,XM_022433988.1,kyphoscoliosis peptidase-like,5169
NC_035784.1,93007059,93012866,93007059,93012866,111132169,XM_022479929.1,kyphoscoliosis peptidase-like,5807
NC_035781.1,56663233,56672173,56663233,56672173,111120417,XM_022461131.1,kyphoscoliosis peptidase-like,8940
NC_035781.1,57092955,57102346,57092955,57102346,111119978,XM_022460576.1,kyphoscoliosis peptidase-like,9391
NC_035783.1,18172879,18176803,18172879,18176803,111129832,XM_022476307.1,isoaspartyl peptidase/L-asparaginase-like,3924
NC_035780.1,12743659,12745213,12743659,12745213,111105902,XM_022440365.1,formyl peptide receptor-related sequence 4-like,1554
NC_035782.1,54998087,55009979,54998087,55009979,111123517,XM_022465909.1,signal peptide,11892
NC_035780.1,7933283,7961895,7933283,7961895,111099410,XM_022430691.1,signal peptide,28612
NC_035782.1,67027703,67028122,67027703,67028122,111124390,XM_022467241.1,signal peptide,419
NC_035782.1,18681288,18687530,18681288,18687530,111124825,XM_022468034.1,signal peptide,6242
NC_035781.1,43793122,43817291,43793122,43817288,111120969,XM_022462043.1,tachykinin-like peptides receptor 99D,24166
NC_035782.1,16600835,16604168,16600835,16604168,111124977,XM_022468349.1,putative peptidyl-prolyl cis-trans isomerase dodo,3333
NC_035780.1,44507830,44509294,44507830,44509294,111110602,XM_022447170.1,putative peptidyl-tRNA hydrolase PTRHD1,1464
NC_035783.1,22128072,22133105,22128072,22133105,111129827,XM_022476302.1,probable peptidylglycine alpha-hydroxylating monooxygenase 1,5033
NC_035784.1,14062832,14075921,14062832,14075921,111133911,XM_022482645.1,bactericidal permeability-increasing protein-like,13089
NC_035783.1,8552562,8566420,8552562,8566420,111130391,XM_022477427.1,circularly permutated Ras protein 1-like,13858
NC_035781.1,8428235,8437432,8428235,8437432,111118223,XM_022457562.1,glutathione peroxidase 7-like,9197
NC_035786.1,7703304,7713319,7703304,7713319,111103693,XM_022437127.1,chorion peroxidase-like,10015
NC_035788.1,76243311,76255132,76243311,76255132,111110753,XM_022447367.1,thyroid peroxidase-like,11821
NC_035781.1,22582074,22596479,22582074,22596479,111120183,XM_022460911.1,glutathione peroxidase-like,14405
NC_035784.1,41116558,41118456,41116558,41118456,111137147,XM_022488461.1,glutathione peroxidase-like,1898
NC_035781.1,14351262,14353399,14351262,14353399,111120554,XM_022461355.1,glutathione peroxidase-like,2137
NC_035781.1,22718395,22740603,22718395,22740391,111120666,XM_022461562.1,glutathione peroxidase-like,21996
NC_035781.1,22718395,22740603,22718395,22740603,111120666,XM_022461561.1,glutathione peroxidase-like,22208
NC_035786.1,23743782,23748401,23743782,23748401,111104943,XM_022439120.1,chorion peroxidase-like,4619
NC_035786.1,26754847,26761733,26754847,26761733,111104184,XM_022437997.1,chorion peroxidase-like,6886
NC_035785.1,25392438,25399538,25392438,25399538,111101744,XM_022434339.1,thyroid peroxidase-like,7100
NC_035786.1,27472782,27481709,27472782,27481709,111103001,XM_022435975.1,chorion peroxidase-like,8927
NC_035781.1,15633846,15636934,15633846,15636934,111122059,XM_022463595.1,probable peroxisomal membrane protein PEX13,3088
NC_035781.1,43494509,43496010,43494509,43496010,111121885,XM_022463359.1,anterior pharynx in excess protein 1-like,1501
NC_035783.1,57906897,57934776,57906897,57934776,111128972,XM_022474953.1,S phase cyclin A-associated protein in the endoplasmic reticulum-like,27879
NC_035781.1,26379291,26391881,26379291,26391881,111121232,XM_022462403.1,G2/M phase-specific E3 ubiquitin-protein ligase-like,12590
NC_035780.1,315522,340261,315522,340261,111133260,XM_022481470.1,tyrosine-protein phosphatase non-receptor type 5-like,24739
NC_035784.1,8115864,8120848,8115864,8120848,111134904,XM_022484442.1,alkaline phosphatase,4984
NC_035784.1,13003732,13010549,13003732,13010549,111135358,XM_022485339.1,alkaline phosphatase,6817
NC_035784.1,57626641,57634002,57626641,57634002,111133932,XM_022482675.1,alkaline phosphatase,7361
NC_035784.1,8329867,8338603,8329867,8338603,111135544,XM_022485696.1,proline-serine-threonine phosphatase-interacting protein 2-like,8736
NC_035786.1,3163211,3184012,3163211,3184012,111103191,XM_022436264.1,polyphosphoinositide phosphatase-like,20801
NC_035786.1,2993944,3015549,2993944,3015549,111103190,XM_022436262.1,polyphosphoinositide phosphatase-like,21605
NC_035786.1,6201526,6223362,6201526,6223362,111104803,XM_022438943.1,polyphosphoinositide phosphatase-like,21836
NC_035786.1,43609459,43612684,43609459,43612684,111102575,XM_022435378.1,glycerol-3-phosphate phosphatase-like,3225
NC_035786.1,41815364,41818597,41815364,41818597,111102687,XM_022435536.1,glycerol-3-phosphate phosphatase-like,3233
NC_035787.1,49955579,49959195,49955579,49958899,111106299,XM_022440915.1,phosphoserine phosphatase-like,3320
NC_035787.1,49955579,49959195,49955579,49958994,111106299,XM_022440919.1,phosphoserine phosphatase-like,3415
NC_035787.1,49955579,49959195,49955579,49959145,111106299,XM_022440920.1,phosphoserine phosphatase-like,3566
NC_035787.1,49955579,49959195,49955579,49959167,111106299,XM_022440918.1,phosphoserine phosphatase-like,3588
NC_035787.1,49955579,49959195,49955579,49959195,111106299,XM_022440916.1,phosphoserine phosphatase-like,3616
NC_035786.1,41821341,41825534,41821341,41825047,111102686,XM_022435533.1,glycerol-3-phosphate phosphatase-like,3706
NC_035786.1,43603323,43607100,43603323,43607100,111102576,XM_022435379.1,glycerol-3-phosphate phosphatase-like,3777
NC_035786.1,41821341,41825534,41821342,41825534,111102686,XM_022435534.1,glycerol-3-phosphate phosphatase-like,4192
NC_035784.1,13016340,13021281,13016340,13021281,111135356,XM_022485336.1,alkaline phosphatase-like,4941
NC_035784.1,60398557,60405941,60398557,60405941,111138128,XM_022489962.1,alkaline phosphatase-like,7384
NC_035782.1,18293826,18303200,18293826,18303200,111127456,XM_022472636.1,alkaline phosphatase-like,9374
NC_035781.1,10037767,10063089,10037767,10063089,111121542,XM_022462862.1,phospholipid phosphatase-related protein type 5-like,25322
NC_035780.1,32255479,32272717,32255479,32272717,111125544,XM_022469505.1,sodium-dependent phosphate transporter 1-A-like,17238
NC_035782.1,57825645,57829521,57825645,57829500,111125897,XM_022470121.1,dolichol phosphate-mannose biosynthesis regulatory protein-like,3855
NC_035782.1,51397684,51415043,51397684,51415043,111126661,XM_022471449.1,7-methylguanosine phosphate-specific 5'-nucleotidase A-like,17359
NC_035781.1,11562701,11576620,11562701,11576620,111121235,XM_022462407.1,cytoplasmic phosphatidylinositol transfer protein 1-like,13919
NC_035781.1,56253558,56265713,56253558,56265713,111122410,XM_022464196.1,5-phosphohydroxy-L-lysine phospho-lyase-like,12155
NC_035781.1,59018432,59033384,59018432,59033384,111122045,XM_022463572.1,5-phosphohydroxy-L-lysine phospho-lyase-like,14952
NC_035781.1,26687949,26705616,26687949,26705616,111120839,XM_022461832.1,5-phosphohydroxy-L-lysine phospho-lyase-like,17667
NC_035780.1,33511575,33517372,33511575,33517372,111099174,XM_022430594.1,zinc phosphodiesterase ELAC protein 1-like,5797
NC_035784.1,10961518,10971196,10961518,10971196,111132893,XM_022480820.1,sphingomyelin phosphodiesterase-like,9678
NC_035782.1,23261406,23271473,23261406,23271473,111125840,XM_022470022.1,ceramide phosphoethanolamine synthase-like,10067
NC_035785.1,31734545,31738594,31734545,31738594,111100351,XM_022432119.1,probable phosphoglycerate mutase,4049
NC_035780.1,28346928,28390998,28346928,28390998,111128016,XM_022473385.1,inactive phospholipase C-like protein 2,44070
NC_035782.1,24463457,24488637,24463457,24488637,111123673,XM_022466174.1,probable phospholipid-transporting ATPase VD,25180
NC_035784.1,8382728,8386475,8382728,8386475,111099182,XM_022430592.1,phosphoenolpyruvate phosphomutase,3747
NC_035783.1,22920724,22927109,22920724,22927109,111129996,XM_022476575.1,cAMP-regulated phosphoprotein 19-A-like,6385
NC_035783.1,50210023,50227160,50210023,50227160,111128766,XM_022474604.1,vasodilator-stimulated phosphoprotein-like,17137
NC_035783.1,19450707,19453015,19450707,19453015,111129346,XM_022475669.1,E2F-associated phosphoprotein-like,2308
NC_035786.1,34726874,34731640,34726874,34731640,111105531,XM_022439879.1,uracil phosphoribosyltransferase homolog,4766
NC_035787.1,61637229,61648066,61637229,61648066,111109680,XM_022445898.1,nicotinamide phosphoribosyltransferase-like,10837
NC_035780.1,42928456,42944313,42928456,42943785,111134404,XM_022483387.1,nicotinate phosphoribosyltransferase-like,15329
NC_035780.1,42928456,42944313,42928456,42944313,111134404,XM_022483379.1,nicotinate phosphoribosyltransferase-like,15857
NC_035788.1,48263063,48297050,48263063,48297050,111111216,XM_022448052.1,hypoxanthine-guanine phosphoribosyltransferase-like,33987
NC_035784.1,26617839,26623048,26617839,26623048,111133624,XM_022482148.1,adenine phosphoribosyltransferase-like,5209
NC_035784.1,27000395,27005745,27000395,27005745,111133611,XM_022482135.1,adenine phosphoribosyltransferase-like,5350
NC_035780.1,61499765,61507734,61499765,61507734,111099975,XM_022431517.1,uridine phosphorylase 2-like,7969
NC_035783.1,9280132,9295794,9280132,9295794,111129461,XM_022475846.1,glycogen phosphorylase,15662
NC_035782.1,45297526,45314136,45297526,45314135,111125157,XM_022468684.1,glycogen phosphorylase,16609
NC_035782.1,45297526,45314136,45297526,45314136,111125157,XM_022468682.1,glycogen phosphorylase,16610
NC_035787.1,20139660,20142464,20139660,20142464,111108864,XM_022444948.1,glycogen phosphorylase,2804
NC_035786.1,19168664,19171518,19168664,19171518,111105567,XM_022439922.1,glycogen phosphorylase,2854
NC_035786.1,35057689,35068691,35057689,35068691,111103796,XM_022437276.1,thymidine phosphorylase-like,11002
NC_035786.1,35005824,35053811,35017292,35053811,111103795,XM_022437274.1,thymidine phosphorylase-like,36519
NC_035786.1,35005824,35053811,35005824,35053811,111103795,XM_022437275.1,thymidine phosphorylase-like,47987
NC_035781.1,29787734,29795760,29787734,29795760,111120902,XM_022461928.1,S-methyl-5'-thioadenosine phosphorylase-like,8026
NC_035786.1,35077239,35086306,35077239,35086306,111102818,XM_022435703.1,thymidine phosphorylase-like,9067
NC_035783.1,26194042,26195320,26194042,26195320,111131556,XM_022479150.1,mannosyl phosphorylinositol ceramide synthase CSH1-like,1278
NC_035781.1,8613228,8616899,8613228,8616899,111119683,XM_022460100.1,GTP:AMP phosphotransferase AK3,3671
NC_035785.1,35368762,35387183,35368762,35387183,111100499,XM_022432446.1,deoxyribodipyrimidine photo-lyase-like,18421
NC_035784.1,4347553,4352721,4347553,4352721,111135703,XM_022485993.1,deoxyribodipyrimidine photo-lyase-like,5168
NC_035784.1,62799361,62805406,62799361,62805406,111137379,XM_022488817.1,root phototropism protein 2-like,6045
NC_035782.1,49117071,49123461,49117071,49123461,111123293,XM_022465540.1,probable phytanoyl-CoA dioxygenase,6390
NC_035786.1,5282696,5315917,5282696,5301411,111103589,XM_022436962.1,protein piccolo-like,18715
NC_035786.1,4891277,4928300,4905993,4928300,111103596,XM_022436980.1,protein piccolo-like,22307
NC_035784.1,38890004,38922769,38900362,38922768,111136340,XM_022487132.1,protein piccolo-like,22406
NC_035784.1,53717949,53756785,53717949,53740973,111137825,XM_022489502.1,protein piccolo-like,23024
NC_035786.1,4891277,4928300,4905252,4928300,111103596,XM_022436979.1,protein piccolo-like,23048
NC_035784.1,53717949,53756785,53717949,53747885,111137825,XM_022489499.1,protein piccolo-like,29936
NC_035786.1,5282696,5315917,5282696,5313117,111103589,XM_022436960.1,protein piccolo-like,30421
NC_035786.1,4891277,4928300,4897344,4928300,111103596,XM_022436977.1,protein piccolo-like,30956
NC_035786.1,5282696,5315917,5282696,5314163,111103589,XM_022436959.1,protein piccolo-like,31467
NC_035786.1,4891277,4928300,4896279,4928300,111103596,XM_022436975.1,protein piccolo-like,32021
NC_035784.1,38890004,38922769,38890020,38922768,111136340,XM_022487143.1,protein piccolo-like,32748
NC_035784.1,38890004,38922769,38890018,38922768,111136340,XM_022487119.1,protein piccolo-like,32750
NC_035784.1,38890004,38922769,38890017,38922768,111136340,XM_022487140.1,protein piccolo-like,32751
NC_035784.1,38890004,38922769,38890016,38922768,111136340,XM_022487110.1,protein piccolo-like,32752
NC_035784.1,38890004,38922769,38890013,38922768,111136340,XM_022487134.1,protein piccolo-like,32755
NC_035784.1,38890004,38922769,38890012,38922768,111136340,XM_022487139.1,protein piccolo-like,32756
NC_035784.1,38890004,38922769,38890011,38922768,111136340,XM_022487127.1,protein piccolo-like,32757
NC_035784.1,38890004,38922769,38890010,38922768,111136340,XM_022487138.1,protein piccolo-like,32758
NC_035784.1,38890004,38922769,38890009,38922768,111136340,XM_022487123.1,protein piccolo-like,32759
NC_035784.1,38890004,38922769,38890008,38922768,111136340,XM_022487124.1,protein piccolo-like,32760
NC_035784.1,38890004,38922769,38890007,38922768,111136340,XM_022487118.1,protein piccolo-like,32761
NC_035784.1,38890004,38922769,38890007,38922769,111136340,XM_022487111.1,protein piccolo-like,32762
NC_035784.1,38890004,38922769,38890006,38922769,111136340,XM_022487117.1,protein piccolo-like,32763
NC_035784.1,38890004,38922769,38890005,38922769,111136340,XM_022487113.1,protein piccolo-like,32764
NC_035784.1,38890004,38922769,38890004,38922769,111136340,XM_022487109.1,protein piccolo-like,32765
NC_035786.1,5282696,5315917,5282696,5315917,111103589,XM_022436958.1,protein piccolo-like,33221
NC_035784.1,53717949,53756785,53717949,53751721,111137825,XM_022489500.1,protein piccolo-like,33772
NC_035787.1,67386959,67433659,67399606,67433659,111108204,XM_022443881.1,protein piccolo-like,34053
NC_035784.1,53717949,53756785,53717949,53752245,111137825,XM_022489498.1,protein piccolo-like,34296
NC_035784.1,53717949,53756785,53717949,53752442,111137825,XM_022489501.1,protein piccolo-like,34493
NC_035784.1,53717949,53756785,53721351,53756785,111137825,XM_022489509.1,protein piccolo-like,35434
NC_035784.1,53717949,53756785,53717949,53753811,111137825,XM_022489495.1,protein piccolo-like,35862
NC_035784.1,53717949,53756785,53717949,53754318,111137825,XM_022489494.1,protein piccolo-like,36369
NC_035786.1,4891277,4928300,4891277,4928300,111103596,XM_022436974.1,protein piccolo-like,37023
NC_035784.1,53717949,53756785,53717950,53756783,111137825,XM_022489508.1,protein piccolo-like,38833
NC_035784.1,53717949,53756785,53717949,53756784,111137825,XM_022489507.1,protein piccolo-like,38835
NC_035787.1,65798790,65840077,65798790,65840077,111105899,XM_022440356.1,protein piccolo-like,41287
NC_035787.1,67386959,67433659,67386959,67433659,111108204,XM_022443884.1,protein piccolo-like,46700
NC_035787.1,52467871,52516627,52497951,52516627,111106620,XM_022441357.1,protein pigeon-like,18676
NC_035787.1,52309178,52335566,52309178,52335292,111106618,XM_022441353.1,protein pigeon-like,26114
NC_035787.1,52309178,52335566,52309178,52335566,111106618,XM_022441351.1,protein pigeon-like,26388
NC_035787.1,52456250,52495629,52456250,52495629,111106635,XM_022441374.1,protein pigeon-like,39379
NC_035787.1,52610667,52653198,52610667,52653198,111109169,XM_022445251.1,protein pigeon-like,42531
NC_035787.1,52656314,52701030,52656314,52701030,111109170,XM_022445252.1,protein pigeon-like,44716
NC_035787.1,52467871,52516627,52467871,52516627,111106620,XM_022441356.1,protein pigeon-like,48756
NC_035781.1,13395755,13421118,13395755,13421118,111121181,XM_022462339.1,visual pigment-like receptor peropsin,25363
NC_035783.1,36100277,36119151,36100277,36119151,111128977,XM_022474965.1,retinitis pigmentosa 1-like 1 protein,18874
NC_035780.1,63902506,63905855,63902506,63905855,111134989,XM_022484633.1,protein pitchfork-like,3349
NC_035782.1,20154754,20158727,20154754,20158727,111122946,XM_022464983.1,Golgi-associated plant pathogenesis-related protein 1-like,3973
NC_035783.1,13159579,13161873,13159579,13161873,111130773,XM_022478005.1,adhesive plaque matrix protein-like,2294
NC_035783.1,56632193,56641373,56632193,56641373,111129320,XM_022475614.1,adipocyte plasma membrane-associated protein-like,9180
NC_035780.1,7016304,7018499,7016304,7018499,111110225,XM_022446630.1,SAM pointed domain-containing Ets transcription factor-like,2195
NC_035784.1,54623693,54644543,54623693,54644543,111133687,XM_022482295.1,segment polarity protein dishevelled homolog DVL-3-like,20850
NC_035780.1,22363449,22365964,22363449,22365964,111125020,XM_022468436.1,spindle pole body component 110-like,2515
NC_035784.1,61352323,61361213,61352323,61361213,111135552,XM_022485707.1,non-canonical poly(A) RNA polymerase PAPD5-like,8890
NC_035782.1,12632472,12644800,12632472,12644800,111125645,XM_022469651.1,PAB-dependent poly(A)-specific ribonuclease subunit PAN3-like,12328
NC_035781.1,23661153,23663978,23661153,23663978,111119043,XM_022458854.1,nuclear polyadenylated RNA-binding protein 3-like,2825
NC_035784.1,67296609,67311485,67296609,67311485,111134087,XM_022482888.1,cytoplasmic polyadenylation element-binding protein 2-like,14876
NC_035780.1,46891224,46900412,46891224,46900412,111122529,XM_022464346.1,probable polyamine oxidase 4,9188
NC_035787.1,72591263,72632421,72591263,72632421,111105716,XM_022440074.1,protein polybromo-1-like,41158
NC_035783.1,37535066,37565338,37535066,37565338,111129210,XM_022475456.1,mirror-image polydactyly gene 1 protein-like,30272
NC_035780.1,19725303,19731329,19725303,19731329,111111651,XM_022448751.1,tubulin polyglutamylase complex subunit 2-like,6026
NC_035784.1,51327455,51374391,51327455,51374391,111135074,XM_022484786.1,protein polyglycylase TTLL10-like,46936
NC_035780.1,19748091,19778827,19748091,19778827,111111579,XM_022448639.1,RNA polymerase II elongation factor ELL-like,30736
NC_035780.1,2554181,2599559,2554181,2599559,111128103,XM_022473562.1,RNA polymerase-associated protein CTR9 homolog,45378
NC_035781.1,54164602,54167700,54164602,54167700,111121192,XM_022462349.1,tubulin polymerization-promoting protein family member 2-like,3098
NC_035784.1,47113932,47124984,47113932,47124984,111137582,XM_022489092.1,bifunctional polynucleotide phosphatase/kinase-like,11052
NC_035782.1,47890284,47898760,47890284,47898760,111123817,XM_022466425.1,putative polypeptide N-acetylgalactosaminyltransferase 10,8476
NC_035780.1,31561157,31566078,31561157,31566078,111128139,XM_022473607.1,nascent polypeptide-associated complex subunit alpha-like,4921
NC_035781.1,5001346,5017943,5001346,5017943,111120505,XM_022461254.1,inositol polyphosphate multikinase-like,16597
NC_035788.1,15812724,15852805,15812724,15852805,111111223,XM_022448060.1,adenomatous polyposis coli protein-like,40081
NC_035787.1,17219904,17234865,17219904,17234865,111108525,XM_022444484.1,4-hydroxybenzoate polyprenyltransferase,14961
NC_035787.1,18893851,18901016,18893851,18901012,111110659,XM_022447253.1,4-hydroxybenzoate polyprenyltransferase,7161
NC_035787.1,18893851,18901016,18893851,18901016,111110659,XM_022447252.1,4-hydroxybenzoate polyprenyltransferase,7165
NC_035780.1,27017966,27042181,27017966,27042181,111114159,XM_022452793.1,two pore potassium channel protein sup-9-like,24215
NC_035781.1,25966881,26014698,25966881,26014698,111118558,XM_022458089.1,calcium-activated potassium channel slowpoke-like,47817
NC_035782.1,50036794,50048285,50036794,50048285,111126802,XM_022471677.1,putative pre-mRNA-splicing factor ATP-dependent RNA helicase DHX16,11491
NC_035786.1,37014587,37032501,37014587,37032501,111103629,XM_022437023.1,nucleolar pre-ribosomal-associated protein 1-like,17914
NC_035784.1,21574615,21578636,21574615,21577127,111135870,XM_022486302.1,protein preY,2512
NC_035784.1,21574615,21578636,21574615,21578601,111135870,XM_022486300.1,protein preY,3986
NC_035784.1,21574615,21578636,21574621,21578636,111135870,XM_022486301.1,protein preY,4015
NC_035784.1,9030177,9035673,9030177,9035673,111136735,XM_022487825.1,inosine-uridine preferring nucleoside hydrolase-like,5496
NC_035784.1,48441484,48446393,48441484,48446393,111136120,XM_022486749.1,unconventional prefoldin RPB5 interactor-like,4909
NC_035783.1,39763177,39777348,39763177,39777348,111128863,XM_022474768.1,CAAX prenyl protease 2-like,14171
NC_035783.1,16787431,16800322,16787431,16800322,111128279,XM_022473825.1,protein prenyltransferase alpha subunit repeat-containing protein 1-like,12891
NC_035787.1,18110899,18148252,18110899,18148252,111108661,XM_022444685.1,protein prickle-like,37353
NC_035787.1,16579683,16621564,16579683,16621564,111108759,XM_022444819.1,protein prickle-like,41881
NC_035782.1,67919577,67922541,67919577,67922541,111124882,XM_022468139.1,membrane primary amine oxidase-like,2964
NC_035781.1,46303256,46309442,46303256,46309442,111122245,XM_022463892.1,DNA primase large subunit-like,6186
NC_035781.1,31571631,31581499,31571631,31581499,111119563,XM_022459834.1,DNA-directed primase/polymerase protein-like,9868
NC_035784.1,7340683,7349052,7340683,7349052,111099067,XM_022430415.1,pre-rRNA processing protein FTSJ3-like,8369
NC_035781.1,34972339,34976277,34972339,34976277,111121216,XM_022462380.1,ribosome production factor 1-like,3938
NC_035781.1,54955717,54959783,54955717,54959783,111119773,XM_022460251.1,membrane-associated progesterone receptor component 1-like,4066
NC_035780.1,63266110,63276079,63266110,63276079,111133285,XM_022481554.1,membrane progestin receptor gamma-B-like,9969
NC_035783.1,32979220,32999515,32979223,32999515,111128069,XM_022473480.1,neuropeptide prohormone-4-like,20292
NC_035783.1,22706785,22728432,22706785,22728432,111128152,XM_022473624.1,neuropeptide prohormone-4-like,21647
NC_035783.1,32979220,32999515,32979220,32982274,111128069,XM_022473479.1,neuropeptide prohormone-4-like,3054
NC_035783.1,22706785,22728432,22725003,22728432,111128152,XM_022473623.1,neuropeptide prohormone-4-like,3429
NC_035781.1,5080085,5098525,5080085,5098525,111121578,XM_022462906.1,autocrine proliferation repressor protein A-like,18440
NC_035783.1,25589367,25615866,25589367,25615866,111129117,XM_022475244.1,signal-induced proliferation-associated 1-like protein 2,26499
NC_035780.1,444907,453310,444907,453310,111109809,XM_022446052.1,peroxisome proliferator-activated receptor delta-like,8403
NC_035780.1,37911596,37930653,37911596,37930653,111116839,XM_022455857.1,sodium-dependent proline transporter-like,19057
NC_035781.1,18189397,18198765,18189397,18198765,111119354,XM_022459422.1,probable proline--tRNA ligase,9368
NC_035780.1,60815485,60820683,60816980,60820683,111120082,XM_022460748.1,basic proline-rich protein-like,3703
NC_035780.1,56090066,56092222,56090066,56092222,111118708,XM_022458296.1,probable prolyl 4-hydroxylase 3,2156
NC_035783.1,48895540,48922296,48895540,48922296,111128859,XM_022474755.1,C-myc promoter-binding protein-like,26756
NC_035780.1,8313010,8314296,8313010,8314296,111114772,XM_022453245.1,serine protease inhibitor Cvsi-1,1286
NC_035784.1,22611105,22616358,22611105,22616358,111132211,XM_022479989.1,four-domain proteases inhibitor-like,5253
NC_035780.1,29666293,29676102,29666293,29676102,111108200,XM_022443918.1,26S proteasome non-ATPase regulatory subunit 14,9809
NC_035780.1,85606,95254,85606,95254,111112434,XM_022449924.1,homeobox protein Hox-B7-like,9648
NC_035783.1,491511,501707,491511,501707,111130753,XM_022477979.1,perlucin-like protein,10196
NC_035780.1,53497892,53508098,53497892,53508098,111108028,XM_022443520.1,nacrein-like protein,10206
NC_035780.1,36596710,36597734,36596710,36597734,111119954,XM_022460548.1,perlucin-like protein,1024
NC_035788.1,28963636,28973909,28963636,28973909,111114463,XM_022452769.1,kielin/chordin-like protein,10273
NC_035788.1,102409705,102420107,102409705,102420107,111113395,XM_022451643.1,kielin/chordin-like protein,10402
NC_035788.1,36980961,36982017,36980961,36982017,111110731,XM_022447322.1,perlucin-like protein,1056
NC_035786.1,42691649,42702229,42691649,42702229,111104165,XM_022437969.1,lebercilin-like protein,10580
NC_035784.1,83060698,83071301,83060698,83071301,111136459,XM_022487321.1,IWS1-like protein,10603
NC_035780.1,61473179,61484717,61474046,61484717,111102674,XM_022435617.1,peroxidase-like protein,10671
NC_035784.1,72018073,72028774,72018073,72028774,111136908,XM_022488077.1,protocadherin-like protein,10701
NC_035787.1,66849431,66860227,66849431,66860227,111105912,XM_022440390.1,dynamin-1-like protein,10796
NC_035784.1,63945915,63956917,63945915,63956915,111137821,XM_022489484.1,kielin/chordin-like protein,11000
NC_035784.1,63945915,63956917,63945915,63956916,111137821,XM_022489485.1,kielin/chordin-like protein,11001
NC_035784.1,63945915,63956917,63945915,63956917,111137821,XM_022489483.1,kielin/chordin-like protein,11002
NC_035780.1,52190977,52202241,52190977,52202241,111107957,XM_022443422.1,nacrein-like protein,11264
NC_035781.1,39450615,39461880,39450615,39461880,111120768,XM_022461728.1,HBS1-like protein,11265
NC_035780.1,61473179,61484717,61473179,61484717,111102674,XM_022435545.1,peroxidase-like protein,11538
NC_035781.1,38714725,38726707,38714725,38726707,111120855,XM_022461854.1,HBS1-like protein,11982
NC_035780.1,36583224,36584423,36583224,36584423,111119895,XM_022460470.1,perlucin-like protein,1199
NC_035789.1,2423829,2436808,2423829,2436808,111117162,XM_022456243.1,perlucin-like protein,12979
NC_035783.1,161491,162797,161491,162797,111128208,XM_022473700.1,mucin-like protein,1306
NC_035781.1,17124424,17137900,17124424,17137900,111118650,XM_022458207.1,calcyphosin-like protein,13476
NC_035780.1,23318732,23332354,23318732,23332354,111122693,XM_022464570.1,peroxidase-like protein,13622
NC_035785.1,2672535,2673917,2672535,2673917,111100942,XM_022433124.1,speriolin-like protein,1382
NC_035780.1,54937790,54951636,54937790,54951636,111108099,XM_022443671.1,perlucin-like protein,13846
NC_035788.1,7179536,7180931,7179536,7180931,111112070,XM_022449369.1,perlucin-like protein,1395
NC_035784.1,19256885,19271212,19256885,19271211,111136181,XM_022486837.1,ataxin-2-like protein,14326
NC_035784.1,19256885,19271212,19256885,19271212,111136181,XM_022486836.1,ataxin-2-like protein,14327
NC_035787.1,65511014,65525428,65511014,65525428,111108629,XM_022444628.1,dynamin-1-like protein,14414
NC_035780.1,36598025,36599474,36598025,36599474,111119922,XM_022460503.1,perlucin-like protein,1449
NC_035783.1,10642233,10656813,10642233,10656813,111129844,XM_022476328.1,vam6/Vps39-like protein,14580
NC_035788.1,33718726,33720202,33718726,33720202,111115296,XM_022453986.1,perlucin-like protein,1476
NC_035780.1,36576092,36577570,36576092,36577570,111119911,XM_022460492.1,perlucin-like protein,1478
NC_035784.1,18588525,18603800,18588756,18603800,111136215,XM_022486902.1,ataxin-2-like protein,15044
NC_035784.1,18588525,18603800,18588525,18603800,111136215,XM_022486904.1,ataxin-2-like protein,15275
NC_035788.1,31082892,31084447,31082892,31084447,111111959,XM_022449179.1,perlucin-like protein,1555
NC_035788.1,36296938,36298520,36296938,36298520,111114479,XM_022452792.1,perlucin-like protein,1582
NC_035788.1,30753153,30754749,30753153,30754749,111113712,XM_022452001.1,perlucin-like protein,1596
NC_035788.1,7106634,7108253,7106634,7108253,111112066,XM_022449367.1,perlucin-like protein,1619
NC_035783.1,59102580,59104221,59102599,59104221,111128827,XM_022474716.1,perlucin-like protein,1622
NC_035788.1,30629758,30631387,30629758,30631387,111110804,XM_022447417.1,perlucin-like protein,1629
NC_035783.1,59102580,59104221,59102580,59104221,111128827,XM_022474715.1,perlucin-like protein,1641
NC_035788.1,36437722,36439371,36437722,36439371,111116031,XM_022454997.1,perlucin-like protein,1649
NC_035788.1,7157709,7159416,7157709,7159416,111112069,XM_022449368.1,perlucin-like protein,1707
NC_035784.1,18231575,18248910,18231575,18248909,111136493,XM_022487376.1,tonsoku-like protein,17334
NC_035784.1,18231575,18248910,18231575,18248910,111136493,XM_022487377.1,tonsoku-like protein,17335
NC_035780.1,36574031,36575775,36574031,36575775,111119928,XM_022460512.1,perlucin-like protein,1744
NC_035786.1,13538713,13540474,13538713,13540474,111104655,XM_022438721.1,perlucin-like protein,1761
NC_035780.1,36584728,36586522,36584728,36586522,111119938,XM_022460523.1,perlucin-like protein,1794
NC_035782.1,70201076,70219091,70201076,70219091,111124417,XM_022467269.1,perlucin-like protein,18015
NC_035780.1,43801776,43820025,43801776,43820025,111118692,XM_022458272.1,protocadherin-like protein,18249
NC_035788.1,95435734,95437620,95435734,95437620,111112856,XM_022450710.1,perlucin-like protein,1886
NC_035788.1,31063645,31069768,31067873,31069762,111111960,XM_022449181.1,perlucin-like protein,1889
NC_035789.1,26881183,26883087,26881183,26883087,111116672,XM_022455667.1,kielin/chordin-like protein,1904
NC_035789.1,22340416,22342321,22340416,22342321,111117577,XM_022456728.1,kielin/chordin-like protein,1905
NC_035789.1,22347772,22349678,22347772,22349678,111117576,XM_022456727.1,kielin/chordin-like protein,1906
NC_035789.1,26888530,26890442,26888530,26890442,111116673,XM_022455668.1,kielin/chordin-like protein,1912
NC_035783.1,56093186,56095113,56093186,56095113,111127780,XM_022473024.1,perlucin-like protein,1927
NC_035789.1,8911535,8913468,8911535,8913468,111117329,XM_022456396.1,kielin/chordin-like protein,1933
NC_035788.1,36048862,36050852,36048862,36050852,111116001,XM_022454958.1,perlucin-like protein,1990
NC_035780.1,5020866,5041322,5020866,5041322,111130647,XM_022477818.1,mucin-like protein,20456
NC_035787.1,66522980,66543530,66522980,66543530,111105918,XM_022440400.1,mucin-like protein,20550
NC_035786.1,45199695,45201844,45199695,45201844,111105106,XM_022439278.1,nacrein-like protein,2149
NC_035782.1,60310251,60331847,60310251,60331847,111123583,XM_022466005.1,transient-receptor-potential-like protein,21596
NC_035781.1,30169329,30190961,30169329,30190961,111119382,XM_022459493.1,nipped-B-like protein,21632
NC_035783.1,59106705,59108902,59106734,59108902,111131737,XM_022479406.1,perlucin-like protein,2168
NC_035780.1,30200731,30202908,30200731,30202908,111105183,XM_022439356.1,perlucin-like protein,2177
NC_035783.1,59106705,59108902,59106705,59108902,111131737,XM_022479407.1,perlucin-like protein,2197
NC_035784.1,23628519,23630834,23628519,23630749,111132846,XM_022480715.1,perlucin-like protein,2230
NC_035782.1,69526983,69549533,69526983,69549494,111125655,XM_022469670.1,M protein,22511
NC_035782.1,69526983,69549533,69526983,69549533,111125655,XM_022469671.1,M protein,22550
NC_035780.1,61030208,61032471,61030208,61032469,111105659,XM_022440020.1,perlucin-like protein,2261
NC_035780.1,61030208,61032471,61030208,61032471,111105659,XM_022440023.1,perlucin-like protein,2263
NC_035785.1,2604502,2606769,2604502,2606769,111100688,XM_022432773.1,speriolin-like protein,2267
NC_035782.1,59896476,59919425,59896476,59919425,111123857,XM_022466494.1,transient-receptor-potential-like protein,22949
NC_035784.1,24018508,24020803,24018508,24020803,111132845,XM_022480714.1,perlucin-like protein,2295
NC_035781.1,19146445,19148741,19146445,19148741,111120787,XM_022461755.1,calcyphosin-like protein,2296
NC_035786.1,44523727,44526041,44523727,44526041,111105097,XM_022439270.1,nacrein-like protein,2314
NC_035787.1,17369417,17371783,17369417,17371783,111108605,XM_022444589.1,perlucin-like protein,2366
NC_035788.1,24518873,24521279,24518873,24521279,111115702,XM_022454533.1,perlucin-like protein,2406
NC_035783.1,59093988,59096415,59094007,59096415,111131760,XM_022479439.1,perlucin-like protein,2408
NC_035783.1,56096524,56104309,56101865,56104279,111127781,XM_022473028.1,perlucin-like protein,2414
NC_035783.1,59093988,59096415,59093988,59096415,111131760,XM_022479438.1,perlucin-like protein,2427
NC_035780.1,4992543,5016848,4992543,5016848,111130637,XM_022477806.1,mucin-like protein,24305
NC_035785.1,49077212,49158152,49155718,49158152,111099896,XM_022431399.1,perlucin-like protein,2434
NC_035783.1,56096524,56104309,56101865,56104309,111127781,XM_022473025.1,perlucin-like protein,2444
NC_035788.1,36740011,36742471,36740011,36742471,111110737,XM_022447329.1,perlucin-like protein,2460
NC_035787.1,25631214,25633678,25631214,25633678,111108905,XM_022444989.1,perlucin-like protein,2464
NC_035788.1,37325001,37327495,37325001,37327495,111111614,XM_022448693.1,perlucin-like protein,2494
NC_035783.1,56096524,56104309,56096525,56099034,111127781,XM_022473026.1,perlucin-like protein,2509
NC_035783.1,56096524,56104309,56096524,56099034,111127781,XM_022473029.1,perlucin-like protein,2510
NC_035787.1,18977138,18979655,18977138,18979655,111107234,XM_022442325.1,perlucin-like protein,2517
NC_035788.1,36976999,36979566,36976999,36979566,111116063,XM_022455050.1,perlucin-like protein,2567
NC_035787.1,51523596,51526172,51523596,51526172,111107119,XM_022442118.1,perlustrin-like protein,2576
NC_035787.1,25754426,25757009,25754426,25757009,111110552,XM_022447099.1,perlucin-like protein,2583
NC_035788.1,95410348,95412968,95410348,95412968,111112857,XM_022450711.1,perlucin-like protein,2620
NC_035780.1,30511850,30514493,30511850,30514493,111105144,XM_022439320.1,perlucin-like protein,2643
NC_035788.1,24472602,24517748,24472602,24475329,111115082,XM_022453664.1,perlucin-like protein,2727
NC_035789.1,22316914,22319651,22316914,22319651,111117572,XM_022456724.1,kielin/chordin-like protein,2737
NC_035788.1,92174964,92177703,92174964,92177703,111115693,XM_022454522.1,perlucin-like protein,2739
NC_035788.1,24597314,24600103,24597314,24600103,111113378,XM_022451615.1,perlucin-like protein,2789
NC_035789.1,26911780,26914577,26911780,26914577,111116670,XM_022455665.1,kielin/chordin-like protein,2797
NC_035788.1,24575753,24578558,24575753,24578558,111113379,XM_022451616.1,perlucin-like protein,2805
NC_035786.1,44526525,44529333,44526525,44529333,111105098,XM_022439271.1,nacrein-like protein,2808
NC_035787.1,18966381,18970346,18966381,18969192,111107233,XM_022442324.1,perlucin-like protein,2811
NC_035780.1,36567922,36570741,36567922,36570741,111107198,XM_022442258.1,perlucin-like protein,2819
NC_035780.1,53793659,53822370,53793659,53822370,111132891,XM_022480818.1,hunchback-like protein,28711
NC_035789.1,2389183,2392108,2389183,2392108,111116642,XM_022455645.1,perlucin-like protein,2925
NC_035788.1,84680929,84683866,84680929,84683866,111115329,XM_022454011.1,kielin/chordin-like protein,2937
NC_035789.1,22368250,22371191,22368250,22371191,111117574,XM_022456725.1,kielin/chordin-like protein,2941
NC_035788.1,82849315,82852266,82849315,82852266,111115812,XM_022454671.1,kielin/chordin-like protein,2951
NC_035785.1,29528833,29532799,29528833,29531838,111101180,XM_022433549.1,perlucin-like protein,3005
NC_035780.1,44707379,44710412,44707379,44710412,111133402,XM_022481832.1,perlucin-like protein,3033
NC_035781.1,17237286,17245780,17237286,17240330,111121230,XM_022462401.1,calcyphosin-like protein,3044
NC_035780.1,45233227,45238256,45233227,45236315,111113440,XM_022451731.1,perlucin-like protein,3088
NC_035789.1,467384,470554,467384,470481,111117722,XM_022456893.1,mpv17-like protein,3097
NC_035785.1,16991204,16991515,16991204,16991515,111100648,XM_022432735.1,perlucin-like protein,311
NC_035780.1,52097557,52128704,52097557,52128704,111107937,XM_022443398.1,peroxidase-like protein,31147
NC_035789.1,467384,470554,467384,470520,111117722,XM_022456894.1,mpv17-like protein,3136
NC_035789.1,467384,470554,467384,470539,111117722,XM_022456895.1,mpv17-like protein,3155
NC_035789.1,467384,470554,467386,470554,111117722,XM_022456892.1,mpv17-like protein,3168
NC_035788.1,87320443,87323700,87320443,87323700,111115578,XM_022454359.1,perlucin-like protein,3257
NC_035785.1,17927046,17927373,17927046,17927373,111101980,XM_022434634.1,perlucin-like protein,327
NC_035783.1,28397452,28430472,28397452,28430472,111129048,XM_022475105.1,GON-4-like protein,33020
NC_035788.1,103948601,103951937,103948601,103951937,111114652,XM_022453057.1,kielin/chordin-like protein,3336
NC_035780.1,5039897,5074279,5039897,5074279,111130653,XM_022477832.1,mucin-like protein,34382
NC_035788.1,72639166,72642607,72639166,72642607,111115700,XM_022454531.1,perlucin-like protein,3441
NC_035783.1,30414391,30449529,30414391,30449529,111129603,XM_022476057.1,tankyrase-like protein,35138
NC_035780.1,8560936,8564456,8560936,8564456,111123977,XM_022466763.1,perlucin-like protein,3520
NC_035781.1,17124424,17137900,17124466,17128036,111118650,XM_022458206.1,calcyphosin-like protein,3570
NC_035780.1,17815652,17819279,17815652,17819279,111104556,XM_022438577.1,M protein,3627
NC_035781.1,18105618,18109253,18105618,18109253,111120893,XM_022461914.1,calcyphosin-like protein,3635
NC_035786.1,5914033,5917699,5914033,5917699,111103972,XM_022437641.1,perlucin-like protein,3666
NC_035786.1,3785341,3789025,3785341,3789025,111104861,XM_022439024.1,perlucin-like protein,3684
NC_035784.1,25554746,25558431,25554746,25558431,111137931,XM_022489635.1,SRR1-like protein,3685
NC_035781.1,35580193,35585997,35582176,35585871,111119327,XM_022459392.1,calcyphosin-like protein,3695
NC_035785.1,49217545,49226770,49217545,49221255,111099895,XM_022431396.1,perlucin-like protein,3710
NC_035780.1,21293476,21331291,21293476,21331291,111106312,XM_022440942.1,mucin-like protein,37815
NC_035780.1,53536877,53540675,53536877,53540675,111116143,XM_022455147.1,peroxidase-like protein,3798
NC_035781.1,35580193,35585997,35582176,35585997,111119327,XM_022459391.1,calcyphosin-like protein,3821
NC_035783.1,40835484,40839326,40835484,40839326,111129991,XM_022476570.1,perlucin-like protein,3842
NC_035784.1,22785110,22789164,22785110,22788953,111132580,XM_022480408.1,mpv17-like protein,3843
NC_035786.1,12514126,12517977,12514126,12517977,111102379,XM_022435080.1,perlucin-like protein,3851
NC_035788.1,76542489,76546349,76542489,76546349,111116147,XM_022455146.1,perlucin-like protein,3860
NC_035784.1,21578727,21582635,21578727,21582635,111135869,XM_022486299.1,coactosin-like protein,3908
NC_035789.1,8266535,8270449,8266535,8270449,111117801,XM_022457030.1,perlucin-like protein,3914
NC_035784.1,22785110,22789164,22785110,22789060,111132580,XM_022480407.1,mpv17-like protein,3950
NC_035786.1,13547014,13550983,13547014,13550965,111104096,XM_022437841.1,perlucin-like protein,3951
NC_035783.1,58299554,58303518,58299554,58303518,111130974,XM_022478283.1,perlucin-like protein,3964
NC_035787.1,18966381,18970346,18966381,18970346,111107233,XM_022442323.1,perlucin-like protein,3965
NC_035785.1,29528833,29532799,29528833,29532799,111101180,XM_022433550.1,perlucin-like protein,3966
NC_035786.1,13547014,13550983,13547014,13550983,111104096,XM_022437842.1,perlucin-like protein,3969
NC_035789.1,11632623,11636593,11632623,11636593,111116291,XM_022455279.1,perlucin-like protein,3970
NC_035785.1,29523413,29527396,29523413,29527396,111101181,XM_022433551.1,perlucin-like protein,3983
NC_035788.1,29983630,29987619,29983630,29987619,111111783,XM_022448935.1,kielin/chordin-like protein,3989
NC_035786.1,13541556,13545593,13541556,13545593,111104097,XM_022437843.1,perlucin-like protein,4037
NC_035784.1,22785110,22789164,22785110,22789164,111132580,XM_022480406.1,mpv17-like protein,4054
NC_035784.1,62766689,62770783,62766689,62770783,111132176,XM_022479939.1,PACRG-like protein,4094
NC_035784.1,18312799,18316965,18312799,18316965,111136742,XM_022487834.1,perlucin-like protein,4166
NC_035785.1,49217545,49226770,49222586,49226770,111099895,XM_022431398.1,perlucin-like protein,4184
NC_035783.1,36533387,36575238,36533387,36575238,111128949,XM_022474925.1,ninein-like protein,41851
NC_035788.1,36040049,36044362,36040049,36044362,111113791,XM_022452082.1,perlucin-like protein,4313
NC_035780.1,28961,33324,28961,33324,111126949,XM_022471938.1,UNC5C-like protein,4363
NC_035786.1,33844641,33849057,33844641,33849057,111105623,XM_022439993.1,nacrein-like protein,4416
NC_035786.1,46393782,46398209,46393782,46398209,111102603,XM_022435419.1,perlucin-like protein,4427
NC_035788.1,24472602,24517748,24472602,24517748,111115082,XM_022453665.1,perlucin-like protein,45146
NC_035788.1,33709619,33714205,33709619,33714205,111113755,XM_022452043.1,perlucin-like protein,4586
NC_035788.1,95404552,95409219,95404552,95409219,111115521,XM_022454283.1,perlucin-like protein,4667
NC_035787.1,17358449,17364297,17358449,17363137,111108604,XM_022444588.1,perlucin-like protein,4688
NC_035785.1,16847605,16856046,16847605,16852348,111100494,XM_022432445.1,perlucin-like protein,4743
NC_035786.1,48650148,48654902,48650148,48654902,111103864,XM_022437422.1,TIP41-like protein,4754
NC_035782.1,29867945,29872866,29868052,29872865,111126196,XM_022470656.1,TRMT1-like protein,4813
NC_035782.1,29234132,29239161,29234287,29239161,111127646,XM_022472914.1,TRMT1-like protein,4874
NC_035784.1,38465876,38470769,38465876,38470769,111136574,XM_022487520.1,coactosin-like protein,4893
NC_035782.1,29867945,29872866,29867945,29872866,111126196,XM_022470655.1,TRMT1-like protein,4921
NC_035784.1,28162746,28167711,28162746,28167711,111132280,XM_022480073.1,perlucin-like protein,4965
NC_035780.1,45233227,45238256,45233227,45238256,111113440,XM_022451748.1,perlucin-like protein,5029
NC_035787.1,63938402,63943484,63938402,63943484,111107361,XM_022442539.1,nacrein-like protein,5082
NC_035785.1,17811379,17817277,17811379,17816486,111101466,XM_022433970.1,perlucin-like protein,5107
NC_035784.1,38995943,39001123,38995943,39001123,111136368,XM_022487175.1,coactosin-like protein,5180
NC_035784.1,55051510,55056695,55051510,55056695,111136087,XM_022486688.1,chondroadherin-like protein,5185
NC_035785.1,24764158,24769385,24764158,24769385,111102053,XM_022434707.1,perlucin-like protein,5227
NC_035784.1,86861250,86913712,86861250,86913712,111132948,XM_022480907.1,RRP12-like protein,52462
NC_035789.1,480780,486919,480780,486066,111116984,XM_022456042.1,mpv17-like protein,5286
NC_035784.1,22797359,22804102,22797359,22802700,111133041,XM_022481089.1,mpv17-like protein,5341
NC_035784.1,22797359,22804102,22797359,22802709,111133041,XM_022481091.1,mpv17-like protein,5350
NC_035789.1,8509385,8514789,8509385,8514789,111116248,XM_022455234.1,perlucin-like protein,5404
NC_035787.1,63783908,63789333,63783908,63789333,111107350,XM_022442523.1,nacrein-like protein,5425
NC_035787.1,45580210,45585765,45580210,45585765,111105697,XM_022440057.1,perlucin-like protein,5555
NC_035789.1,8096207,8101811,8096207,8101811,111116242,XM_022455227.1,perlucin-like protein,5604
NC_035780.1,11086051,11091706,11086051,11091706,111129311,XM_022475604.1,ropporin-1-like protein,5655
NC_035785.1,24756354,24762014,24756354,24762014,111101453,XM_022433944.1,perlucin-like protein,5660
NC_035784.1,85074222,85079962,85074222,85079962,111137200,XM_022488552.1,TIP41-like protein,5740
NC_035781.1,40513442,40519229,40513442,40519229,111119179,XM_022459058.1,adrenodoxin-like protein,5787
NC_035781.1,35580193,35585997,35580193,35585997,111119327,XM_022459393.1,calcyphosin-like protein,5804
NC_035787.1,17358449,17364297,17358449,17364297,111108604,XM_022444587.1,perlucin-like protein,5848
NC_035785.1,17811379,17817277,17811379,17817277,111101466,XM_022433969.1,perlucin-like protein,5898
NC_035780.1,23337862,23343817,23337862,23343817,111101430,XM_022433922.1,peroxidase-like protein,5955
NC_035786.1,44533196,44539159,44533196,44539159,111104844,XM_022439005.1,nacrein-like protein,5963
NC_035789.1,480780,486919,480780,486894,111116984,XM_022456041.1,mpv17-like protein,6114
NC_035789.1,480780,486919,480780,486903,111116984,XM_022456044.1,mpv17-like protein,6123
NC_035787.1,52735236,52741360,52735236,52741360,111106257,XM_022440861.1,phosducin-like protein,6124
NC_035782.1,51783771,51789898,51783771,51789898,111123883,XM_022466532.1,peroxidase-like protein,6127
NC_035789.1,480780,486919,480780,486919,111116984,XM_022456043.1,mpv17-like protein,6139
NC_035785.1,3077134,3083543,3077134,3083543,111099588,XM_022430916.1,speriolin-like protein,6409
NC_035782.1,70436540,70442959,70436540,70442959,111124422,XM_022467273.1,perlucin-like protein,6419
NC_035788.1,29996864,30003332,29996864,30003332,111111778,XM_022448926.1,kielin/chordin-like protein,6468
NC_035781.1,14390202,14396745,14390202,14396745,111120550,XM_022461349.1,meteorin-like protein,6543
NC_035788.1,103961125,103967669,103961125,103967669,111111482,XM_022448476.1,kielin/chordin-like protein,6544
NC_035784.1,22797359,22804102,22797359,22803970,111133041,XM_022481090.1,mpv17-like protein,6611
NC_035784.1,22797359,22804102,22797359,22803990,111133041,XM_022481092.1,mpv17-like protein,6631
NC_035788.1,104007421,104014082,104007421,104014082,111111483,XM_022448477.1,kielin/chordin-like protein,6661
NC_035787.1,65782239,65782907,65782239,65782907,111105969,XM_022440480.1,perlucin-like protein,668
NC_035782.1,54465299,54472010,54465299,54472010,111123491,XM_022465833.1,BET1-like protein,6711
NC_035780.1,53564034,53570769,53564034,53570769,111127033,XM_022472055.1,peroxidase-like protein,6735
NC_035784.1,22797359,22804102,22797359,22804102,111133041,XM_022481088.1,mpv17-like protein,6743
NC_035788.1,30029456,30036201,30029456,30036201,111111603,XM_022448678.1,kielin/chordin-like protein,6745
NC_035786.1,45219933,45229566,45219933,45226681,111104447,XM_022438409.1,nacrein-like protein,6748
NC_035786.1,1331799,1338918,1331799,1338918,111104068,XM_022437802.1,nacrein-like protein,7119
NC_035782.1,12547603,12554938,12547603,12554938,111123816,XM_022466423.1,peroxidase-like protein,7335
NC_035788.1,4903482,4910894,4903482,4910894,111111610,XM_022448688.1,perlucin-like protein,7412
NC_035784.1,82381978,82389394,82381978,82389394,111137146,XM_022488460.1,perlucin-like protein,7416
NC_035789.1,5375827,5383482,5375827,5383482,111117256,XM_022456326.1,perlucin-like protein,7655
NC_035783.1,56096524,56104309,56096524,56104301,111127781,XM_022473027.1,perlucin-like protein,7777
NC_035786.1,44551157,44558973,44551157,44558973,111105218,XM_022439385.1,nacrein-like protein,7816
NC_035785.1,49077212,49158152,49077212,49158152,111099896,XM_022431401.1,perlucin-like protein,80940
NC_035788.1,3437481,3445580,3437481,3445580,111114678,XM_022453097.1,kielin/chordin-like protein,8099
NC_035785.1,16847605,16856046,16847605,16856046,111100494,XM_022432444.1,perlucin-like protein,8441
NC_035781.1,17237286,17245780,17237286,17245780,111121230,XM_022462402.1,calcyphosin-like protein,8494
NC_035780.1,23303823,23312325,23303823,23312325,111104064,XM_022437796.1,peroxidase-like protein,8502
NC_035788.1,11264644,11273283,11264644,11273283,111114827,XM_022453317.1,perlucin-like protein,8639
NC_035784.1,71109907,71118596,71109907,71118596,111136431,XM_022487278.1,nacrein-like protein,8689
NC_035780.1,62832069,62840878,62832069,62840878,111099775,XM_022431233.1,peroxidase-like protein,8809
NC_035785.1,49217545,49226770,49217548,49226769,111099895,XM_022431397.1,perlucin-like protein,9221
NC_035789.1,22372093,22381345,22372093,22381345,111116489,XM_022455484.1,kielin/chordin-like protein,9252
NC_035788.1,95568331,95577709,95568331,95577709,111112858,XM_022450713.1,perlucin-like protein,9378
NC_035783.1,45395136,45404680,45395136,45404680,111128501,XM_022474125.1,RRP15-like protein,9544
NC_035780.1,61473179,61484717,61473179,61482765,111102674,XM_022435688.1,peroxidase-like protein,9586
NC_035786.1,45219933,45229566,45219933,45229566,111104447,XM_022438410.1,nacrein-like protein,9633
NC_035785.1,43600987,43610776,43600987,43610776,111100668,XM_022432755.1,stress-70 protein,9789
NC_035787.1,6319539,6321267,6319539,6320527,111110329,XM_022446780.1,kielin/chordin-like protein,988
NC_035784.1,24016378,24017374,24016378,24017374,111132251,XM_022480042.1,perlucin-like protein,996
NC_035784.1,3698138,3708135,3698138,3708135,111138169,XM_022490016.1,perlucin-like protein,9997
NC_035781.1,5246865,5263817,5246865,5263817,111119991,XM_022460592.1,G protein-activated inward rectifier potassium channel 3-like,16952
NC_035781.1,46987442,47007823,46987442,47007823,111120682,XM_022461593.1,TATA-binding protein-associated factor 172-like,20381
NC_035781.1,27887370,27894088,27887830,27894088,111119832,XM_022460350.1,amyloid protein-binding protein 2-like,6258
NC_035784.1,69465709,69498230,69465709,69498230,111135594,XM_022485808.1,G protein-coupled receptor kinase 5-like,32521
NC_035784.1,43228376,43248907,43232717,43248907,111135863,XM_022486289.1,hemocyte protein-glutamine gamma-glutamyltransferase-like,16190
NC_035781.1,584149,596169,584149,596169,111120891,XM_022461912.1,polyadenylate-binding protein-interacting protein 1-like,12020
NC_035781.1,23464996,23504829,23466057,23504829,111118379,XM_022457807.1,contactin-associated protein-like 5,38772
NC_035786.1,34702413,34703416,34702413,34703416,111105041,XM_022439214.1,serine-enriched protein-like,1003
NC_035782.1,60261039,60271081,60261039,60271081,111126106,XM_022470512.1,P protein-like,10042
NC_035784.1,33329272,33330300,33329272,33330300,111138385,XM_022490318.1,asparagine-rich protein-like,1028
NC_035784.1,40211879,40225509,40211879,40222221,111136676,XM_022487705.1,AKT-interacting protein-like,10342
NC_035783.1,44192491,44207909,44192491,44202864,111130932,XM_022478221.1,TIMELESS-interacting protein-like,10373
NC_035785.1,42621407,42631990,42621407,42631990,111102249,XM_022434914.1,MYCBP-associated protein-like,10583
NC_035788.1,30355587,30368444,30355587,30366568,111113358,XM_022451585.1,valine-rich protein-like,10981
NC_035783.1,2697525,2698624,2697525,2698624,111131412,XM_022478922.1,glycine-rich protein-like,1099
NC_035788.1,36790918,36803774,36792668,36803774,111113316,XM_022451494.1,valine-rich protein-like,11106
NC_035784.1,40211879,40225509,40211879,40223090,111136676,XM_022487706.1,AKT-interacting protein-like,11211
NC_035786.1,34686007,34687129,34686007,34687129,111102694,XM_022435541.1,serine-enriched protein-like,1122
NC_035784.1,82600348,82611710,82600348,82611710,111137249,XM_022488635.1,asparagine-rich protein-like,11362
NC_035780.1,29421436,29432997,29421436,29432997,111114027,XM_022452319.1,mdm2-binding protein-like,11561
NC_035783.1,57602975,57604144,57602975,57604144,111130780,XM_022478015.1,circumsporozoite protein-like,1169
NC_035784.1,65699379,65711228,65699379,65711228,111137543,XM_022489027.1,LRP2-binding protein-like,11849
NC_035780.1,12472087,12473292,12472087,12473292,111131233,XM_022478665.1,S-antigen protein-like,1205
NC_035786.1,49629960,49642301,49629960,49642301,111105474,XM_022439789.1,brachyury protein-like,12341
NC_035784.1,78381082,78394547,78381853,78394547,111135208,XM_022485056.1,C-terminal-binding protein-like,12694
NC_035788.1,30355587,30368444,30355587,30368361,111113358,XM_022451588.1,valine-rich protein-like,12774
NC_035788.1,11535907,11537185,11535907,11537185,111116075,XM_022455061.1,IgGFc-binding protein-like,1278
NC_035788.1,36790918,36803774,36790927,36803774,111113316,XM_022451496.1,valine-rich protein-like,12847
NC_035788.1,30355587,30368444,30355587,30368435,111113358,XM_022451587.1,valine-rich protein-like,12848
NC_035788.1,36790918,36803774,36790918,36803774,111113316,XM_022451495.1,valine-rich protein-like,12856
NC_035788.1,30355587,30368444,30355587,30368444,111113358,XM_022451584.1,valine-rich protein-like,12857
NC_035788.1,11822150,11835227,11822150,11835227,111113303,XM_022451468.1,IgGFc-binding protein-like,13077
NC_035784.1,78381082,78394547,78381315,78394547,111135208,XM_022485058.1,C-terminal-binding protein-like,13232
NC_035784.1,78381082,78394547,78381105,78394547,111135208,XM_022485059.1,C-terminal-binding protein-like,13442
NC_035784.1,78381082,78394547,78381082,78394547,111135208,XM_022485055.1,C-terminal-binding protein-like,13465
NC_035784.1,40211879,40225509,40211879,40225509,111136676,XM_022487707.1,AKT-interacting protein-like,13630
NC_035782.1,64875995,64889677,64875995,64889677,111125013,XM_022468413.1,mitochondria-eating protein-like,13682
NC_035784.1,48417609,48431656,48417617,48431652,111136121,XM_022486750.1,retinal-binding protein-like,14035
NC_035784.1,48417609,48431656,48417609,48431656,111136121,XM_022486751.1,retinal-binding protein-like,14047
NC_035782.1,28740099,28754262,28740099,28754262,111124165,XM_022467027.1,IgGFc-binding protein-like,14163
NC_035782.1,65487873,65502079,65487873,65502079,111123211,XM_022465390.1,CREB-binding protein-like,14206
NC_035785.1,37535446,37549935,37535601,37549935,111101110,XM_022433419.1,retinoblastoma-associated protein-like,14334
NC_035785.1,37535446,37549935,37535449,37549933,111101110,XM_022433420.1,retinoblastoma-associated protein-like,14484
NC_035785.1,37535446,37549935,37535446,37549934,111101110,XM_022433418.1,retinoblastoma-associated protein-like,14488
NC_035783.1,44192491,44207909,44193292,44207909,111130932,XM_022478222.1,TIMELESS-interacting protein-like,14617
NC_035781.1,48008381,48009878,48008381,48009878,111122061,XM_022463601.1,UPF0728 protein-like,1497
NC_035783.1,2637627,2652878,2637627,2652878,111130883,XM_022478151.1,SITS-binding protein-like,15251
NC_035782.1,31543734,31559214,31543734,31559214,111124182,XM_022467044.1,IgGFc-binding protein-like,15480
NC_035784.1,76403666,76407942,76403666,76405215,111134911,XM_022484465.1,circumsporozoite protein-like,1549
NC_035783.1,37239966,37256363,37239966,37256363,111128958,XM_022474933.1,IgGFc-binding protein-like,16397
NC_035783.1,37946500,37963614,37946500,37963614,111131834,XM_022479561.1,IgGFc-binding protein-like,17114
NC_035783.1,36417231,36418963,36417231,36418963,111129240,XM_022475501.1,fukutin-related protein-like,1732
NC_035783.1,18400615,18418241,18400615,18418241,111130101,XM_022476798.1,TATA-box-binding protein-like,17626
NC_035784.1,73123005,73125061,73123005,73125061,111132578,XM_022480403.1,serine-enriched protein-like,2056
NC_035787.1,63555097,63575680,63555097,63575680,111107373,XM_022442562.1,ATR-interacting protein-like,20583
NC_035784.1,54217161,54219269,54217161,54219269,111135138,XM_022484909.1,serine-enriched protein-like,2108
NC_035782.1,31572950,31595624,31572950,31595624,111124183,XM_022467045.1,IgGFc-binding protein-like,22674
NC_035782.1,31862567,31885537,31862567,31885537,111124190,XM_022467052.1,IgGFc-binding protein-like,22970
NC_035788.1,26758526,26760834,26758526,26760834,111115165,XM_022453807.1,IgGFc-binding protein-like,2308
NC_035788.1,11811976,11814351,11811976,11814351,111113304,XM_022451469.1,IgGFc-binding protein-like,2375
NC_035782.1,37182880,37185274,37182880,37185274,111125301,XM_022468923.1,IgGFc-binding protein-like,2394
NC_035784.1,57768461,57798178,57774064,57798178,111134478,XM_022483530.1,CAD protein-like,24114
NC_035784.1,38006841,38031006,38006841,38031006,111134789,XM_022484154.1,MLX-interacting protein-like,24165
NC_035781.1,49923710,49926241,49923710,49926241,111121892,XM_022463367.1,UPF0728 protein-like,2531
NC_035786.1,30308662,30311240,30308662,30311240,111103810,XM_022437305.1,headcase protein-like,2578
NC_035786.1,32769808,32772387,32769808,32772387,111103739,XM_022437181.1,headcase protein-like,2579
NC_035784.1,78136729,78139338,78136729,78139338,111133641,XM_022482166.1,emopamil-binding protein-like,2609
NC_035782.1,67493775,67496421,67493775,67496421,111127419,XM_022472593.1,IgGFc-binding protein-like,2646
NC_035782.1,36249719,36252423,36249719,36252423,111125889,XM_022470108.1,IgGFc-binding protein-like,2704
NC_035789.1,32474302,32477024,32474302,32477024,111117860,XM_022457087.1,IgGFc-binding protein-like,2722
NC_035787.1,68408181,68435977,68408181,68435977,111107106,XM_022442100.1,prestalk protein-like,27796
NC_035784.1,57768461,57798178,57769189,57798178,111134478,XM_022483529.1,CAD protein-like,28989
NC_035783.1,25564345,25567278,25564345,25567278,111131564,XM_022479159.1,KIF1-binding protein-like,2933
NC_035784.1,57768461,57798178,57768641,57798178,111134478,XM_022483528.1,CAD protein-like,29537
NC_035784.1,57768461,57798178,57768461,57798178,111134478,XM_022483526.1,CAD protein-like,29717
NC_035781.1,15571176,15574152,15571176,15574152,111118406,XM_022457858.1,MRG/MORF4L-binding protein-like,2976
NC_035780.1,14144439,14147648,14144439,14147435,111116664,XM_022455669.1,IgGFc-binding protein-like,2996
NC_035783.1,27746166,27749248,27746166,27749248,111127944,XM_022473273.1,KIF1-binding protein-like,3082
NC_035781.1,504632,535820,504632,535820,111120905,XM_022461933.1,FYN-binding protein-like,31188
NC_035784.1,59778180,59819261,59778180,59809420,111134561,XM_022483692.1,msx2-interacting protein-like,31240
NC_035780.1,14144439,14147648,14144439,14147648,111116664,XM_022455663.1,IgGFc-binding protein-like,3209
NC_035784.1,3300854,3333609,3300854,3333609,111134293,XM_022483193.1,C-Maf-inducing protein-like,32755
NC_035784.1,65915241,65918544,65915241,65918544,111134835,XM_022484276.1,homeodomain-only protein-like,3303
NC_035782.1,67482658,67486062,67482658,67486062,111127171,XM_022472237.1,IgGFc-binding protein-like,3404
NC_035789.1,7946826,7997902,7956870,7991333,111116869,XM_022455914.1,MYCBP-associated protein-like,34463
NC_035784.1,86307820,86345109,86310481,86345109,111136917,XM_022488089.1,NF-kappa-B-activating protein-like,34628
NC_035788.1,12127919,12133061,12129572,12133061,111115890,XM_022454789.1,IgGFc-binding protein-like,3489
NC_035789.1,7946826,7997902,7956234,7991336,111116869,XM_022455913.1,MYCBP-associated protein-like,35102
NC_035789.1,7946826,7997902,7956234,7991337,111116869,XM_022455912.1,MYCBP-associated protein-like,35103
NC_035785.1,5585359,5588875,5585359,5588875,111099449,XM_022430729.1,IgGFc-binding protein-like,3516
NC_035789.1,7946826,7997902,7946827,7982124,111116869,XM_022455904.1,MYCBP-associated protein-like,35297
NC_035784.1,54290369,54326859,54290369,54326859,111135132,XM_022484891.1,NFATC2-interacting protein-like,36490
NC_035784.1,86307820,86345109,86307847,86345109,111136917,XM_022488086.1,NF-kappa-B-activating protein-like,37262
NC_035784.1,86307820,86345109,86307820,86345109,111136917,XM_022488088.1,NF-kappa-B-activating protein-like,37289
NC_035781.1,2265324,2269119,2265324,2269119,111121755,XM_022463182.1,circumsporozoite protein-like,3795
NC_035787.1,65095644,65099479,65095644,65099479,111109297,XM_022445378.1,IgGFc-binding protein-like,3835
NC_035789.1,7946826,7997902,7946827,7986371,111116869,XM_022455903.1,MYCBP-associated protein-like,39544
NC_035786.1,47640240,47644228,47640240,47644228,111104778,XM_022438901.1,translocator protein-like,3988
NC_035782.1,1633313,1637315,1633313,1637315,111126854,XM_022471762.1,circumsporozoite protein-like,4002
NC_035784.1,59778180,59819261,59778180,59819261,111134561,XM_022483691.1,msx2-interacting protein-like,41081
NC_035786.1,46884360,46888623,46884360,46888623,111104785,XM_022438917.1,translocator protein-like,4263
NC_035784.1,76403666,76407942,76403666,76407942,111134911,XM_022484466.1,circumsporozoite protein-like,4276
NC_035783.1,41670291,41713350,41670291,41713350,111128961,XM_022474936.1,TALPID3 protein-like,43059
NC_035782.1,22422375,22426685,22422375,22426683,111126466,XM_022471147.1,circumsporozoite protein-like,4308
NC_035782.1,22422375,22426685,22422375,22426685,111126466,XM_022471146.1,circumsporozoite protein-like,4310
NC_035783.1,40029781,40073935,40030623,40073935,111129224,XM_022475476.1,TALPID3 protein-like,43312
NC_035789.1,7946826,7997902,7946828,7990215,111116869,XM_022455911.1,MYCBP-associated protein-like,43387
NC_035788.1,26977714,26987318,26982912,26987311,111115546,XM_022454322.1,IgGFc-binding protein-like,4399
NC_035783.1,40029781,40073935,40029781,40073935,111129224,XM_022475477.1,TALPID3 protein-like,44154
NC_035789.1,7946826,7997902,7946829,7991326,111116869,XM_022455907.1,MYCBP-associated protein-like,44497
NC_035789.1,7946826,7997902,7946828,7991332,111116869,XM_022455902.1,MYCBP-associated protein-like,44504
NC_035789.1,7946826,7997902,7946827,7991333,111116869,XM_022455906.1,MYCBP-associated protein-like,44506
NC_035789.1,7946826,7997902,7946827,7991334,111116869,XM_022455905.1,MYCBP-associated protein-like,44507
NC_035789.1,7946826,7997902,7946826,7991338,111116869,XM_022455901.1,MYCBP-associated protein-like,44512
NC_035789.1,7946826,7997902,7946826,7991339,111116869,XM_022455900.1,MYCBP-associated protein-like,44513
NC_035789.1,7946826,7997902,7946826,7991340,111116869,XM_022455899.1,MYCBP-associated protein-like,44514
NC_035786.1,43457861,43462354,43457861,43462354,111105252,XM_022439426.1,circumsporozoite protein-like,4493
NC_035781.1,3071567,3076103,3071567,3076103,111119568,XM_022459841.1,PRKCA-binding protein-like,4536
NC_035783.1,44496405,44501126,44496405,44501126,111128836,XM_022474727.1,crystal protein-like,4721
NC_035789.1,7946826,7997902,7946828,7996112,111116869,XM_022455909.1,MYCBP-associated protein-like,49284
NC_035787.1,36171553,36176495,36171553,36176495,111108989,XM_022445078.1,IgGFc-binding protein-like,4942
NC_035789.1,32621978,32627095,32621978,32627034,111117691,XM_022456855.1,IgGFc-binding protein-like,5056
NC_035788.1,8414114,8414623,8414114,8414623,111112597,XM_022450168.1,circumsporozoite protein-like,509
NC_035787.1,39210105,39215197,39210105,39215197,111107180,XM_022442224.1,IgGFc-binding protein-like,5092
NC_035789.1,7946826,7997902,7946827,7997902,111116869,XM_022455908.1,MYCBP-associated protein-like,51075
NC_035789.1,32621978,32627095,32621978,32627095,111117691,XM_022456856.1,IgGFc-binding protein-like,5117
NC_035788.1,12127919,12133061,12127919,12133061,111115890,XM_022454792.1,IgGFc-binding protein-like,5142
NC_035782.1,61065834,61071250,61065844,61071121,111122527,XM_022464314.1,calcyclin-binding protein-like,5277
NC_035787.1,34456488,34462573,34457175,34462573,111105679,XM_022440029.1,IgGFc-binding protein-like,5398
NC_035788.1,26931142,26936557,26931142,26936557,111110904,XM_022447565.1,IgGFc-binding protein-like,5415
NC_035782.1,61065834,61071250,61065834,61071250,111122527,XM_022464315.1,calcyclin-binding protein-like,5416
NC_035781.1,48712057,48717970,48712274,48717970,111121437,XM_022462727.1,STAM-binding protein-like,5696
NC_035788.1,11728361,11734143,11728361,11734143,111113305,XM_022451470.1,IgGFc-binding protein-like,5782
NC_035784.1,40211879,40225509,40211879,40217726,111136676,XM_022487710.1,AKT-interacting protein-like,5847
NC_035781.1,48712057,48717970,48712057,48717970,111121437,XM_022462726.1,STAM-binding protein-like,5913
NC_035786.1,56645106,56651026,56645106,56651026,111103915,XM_022437537.1,MLX-interacting protein-like,5920
NC_035787.1,34456488,34462573,34456488,34462573,111105679,XM_022440028.1,IgGFc-binding protein-like,6085
NC_035784.1,85028013,85036221,85030006,85036221,111136533,XM_022487452.1,toll-interacting protein-like,6215
NC_035782.1,63107948,63114198,63107948,63114198,111125519,XM_022469435.1,UPF0184 protein-like,6250
NC_035780.1,14613290,14619708,14613290,14619708,111138517,XM_022490535.1,IgGFc-binding protein-like,6418
NC_035786.1,48608609,48617068,48610552,48617068,111104767,XM_022438882.1,toll-interacting protein-like,6516
NC_035788.1,26787172,26793725,26787172,26793725,111115196,XM_022453849.1,IgGFc-binding protein-like,6553
NC_035784.1,40211879,40225509,40211879,40218494,111136676,XM_022487709.1,AKT-interacting protein-like,6615
NC_035781.1,4974837,4981456,4974837,4981456,111118333,XM_022457738.1,phosphotriesterase-related protein-like,6619
NC_035784.1,2561288,2568673,2561288,2568673,111136104,XM_022486710.1,asparagine-rich protein-like,7385
NC_035784.1,82712220,82719719,82712220,82719711,111136686,XM_022487730.1,asparagine-rich protein-like,7491
NC_035784.1,82712220,82719719,82712220,82719719,111136686,XM_022487729.1,asparagine-rich protein-like,7499
NC_035783.1,42634887,42642441,42634887,42642431,111130618,XM_022477783.1,synaptojanin-2-binding protein-like,7544
NC_035783.1,42634887,42642441,42634887,42642441,111130618,XM_022477784.1,synaptojanin-2-binding protein-like,7554
NC_035785.1,35582879,35592761,35582879,35590487,111100049,XM_022431637.1,IgGFc-binding protein-like,7608
NC_035781.1,49158215,49165876,49158215,49165876,111121253,XM_022462427.1,STAM-binding protein-like,7661
NC_035785.1,3627620,3628407,3627620,3628407,111100704,XM_022432788.1,TATA-box-binding protein-like,787
NC_035784.1,82629591,82708452,82629591,82708452,111137252,XM_022488639.1,asparagine-rich protein-like,78861
NC_035784.1,40211879,40225509,40211879,40219778,111136676,XM_022487708.1,AKT-interacting protein-like,7899
NC_035781.1,12491115,12499032,12491115,12499032,111118874,XM_022458561.1,asparagine-rich protein-like,7917
NC_035788.1,11844285,11845094,11844285,11845094,111113487,XM_022451783.1,IgGFc-binding protein-like,809
NC_035784.1,85028013,85036221,85028013,85036221,111136533,XM_022487450.1,toll-interacting protein-like,8208
NC_035786.1,14759241,14767496,14759241,14767496,111102916,XM_022435862.1,C-Myc-binding protein-like,8255
NC_035788.1,26918957,26927350,26918957,26927350,111110903,XM_022447564.1,IgGFc-binding protein-like,8393
NC_035786.1,48608609,48617068,48608614,48617068,111104767,XM_022438881.1,toll-interacting protein-like,8454
NC_035786.1,48608609,48617068,48608609,48617068,111104767,XM_022438880.1,toll-interacting protein-like,8459
NC_035788.1,12122926,12123773,12122926,12123773,111111175,XM_022447994.1,IgGFc-binding protein-like,847
NC_035786.1,30175571,30184087,30175571,30184087,111105271,XM_022439453.1,CREB-binding protein-like,8516
NC_035786.1,34714010,34714865,34714010,34714865,111103283,XM_022436417.1,serine-enriched protein-like,855
NC_035788.1,26977714,26987318,26977750,26986307,111115546,XM_022454323.1,IgGFc-binding protein-like,8557
NC_035784.1,59201661,59210317,59201661,59210317,111099073,XM_022430426.1,BRCA1-associated protein-like,8656
NC_035786.1,34710728,34711605,34710728,34711605,111102771,XM_022435638.1,serine-enriched protein-like,877
NC_035785.1,17696633,17705517,17696633,17705517,111099752,XM_022431186.1,threonine-rich protein-like,8884
NC_035788.1,30309925,30318913,30309925,30318913,111115840,XM_022454702.1,mantle protein-like,8988
NC_035788.1,36840351,36849415,36840351,36849415,111115595,XM_022454383.1,mantle protein-like,9064
NC_035785.1,16734225,16743353,16734225,16743353,111101968,XM_022434623.1,threonine-rich protein-like,9128
NC_035786.1,34691102,34692016,34691102,34692016,111103440,XM_022436721.1,serine-enriched protein-like,914
NC_035783.1,44819120,44828349,44819120,44828349,111127732,XM_022472964.1,IgGFc-binding protein-like,9229
NC_035788.1,11615503,11616429,11615503,11616429,111113306,XM_022451471.1,IgGFc-binding protein-like,926
NC_035780.1,2979773,2989042,2979773,2989042,111134776,XM_022484138.1,asparagine-rich protein-like,9269
NC_035782.1,56223994,56233484,56223994,56233484,111127278,XM_022472383.1,PGAP2-interacting protein-like,9490
NC_035782.1,59164916,59174449,59164916,59174449,111125622,XM_022469601.1,hsc70-interacting protein-like,9533
NC_035788.1,26977714,26987318,26977750,26987318,111115546,XM_022454320.1,IgGFc-binding protein-like,9568
NC_035788.1,70924294,70933882,70924294,70933882,111115532,XM_022454299.1,acyl-CoA-binding protein-like,9588
NC_035788.1,26977714,26987318,26977714,26987317,111115546,XM_022454321.1,IgGFc-binding protein-like,9603
NC_035785.1,35582879,35592761,35582879,35592761,111100049,XM_022431636.1,IgGFc-binding protein-like,9882
NC_035786.1,34681580,34682577,34681580,34682577,111105039,XM_022439212.1,serine-enriched protein-like,997
NC_035780.1,1928718,1940217,1928718,1940217,111100652,XM_022432742.1,oxysterol-binding protein-related protein 11-like,11499
NC_035782.1,6672669,6681158,6672669,6681158,111123133,XM_022465273.1,vacuolar protein-sorting-associated protein 25-like,8489
NC_035780.1,50915244,50932491,50915244,50932491,111112650,XM_022450507.1,opioid-binding protein/cell adhesion molecule-like,17247
NC_035783.1,40705653,40706383,40705653,40706383,111131316,XM_022478788.1,cysteine proteinase inhibitor 8-like,730
NC_035780.1,3637454,3642567,3637454,3642567,111111995,XM_022449246.1,microtubule-associated proteins 1A/1B light chain 3A-like,5113
NC_035784.1,2082421,2090565,2082421,2090565,111133361,XM_022481695.1,proline-rich proteoglycan 2-like,8144
NC_035784.1,40823472,40825077,40823472,40825077,111137264,XM_022488655.1,chondroitin proteoglycan-2-like,1605
NC_035786.1,42090815,42102303,42090815,42102303,111104866,XM_022439029.1,PEST proteolytic signal-containing nuclear protein-like,11488
NC_035782.1,63474849,63505042,63474849,63505042,111122895,XM_022464928.1,putative protocadherin beta-18,30193
NC_035780.1,2665069,2670707,2665069,2670707,111114799,XM_022453278.1,V-type proton ATPase subunit C 1-like,5638
NC_035784.1,96245757,96260259,96245757,96260259,111136376,XM_022487179.1,mitochondrial proton/calcium exchanger protein-like,14502
NC_035788.1,40705069,40765022,40705069,40765022,111111795,XM_022448945.1,protein prune homolog 2-like,59953
NC_035784.1,39971228,39976821,39971228,39976821,111133458,XM_022481889.1,tRNA pseudouridine synthase-like 1,5593
NC_035781.1,3225621,3231121,3225621,3231121,111119204,XM_022459135.1,RNA pseudouridylate synthase domain-containing protein 1-like,5500
NC_035780.1,44046423,44053136,44046423,44053136,111126691,XM_022471547.1,protein psiJ-like,6713
NC_035782.1,75174312,75175646,75174312,75175646,111126361,XM_022470925.1,probable pterin-4-alpha-carbinolamine dehydratase,1334
NC_035780.1,9859247,9871110,9859247,9871110,111099502,XM_022430811.1,bifunctional purine biosynthesis protein PURH-like,11863
NC_035780.1,9020939,9022027,9020939,9022027,111137668,XM_022489243.1,P2X purinoceptor 7-like,1088
NC_035780.1,60805745,60806553,60805745,60806553,111108343,XM_022444155.1,protein pxr-1-like,808
NC_035784.1,48237460,48239032,48237460,48239032,111132414,XM_022480216.1,protein pxr1-like,1572
NC_035780.1,55095543,55122735,55096983,55110599,111124119,XM_022467010.1,protein pygopus-like,13616
NC_035783.1,26709799,26712662,26710901,26712662,111130559,XM_022477711.1,protein pygopus-like,1761
NC_035780.1,55095543,55122735,55095543,55116792,111124119,XM_022466986.1,protein pygopus-like,21249
NC_035780.1,55095543,55122735,55095543,55117014,111124119,XM_022467004.1,protein pygopus-like,21471
NC_035780.1,55095543,55122735,55095543,55119181,111124119,XM_022466991.1,protein pygopus-like,23638
NC_035780.1,55095543,55122735,55095543,55122735,111124119,XM_022466998.1,protein pygopus-like,27192
NC_035783.1,26709799,26712662,26709840,26712662,111130559,XM_022477710.1,protein pygopus-like,2822
NC_035783.1,26709799,26712662,26709799,26712662,111130559,XM_022477709.1,protein pygopus-like,2863
NC_035782.1,48187714,48192397,48187714,48192397,111122903,XM_022464937.1,cyclic pyranopterin monophosphate synthase,4683
NC_035781.1,47364513,47380392,47364513,47380392,111122387,XM_022464156.1,putative pyridoxal-dependent decarboxylase domain-containing protein 2,15879
NC_035784.1,11910171,11919232,11910171,11919232,111135490,XM_022485608.1,dCTP pyrophosphatase 1-like,9061
NC_035784.1,4968744,4976971,4968744,4976544,111136071,XM_022486660.1,ADP-ribose pyrophosphatase,7800
NC_035784.1,4968744,4976971,4968744,4976971,111136071,XM_022486661.1,ADP-ribose pyrophosphatase,8227
NC_035784.1,4595542,4604504,4595542,4604116,111134201,XM_022483049.1,ADP-ribose pyrophosphatase,8574
NC_035784.1,4595542,4604504,4595543,4604483,111134201,XM_022483051.1,ADP-ribose pyrophosphatase,8940
NC_035784.1,4595542,4604504,4595543,4604504,111134201,XM_022483050.1,ADP-ribose pyrophosphatase,8961
NC_035781.1,37115548,37152880,37130684,37152566,111118584,XM_022458129.1,inorganic pyrophosphatase-like,21882
NC_035781.1,37115548,37152880,37130684,37152880,111118584,XM_022458127.1,inorganic pyrophosphatase-like,22196
NC_035781.1,37115548,37152880,37115548,37152880,111118584,XM_022458128.1,inorganic pyrophosphatase-like,37332
NC_035787.1,34196330,34202021,34197634,34202021,111110100,XM_022446459.1,ADP-sugar pyrophosphatase-like,4387
NC_035787.1,34196330,34202021,34196330,34202021,111110100,XM_022446458.1,ADP-sugar pyrophosphatase-like,5691
NC_035787.1,39417084,39423626,39417084,39423626,111109844,XM_022446093.1,ADP-sugar pyrophosphatase-like,6542
NC_035781.1,37225332,37235170,37225332,37235170,111118590,XM_022458133.1,inorganic pyrophosphatase-like,9838
NC_035781.1,54607891,54612688,54607891,54612688,111120818,XM_022461803.1,ectonucleotide pyrophosphatase/phosphodiesterase family member 5-like,4797
NC_035780.1,10537627,10547456,10537627,10547456,111120824,XM_022461812.1,farnesyl pyrophosphate synthase-like,9829
NC_035782.1,65391777,65398150,65391777,65398150,111123753,XM_022466313.1,ribose-phosphate pyrophosphokinase 1-like,6373
NC_035784.1,18606306,18620254,18606306,18620254,111136113,XM_022486733.1,nicotinate-nucleotide pyrophosphorylase [carboxylating]-like,13948
NC_035780.1,36515033,36525864,36515033,36525863,111129163,XM_022475338.1,UDP-N-acetylhexosamine pyrophosphorylase-like,10830
NC_035780.1,36515033,36525864,36515033,36525864,111129163,XM_022475358.1,UDP-N-acetylhexosamine pyrophosphorylase-like,10831
NC_035780.1,36445871,36459322,36445878,36459322,111129139,XM_022475290.1,UDP-N-acetylhexosamine pyrophosphorylase-like,13444
NC_035780.1,36445871,36459322,36445876,36459322,111129139,XM_022475315.1,UDP-N-acetylhexosamine pyrophosphorylase-like,13446
NC_035780.1,36445871,36459322,36445871,36459322,111129139,XM_022475306.1,UDP-N-acetylhexosamine pyrophosphorylase-like,13451
NC_035780.1,36515033,36525864,36515365,36525224,111129163,XM_022475327.1,UDP-N-acetylhexosamine pyrophosphorylase-like,9859
NC_035785.1,554018,561412,554018,561412,111100274,XM_022431961.1,mitochondrial pyruvate carrier 1-like,7394
NC_035783.1,27902822,27904642,27902822,27904641,111130414,XM_022477484.1,protein qua-1-like,1819
NC_035783.1,27902822,27904642,27902822,27904642,111130414,XM_022477483.1,protein qua-1-like,1820
NC_035788.1,18573952,18575878,18573952,18575878,111115584,XM_022454374.1,protein qua-1-like,1926
NC_035785.1,40355784,40388638,40355784,40388636,111100788,XM_022432883.1,protein quaking-B-like,32852
NC_035785.1,40355784,40388638,40355784,40388637,111100788,XM_022432884.1,protein quaking-B-like,32853
NC_035785.1,40355784,40388638,40355784,40388638,111100788,XM_022432879.1,protein quaking-B-like,32854
NC_035785.1,50749437,50783058,50749437,50783058,111101020,XM_022433229.1,protein quaking-B-like,33621
NC_035780.1,10716271,10727358,10716271,10727358,111102318,XM_022435000.1,protein quiver-like,11087
NC_035780.1,11521486,11529987,11521492,11529987,111113075,XM_022451049.1,protein quiver-like,8495
NC_035780.1,11521486,11529987,11521486,11529987,111113075,XM_022451055.1,protein quiver-like,8501
NC_035780.1,11532913,11542703,11532913,11542703,111101281,XM_022433726.1,protein quiver-like,9790
NC_035780.1,10703811,10713675,10703811,10713675,111100550,XM_022432546.1,protein quiver-like,9864
NC_035784.1,4147378,4160678,4147378,4160678,111136820,XM_022487944.1,25S rRNA (cytosine-C(5))-methyltransferase nop2-like,13300
NC_035781.1,842274,845965,842274,845965,111120087,XM_022460750.1,probable rRNA-processing protein EBP2,3691
NC_035784.1,17213440,17228733,17213441,17228733,111137347,XM_022488784.1,serine racemase-like,15292
NC_035784.1,17213440,17228733,17213440,17228733,111137347,XM_022488785.1,serine racemase-like,15293
NC_035784.1,17159371,17176944,17159371,17176923,111137345,XM_022488783.1,serine racemase-like,17552
NC_035784.1,17159371,17176944,17159371,17176944,111137345,XM_022488782.1,serine racemase-like,17573
NC_035784.1,17234922,17240848,17234922,17240848,111137350,XM_022488789.1,serine racemase-like,5926
NC_035783.1,49521161,49530846,49521161,49530846,111128323,XM_022473895.1,alpha-methylacyl-CoA racemase-like,9685
NC_035784.1,81798605,81817553,81798605,81817553,111132667,XM_022480492.1,UV radiation resistance-associated gene protein-like,18948
NC_035782.1,40476067,40486701,40476067,40486701,111126237,XM_022470726.1,Golgi reassembly-stacking protein 2-like,10634
NC_035780.1,511797,526500,511797,526500,111135169,XM_022484983.1,glutamate receptor ionotropic,14703
NC_035780.1,3559448,3572274,3559448,3572274,111126076,XM_022470483.1,TNF receptor-associated factor 6-like,12826
NC_035781.1,11965873,11978747,11965873,11978747,111120615,XM_022461462.1,nuclear receptor-binding protein-like,12874
NC_035783.1,11921135,11956116,11921135,11956116,111129874,XM_022476371.1,thyroid receptor-interacting protein 11-like,34981
NC_035780.1,57747026,57749650,57747026,57749650,111125465,XM_022469341.1,proline-rich receptor-like protein kinase PERK2,2624
NC_035782.1,72985294,72986307,72985294,72986307,111124434,XM_022467286.1,trissin receptor-like,1013
NC_035782.1,71222069,71223116,71222069,71223116,111124429,XM_022467281.1,trissin receptor-like,1047
NC_035787.1,51966657,51977214,51966663,51977214,111110165,XM_022446554.1,angiopoietin-1 receptor-like,10551
NC_035787.1,35589814,35625201,35589814,35600809,111108361,XM_022444185.1,FMRFamide receptor-like,10995
NC_035784.1,66084998,66086112,66084998,66086112,111133431,XM_022481856.1,oxytocin receptor-like,1114
NC_035780.1,970363,981628,970363,981628,111110627,XM_022447205.1,FMRFamide receptor-like,11265
NC_035780.1,18451379,18569073,18451379,18569073,111111133,XM_022448046.1,secretin receptor-like,117694
NC_035787.1,50955882,50967787,50955882,50967787,111110431,XM_022446929.1,FMRFamide receptor-like,11905
NC_035788.1,65920322,65996132,65920322,65932409,111113428,XM_022451710.1,5-hydroxytryptamine receptor-like,12087
NC_035784.1,71961866,71963087,71961866,71963087,111099224,XM_022430664.1,octopamine receptor-like,1221
NC_035781.1,21305476,21429392,21305476,21427968,111119607,XM_022459946.1,allatostatin-A receptor-like,122492
NC_035782.1,64426919,64428150,64426919,64428150,111127100,XM_022472121.1,tyramine/octopamine receptor-like,1231
NC_035781.1,21305476,21429392,21305476,21429392,111119607,XM_022459951.1,allatostatin-A receptor-like,123916
NC_035786.1,45880815,45900951,45880815,45893264,111103786,XM_022437257.1,pyrokinin-1 receptor-like,12449
NC_035781.1,52454631,52467536,52455076,52467536,111119109,XM_022458960.1,RYamide receptor-like,12460
NC_035783.1,26425932,26427191,26425932,26427191,111129577,XM_022476032.1,RYamide receptor-like,1259
NC_035781.1,29356502,29369267,29356502,29369267,111121917,XM_022463405.1,pyrokinin-1 receptor-like,12765
NC_035781.1,27783105,27784395,27783105,27784395,111119481,XM_022459678.1,FMRFamide receptor-like,1290
NC_035782.1,67999729,68023266,68010257,68023266,111122959,XM_022465004.1,cholecystokinin receptor-like,13009
NC_035782.1,43875308,43876610,43875308,43876610,111124259,XM_022467113.1,psychosine receptor-like,1302
NC_035781.1,25933357,25934664,25933357,25934664,111122279,XM_022463931.1,substance-K receptor-like,1307
NC_035781.1,27278838,27291985,27278838,27291985,111120207,XM_022460936.1,RYamide receptor-like,13147
NC_035785.1,21784495,21811645,21784495,21797861,111100098,XM_022431712.1,pyrokinin-1 receptor-like,13366
NC_035782.1,64432807,64434184,64432807,64434184,111126572,XM_022471311.1,cholecystokinin receptor-like,1377
NC_035781.1,52511470,52546451,52532183,52546450,111119110,XM_022458963.1,FMRFamide receptor-like,14267
NC_035781.1,17878069,17892377,17878069,17892377,111121937,XM_022463436.1,allatostatin-A receptor-like,14308
NC_035784.1,36565884,36590195,36565884,36580336,111133802,XM_022482473.1,FMRFamide receptor-like,14452
NC_035784.1,36565884,36590195,36565884,36580339,111133802,XM_022482475.1,FMRFamide receptor-like,14455
NC_035785.1,45066106,45094312,45079844,45094312,111100013,XM_022431575.1,pyrokinin-1 receptor-like,14468
NC_035785.1,19096161,19110652,19096161,19110652,111100850,XM_022432961.1,secretin receptor-like,14491
NC_035781.1,18908559,18923113,18908559,18923113,111122039,XM_022463566.1,allatostatin-A receptor-like,14554
NC_035784.1,19136540,19138007,19136540,19138007,111133960,XM_022482706.1,apelin receptor-like,1467
NC_035781.1,28936260,28950972,28936260,28950972,111121819,XM_022463248.1,substance-K receptor-like,14712
NC_035781.1,28886728,28888212,28886728,28888212,111119199,XM_022459124.1,FMRFamide receptor-like,1484
NC_035781.1,14537217,14552110,14537217,14552110,111120544,XM_022461341.1,substance-K receptor-like,14893
NC_035785.1,19060484,19075395,19060484,19075395,111100848,XM_022432959.1,secretin receptor-like,14911
NC_035781.1,21305476,21429392,21414460,21429392,111119607,XM_022459950.1,allatostatin-A receptor-like,14932
NC_035780.1,18415788,18430754,18415788,18430754,111111059,XM_022447852.1,secretin receptor-like,14966
NC_035785.1,21784495,21811645,21784495,21799549,111100098,XM_022431713.1,pyrokinin-1 receptor-like,15054
NC_035784.1,91474768,91489988,91474768,91489988,111135522,XM_022485669.1,renin receptor-like,15220
NC_035782.1,74416902,74418426,74416902,74418426,111124442,XM_022467296.1,trissin receptor-like,1524
NC_035781.1,52511470,52546451,52531179,52546451,111119110,XM_022458965.1,FMRFamide receptor-like,15272
NC_035780.1,42125091,42140371,42125091,42140371,111126249,XM_022470750.1,FMRFamide receptor-like,15280
NC_035781.1,21305476,21429392,21414051,21429392,111119607,XM_022459952.1,allatostatin-A receptor-like,15341
NC_035781.1,27832529,27848240,27832529,27848240,111121930,XM_022463429.1,substance-K receptor-like,15711
NC_035788.1,66751549,66767269,66751549,66767269,111114491,XM_022452809.1,5-hydroxytryptamine receptor-like,15720
NC_035781.1,36540824,36556781,36540924,36556780,111118421,XM_022457895.1,substance-P receptor-like,15856
NC_035781.1,36540824,36556781,36540850,36556781,111118421,XM_022457893.1,substance-P receptor-like,15931
NC_035781.1,36540824,36556781,36540824,36556781,111118421,XM_022457894.1,substance-P receptor-like,15957
NC_035781.1,3748228,3764203,3748228,3764203,111122002,XM_022463521.1,allatostatin-A receptor-like,15975
NC_035787.1,5646701,5648309,5646701,5648309,111110483,XM_022446997.1,FMRFamide receptor-like,1608
NC_035784.1,27541329,27557480,27541329,27557480,111137460,XM_022488924.1,FMRFamide receptor-like,16151
NC_035782.1,64443432,64445049,64443432,64445049,111126148,XM_022470573.1,octopamine receptor-like,1617
NC_035785.1,45066106,45094312,45078119,45094312,111100013,XM_022431576.1,pyrokinin-1 receptor-like,16193
NC_035781.1,28326236,28342604,28326236,28342604,111120215,XM_022460945.1,RYamide receptor-like,16368
NC_035784.1,40670634,40687330,40670634,40687330,111132976,XM_022480966.1,FMRFamide receptor-like,16696
NC_035785.1,40754898,40756587,40754898,40756587,111100130,XM_022431755.1,trissin receptor-like,1689
NC_035784.1,44858061,44859753,44858061,44859753,111138361,XM_022490288.1,nociceptin receptor-like,1692
NC_035782.1,48327816,48372324,48327817,48344786,111126791,XM_022471661.1,FMRFamide receptor-like,16969
NC_035783.1,53178138,53179839,53178138,53179839,111129756,XM_022476225.1,octopamine receptor-like,1701
NC_035781.1,14552890,14570030,14552890,14570030,111120545,XM_022461342.1,substance-K receptor-like,17140
NC_035784.1,17324564,17353123,17324564,17341833,111136552,XM_022487487.1,pyrokinin-1 receptor-like,17269
NC_035782.1,64440101,64441842,64440101,64441842,111126925,XM_022471870.1,cholecystokinin receptor-like,1741
NC_035781.1,52412242,52429690,52412242,52429690,111119111,XM_022458966.1,RYamide receptor-like,17448
NC_035781.1,36578196,36606059,36578196,36595657,111118486,XM_022457988.1,substance-P receptor-like,17461
NC_035782.1,11838960,11856565,11838960,11856565,111122997,XM_022465067.1,sortilin-related receptor-like,17605
NC_035787.1,8416209,8417977,8416209,8417977,111110310,XM_022446748.1,FMRFamide receptor-like,1768
NC_035781.1,45197296,45215118,45197296,45215118,111120338,XM_022461060.1,RYamide receptor-like,17822
NC_035782.1,65183308,65201239,65183308,65201239,111124574,XM_022467536.1,cholecystokinin receptor-like,17931
NC_035785.1,45126437,45145803,45127635,45145803,111101508,XM_022434030.1,angiopoietin-1 receptor-like,18168
NC_035788.1,65920322,65996132,65920322,65939627,111113428,XM_022451711.1,5-hydroxytryptamine receptor-like,19305
NC_035785.1,45126437,45145803,45126437,45145803,111101508,XM_022434031.1,angiopoietin-1 receptor-like,19366
NC_035788.1,89650646,89706644,89650646,89670098,111111707,XM_022448840.1,kiSS-1 receptor-like,19452
NC_035780.1,18451379,18569073,18451379,18470892,111111133,XM_022447975.1,secretin receptor-like,19513
NC_035781.1,6171088,6198265,6171449,6191230,111120050,XM_022460693.1,speract receptor-like,19781
NC_035784.1,67590772,67596289,67594289,67596289,111132214,XM_022480003.1,angiopoietin-1 receptor-like,2000
NC_035783.1,5791880,5811929,5791880,5811929,111130432,XM_022477505.1,thyrotropin receptor-like,20049
NC_035786.1,45880815,45900951,45880815,45900951,111103786,XM_022437256.1,pyrokinin-1 receptor-like,20136
NC_035781.1,6171088,6198265,6171449,6192011,111120050,XM_022460695.1,speract receptor-like,20562
NC_035788.1,65920322,65996132,65920322,65941708,111113428,XM_022451712.1,5-hydroxytryptamine receptor-like,21386
NC_035783.1,29213413,29215591,29213413,29215591,111129392,XM_022475752.1,PDF receptor-like,2178
NC_035788.1,88206631,88250536,88206631,88228450,111111081,XM_022447848.1,kiSS-1 receptor-like,21819
NC_035780.1,8169904,8172094,8169904,8172094,111123911,XM_022466620.1,FMRFamide receptor-like,2190
NC_035781.1,37991876,38014396,37991876,38014396,111121896,XM_022463375.1,allatostatin-A receptor-like,22520
NC_035787.1,35589814,35625201,35589814,35612350,111108361,XM_022444184.1,FMRFamide receptor-like,22536
NC_035788.1,75455267,75494577,75472035,75494577,111114689,XM_022453114.1,secretin receptor-like,22542
NC_035784.1,36522572,36547259,36522572,36545987,111133803,XM_022482478.1,FMRFamide receptor-like,23415
NC_035780.1,43111,66897,43111,66897,111110729,XM_022447324.1,FMRFamide receptor-like,23786
NC_035784.1,36565884,36590195,36565884,36590195,111133802,XM_022482477.1,FMRFamide receptor-like,24311
NC_035787.1,5606802,5631206,5606802,5631206,111105770,XM_022440155.1,FMRFamide receptor-like,24404
NC_035783.1,29785091,29787546,29785091,29787546,111130475,XM_022477576.1,PDF receptor-like,2455
NC_035784.1,44161978,44164445,44161978,44164445,111099032,XM_022430343.1,5-hydroxytryptamine receptor-like,2467
NC_035784.1,36522572,36547259,36522572,36547259,111133803,XM_022482479.1,FMRFamide receptor-like,24687
NC_035787.1,35589814,35625201,35589814,35615694,111108361,XM_022444181.1,FMRFamide receptor-like,25880
NC_035784.1,11003937,11006560,11003937,11006560,111132899,XM_022480827.1,prostacyclin receptor-like,2623
NC_035781.1,6171088,6198265,6171449,6198265,111120050,XM_022460694.1,speract receptor-like,26816
NC_035782.1,8104591,8131658,8104591,8131658,111126929,XM_022471876.1,allatostatin-A receptor-like,27067
NC_035785.1,21784495,21811645,21784495,21811645,111100098,XM_022431714.1,pyrokinin-1 receptor-like,27150
NC_035781.1,6171088,6198265,6171088,6198264,111120050,XM_022460696.1,speract receptor-like,27176
NC_035788.1,80301011,80329555,80302358,80329555,111114928,XM_022453475.1,calcitonin receptor-like,27197
NC_035784.1,58300980,58328417,58300980,58328417,111132944,XM_022480902.1,cholecystokinin receptor-like,27437
NC_035788.1,62011296,62039130,62011296,62039130,111115534,XM_022454302.1,PDF receptor-like,27834
NC_035781.1,36578196,36606059,36578204,36606059,111118486,XM_022457990.1,substance-P receptor-like,27855
NC_035781.1,36578196,36606059,36578196,36606057,111118486,XM_022457987.1,substance-P receptor-like,27861
NC_035785.1,45066106,45094312,45066106,45094312,111100013,XM_022431578.1,pyrokinin-1 receptor-like,28206
NC_035788.1,80301011,80329555,80301011,80329555,111114928,XM_022453474.1,calcitonin receptor-like,28544
NC_035784.1,17324564,17353123,17324564,17353111,111136552,XM_022487485.1,pyrokinin-1 receptor-like,28547
NC_035784.1,17324564,17353123,17324564,17353123,111136552,XM_022487486.1,pyrokinin-1 receptor-like,28559
NC_035788.1,75455267,75494577,75465156,75494577,111114689,XM_022453113.1,secretin receptor-like,29421
NC_035780.1,32687189,32690145,32687189,32690145,111131664,XM_022479303.1,PDF receptor-like,2956
NC_035788.1,63913648,63977637,63913648,63945723,111113319,XM_022451506.1,ecdysone receptor-like,32075
NC_035780.1,34782429,34785745,34782429,34785745,111109974,XM_022446274.1,FMRFamide receptor-like,3316
NC_035781.1,27832529,27848240,27844910,27848240,111121930,XM_022463430.1,substance-K receptor-like,3330
NC_035780.1,43111,66897,43111,46506,111110729,XM_022447333.1,FMRFamide receptor-like,3395
NC_035781.1,52511470,52546451,52511470,52546449,111119110,XM_022458962.1,FMRFamide receptor-like,34979
NC_035783.1,32058529,32093829,32058529,32093829,111128530,XM_022474166.1,ryanodine receptor-like,35300
NC_035787.1,35589814,35625201,35589814,35625201,111108361,XM_022444183.1,FMRFamide receptor-like,35387
NC_035781.1,28936260,28950972,28947427,28950972,111121819,XM_022463249.1,substance-K receptor-like,3545
NC_035782.1,11482294,11518011,11482294,11518011,111122745,XM_022464631.1,sortilin-related receptor-like,35717
NC_035784.1,67590772,67596289,67592647,67596289,111132214,XM_022479999.1,angiopoietin-1 receptor-like,3642
NC_035783.1,31750051,32121457,31750051,32121457,111128529,XM_022474165.1,ryanodine receptor-like,371406
NC_035788.1,63913648,63977637,63913648,63952758,111113319,XM_022451504.1,ecdysone receptor-like,39110
NC_035788.1,75455267,75494577,75455267,75494577,111114689,XM_022453112.1,secretin receptor-like,39310
NC_035788.1,69894043,69898069,69894125,69898069,111115824,XM_022454688.1,cholecystokinin receptor-like,3944
NC_035781.1,21991966,22031474,21991966,22031474,111119192,XM_022459094.1,angiopoietin-1 receptor-like,39508
NC_035782.1,48327816,48372324,48327816,48367675,111126791,XM_022471660.1,FMRFamide receptor-like,39859
NC_035788.1,69894043,69898069,69894063,69898069,111115824,XM_022454685.1,cholecystokinin receptor-like,4006
NC_035788.1,69894043,69898069,69894043,69898069,111115824,XM_022454686.1,cholecystokinin receptor-like,4026
NC_035782.1,27724195,27728234,27724195,27728234,111122733,XM_022464615.1,octopressin receptor-like,4039
NC_035787.1,8434653,8438699,8434653,8438699,111110639,XM_022447221.1,FMRFamide receptor-like,4046
NC_035788.1,63913648,63977637,63913648,63954283,111113319,XM_022451502.1,ecdysone receptor-like,40635
NC_035787.1,5606802,5631206,5627134,5631206,111105770,XM_022440154.1,FMRFamide receptor-like,4072
NC_035782.1,48327816,48372324,48327817,48368651,111126791,XM_022471658.1,FMRFamide receptor-like,40834
NC_035782.1,48327816,48372324,48327816,48368651,111126791,XM_022471654.1,FMRFamide receptor-like,40835
NC_035780.1,30922110,30926211,30922110,30926211,111119595,XM_022459918.1,FMRFamide receptor-like,4101
NC_035788.1,27704158,27708805,27704158,27708455,111114506,XM_022452841.1,angiopoietin-1 receptor-like,4297
NC_035788.1,88206631,88250536,88206631,88250536,111111081,XM_022447847.1,kiSS-1 receptor-like,43905
NC_035788.1,65920322,65996132,65920322,65964747,111113428,XM_022451708.1,5-hydroxytryptamine receptor-like,44425
NC_035782.1,48327816,48372324,48327816,48372323,111126791,XM_022471659.1,FMRFamide receptor-like,44507
NC_035782.1,48327816,48372324,48327816,48372324,111126791,XM_022471655.1,FMRFamide receptor-like,44508
NC_035784.1,39875978,39880451,39875978,39880451,111137048,XM_022488276.1,pyrokinin-1 receptor-like,4473
NC_035788.1,2973639,3038278,2973639,3018722,111112963,XM_022450859.1,secretin receptor-like,45083
NC_035788.1,27704158,27708805,27704158,27708805,111114506,XM_022452840.1,angiopoietin-1 receptor-like,4647
NC_035784.1,40670634,40687330,40682670,40687330,111132976,XM_022480965.1,FMRFamide receptor-like,4660
NC_035781.1,21305476,21429392,21424609,21429392,111119607,XM_022459948.1,allatostatin-A receptor-like,4783
NC_035781.1,31072438,31077314,31072438,31077314,111121307,XM_022462521.1,FMRFamide receptor-like,4876
NC_035788.1,63913648,63977637,63913648,63963545,111113319,XM_022451503.1,ecdysone receptor-like,49897
NC_035788.1,63913648,63977637,63913648,63964338,111113319,XM_022451500.1,ecdysone receptor-like,50690
NC_035781.1,21305476,21429392,21377159,21427968,111119607,XM_022459947.1,allatostatin-A receptor-like,50809
NC_035788.1,65920322,65996132,65920322,65971567,111113428,XM_022451709.1,5-hydroxytryptamine receptor-like,51245
NC_035788.1,65920322,65996132,65920322,65971848,111113428,XM_022451703.1,5-hydroxytryptamine receptor-like,51526
NC_035788.1,2973639,3038278,2973639,3025364,111112963,XM_022450858.1,secretin receptor-like,51725
NC_035786.1,23670194,23675579,23670194,23675579,111104942,XM_022439119.1,angiopoietin-1 receptor-like,5385
NC_035784.1,67590772,67596289,67590781,67596289,111132214,XM_022480002.1,angiopoietin-1 receptor-like,5508
NC_035784.1,67590772,67596289,67590780,67596289,111132214,XM_022479998.1,angiopoietin-1 receptor-like,5509
NC_035784.1,67590772,67596289,67590774,67596289,111132214,XM_022480000.1,angiopoietin-1 receptor-like,5515
NC_035784.1,67590772,67596289,67590772,67596289,111132214,XM_022480001.1,angiopoietin-1 receptor-like,5517
NC_035788.1,89650646,89706644,89650646,89706644,111111707,XM_022448839.1,kiSS-1 receptor-like,55998
NC_035783.1,23654022,23659690,23654022,23659690,111129491,XM_022475899.1,FMRFamide receptor-like,5668
NC_035781.1,52511470,52546451,52540693,52546451,111119110,XM_022458964.1,FMRFamide receptor-like,5758
NC_035784.1,32342669,32348462,32342669,32348462,111137782,XM_022489429.1,cholecystokinin receptor-like,5793
NC_035788.1,2973639,3038278,2973639,3034314,111112963,XM_022450856.1,secretin receptor-like,60675
NC_035784.1,36522572,36547259,36522572,36528646,111133803,XM_022482480.1,FMRFamide receptor-like,6074
NC_035781.1,52454631,52467536,52454631,52460803,111119109,XM_022458961.1,RYamide receptor-like,6172
NC_035784.1,30325413,30331604,30325413,30331604,111137651,XM_022489207.1,cholecystokinin receptor-like,6191
NC_035785.1,29472126,29478502,29472126,29478502,111102263,XM_022434932.1,RYamide receptor-like,6376
NC_035788.1,63913648,63977637,63913648,63977637,111113319,XM_022451501.1,ecdysone receptor-like,63989
NC_035788.1,2973639,3038278,2973639,3038278,111112963,XM_022450857.1,secretin receptor-like,64639
NC_035782.1,64394796,64401558,64394796,64401558,111127153,XM_022472211.1,octopamine receptor-like,6762
NC_035786.1,13485905,13492872,13485905,13492872,111105267,XM_022439449.1,RYamide receptor-like,6967
NC_035788.1,84293458,84300777,84293458,84300777,111115776,XM_022454619.1,calcitonin receptor-like,7319
NC_035784.1,40670634,40687330,40679978,40687330,111132976,XM_022480964.1,FMRFamide receptor-like,7352
NC_035788.1,19100705,19108124,19100705,19108124,111113585,XM_022451880.1,FMRFamide receptor-like,7419
NC_035787.1,50955882,50967787,50955882,50963319,111110431,XM_022446930.1,FMRFamide receptor-like,7437
NC_035788.1,65920322,65996132,65920322,65996132,111113428,XM_022451707.1,5-hydroxytryptamine receptor-like,75810
NC_035780.1,18407557,18415235,18407557,18415235,111106151,XM_022440703.1,secretin receptor-like,7678
NC_035788.1,66751549,66767269,66759007,66767269,111114491,XM_022452810.1,5-hydroxytryptamine receptor-like,8262
NC_035782.1,48327816,48372324,48327816,48336842,111126791,XM_022471662.1,FMRFamide receptor-like,9026
NC_035781.1,36578196,36606059,36578196,36587232,111118486,XM_022457989.1,substance-P receptor-like,9036
NC_035781.1,36578196,36606059,36578196,36587240,111118486,XM_022457991.1,substance-P receptor-like,9044
NC_035782.1,48327816,48372324,48327816,48336874,111126791,XM_022471657.1,FMRFamide receptor-like,9058
NC_035787.1,35589814,35625201,35589814,35598939,111108361,XM_022444182.1,FMRFamide receptor-like,9125
NC_035787.1,35589814,35625201,35589814,35599036,111108361,XM_022444186.1,FMRFamide receptor-like,9222
NC_035782.1,52983330,52993051,52983330,52993051,111126782,XM_022471642.1,annetocin receptor-like,9721
NC_035780.1,62672500,62682365,62672500,62682365,111133718,XM_022482340.1,allatostatin-A receptor-like,9865
NC_035780.1,2463664,2478866,2463664,2478866,111131721,XM_022479382.1,origin recognition complex subunit 4-like,15202
NC_035780.1,32293361,32300806,32293361,32300806,111124678,XM_022467817.1,meiotic recombination protein REC114-like,7445
NC_035784.1,48297231,48298675,48297231,48298675,111132415,XM_022480217.1,V(D)J recombination-activating protein 1-like,1444
NC_035781.1,56213473,56245772,56213473,56245772,111119596,XM_022459921.1,caspase recruitment domain-containing protein 11-like,32299
NC_035780.1,23220731,23226222,23220731,23226222,111124643,XM_022467713.1,ubiquinol-cytochrome-c reductase complex assembly factor 1-like,5491
NC_035786.1,52091774,52093104,52091774,52093104,111103990,XM_022437664.1,enoyl-[acyl-carrier-protein] reductase,1330
NC_035784.1,83436449,83442087,83436449,83442087,111132090,XM_022479751.1,glutathione reductase,5638
NC_035781.1,39739008,39750021,39739008,39750021,111121211,XM_022462372.1,delta(24)-sterol reductase-like,11013
NC_035788.1,88109133,88120832,88109133,88120832,111111846,XM_022449016.1,glyoxal reductase-like,11699
NC_035781.1,39100013,39112327,39100013,39112327,111120973,XM_022462047.1,delta(24)-sterol reductase-like,12314
NC_035789.1,22652038,22668983,22652038,22668983,111117281,XM_022456348.1,dihydrofolate reductase-like,16945
NC_035788.1,12770430,12789381,12770430,12789381,111114756,XM_022453220.1,dihydrofolate reductase-like,18951
NC_035781.1,388731,395671,393478,395671,111121358,XM_022462605.1,7-dehydrocholesterol reductase-like,2193
NC_035781.1,388731,395671,393476,395671,111121358,XM_022462606.1,7-dehydrocholesterol reductase-like,2195
NC_035782.1,6824690,6827215,6824690,6827215,111125051,XM_022468499.1,polyprenol reductase-like,2525
NC_035780.1,33426244,33428829,33426244,33428829,111125972,XM_022470294.1,chromate reductase-like,2585
NC_035781.1,388731,395671,392784,395671,111121358,XM_022462604.1,7-dehydrocholesterol reductase-like,2887
NC_035781.1,388731,395671,392628,395671,111121358,XM_022462608.1,7-dehydrocholesterol reductase-like,3043
NC_035784.1,45878641,45910182,45878641,45910004,111134862,XM_022484347.1,3-keto-steroid reductase-like,31363
NC_035784.1,45878641,45910182,45878641,45910181,111134862,XM_022484345.1,3-keto-steroid reductase-like,31540
NC_035784.1,45878641,45910182,45878641,45910182,111134862,XM_022484346.1,3-keto-steroid reductase-like,31541
NC_035781.1,388731,395671,392431,395671,111121358,XM_022462609.1,7-dehydrocholesterol reductase-like,3240
NC_035784.1,71026371,71034380,71030948,71034380,111132821,XM_022480673.1,sepiapterin reductase-like,3432
NC_035784.1,71026371,71034380,71030583,71034380,111132821,XM_022480670.1,sepiapterin reductase-like,3797
NC_035782.1,49818102,49822818,49818102,49822794,111123895,XM_022466575.1,delta(14)-sterol reductase-like,4692
NC_035782.1,49818102,49822818,49818108,49822818,111123895,XM_022466574.1,delta(14)-sterol reductase-like,4710
NC_035781.1,54261450,54267996,54261450,54267996,111120655,XM_022461530.1,L-xylulose reductase-like,6546
NC_035781.1,388731,395671,388731,395671,111121358,XM_022462607.1,7-dehydrocholesterol reductase-like,6940
NC_035781.1,39100013,39112327,39100013,39107310,111120973,XM_022462048.1,delta(24)-sterol reductase-like,7297
NC_035784.1,21560123,21567718,21560123,21567718,111134961,XM_022484576.1,3-ketodihydrosphingosine reductase-like,7595
NC_035784.1,71026371,71034380,71026385,71034380,111132821,XM_022480672.1,sepiapterin reductase-like,7995
NC_035780.1,24819030,24827029,24819030,24827029,111128753,XM_022474586.1,pyrroline-5-carboxylate reductase-like,7999
NC_035784.1,71026371,71034380,71026371,71034380,111132821,XM_022480671.1,sepiapterin reductase-like,8009
NC_035784.1,19707907,19716455,19707907,19716455,111138100,XM_022489906.1,methylenetetrahydrofolate reductase-like,8548
NC_035781.1,39739008,39750021,39740955,39750021,111121211,XM_022462373.1,delta(24)-sterol reductase-like,9066
NC_035788.1,89562348,89571928,89562348,89571928,111111712,XM_022448845.1,glyoxal reductase-like,9580
NC_035782.1,27447777,27459990,27447777,27457531,111126558,XM_022471284.1,aldose reductase-related protein 1-like,9754
NC_035782.1,27582244,27585717,27582244,27585717,111125858,XM_022470054.1,glyoxylate reductase/hydroxypyruvate reductase-like,3473
NC_035783.1,30254177,30260745,30254177,30260745,111131226,XM_022478654.1,sex-determining region Y protein-like,6568
NC_035780.1,16705694,16712722,16705694,16712722,111103080,XM_022436098.1,apoptosis regulator BAX-like,7028
NC_035783.1,49468429,49510779,49468429,49500658,111131843,XM_022479575.1,lysosomal-trafficking regulator-like,32229
NC_035783.1,49468429,49510779,49468429,49501799,111131843,XM_022479576.1,lysosomal-trafficking regulator-like,33370
NC_035783.1,49468429,49510779,49468429,49510779,111131843,XM_022479574.1,lysosomal-trafficking regulator-like,42350
NC_035780.1,9996253,10055348,9996253,10055348,111118239,XM_022457639.1,myelin regulatory factor-like,59095
NC_035780.1,2460941,2463301,2460941,2463301,111131773,XM_022479480.1,hairy/enhancer-of-split related with YRPW motif protein-like,2360
NC_035784.1,46127707,46130529,46127707,46130529,111134665,XM_022483917.1,calcium release-activated calcium channel protein 1-like,2822
NC_035780.1,1982711,1993041,1982711,1993041,111104153,XM_022441699.1,X-ray repair cross-complementing protein 5-like,10330
NC_035780.1,10965727,10982272,10965727,10982272,111112613,XM_022450232.1,tetratricopeptide repeat protein 21B-like,16545
NC_035782.1,41103937,41105187,41103937,41105187,111124233,XM_022467091.1,leucine-rich repeat,1250
NC_035787.1,49198573,49211859,49198573,49211859,111106592,XM_022441321.1,ankyrin repeat,13286
NC_035784.1,93500682,93502079,93500682,93502079,111132749,XM_022480568.1,ankyrin repeat,1397
NC_035787.1,72428602,72430191,72428602,72430191,111109360,XM_022445439.1,ankyrin repeat,1589
NC_035788.1,68763955,68765774,68763955,68765774,111110931,XM_022447597.1,ankyrin repeat,1819
NC_035780.1,8222876,8246047,8222876,8246047,111130926,XM_022478216.1,WD repeat,23171
NC_035780.1,36459586,36467972,36459586,36467972,111129172,XM_022475393.1,telomeric repeat-binding factor 1-like,8386
NC_035780.1,10136214,10167580,10136214,10167580,111104770,XM_022438891.1,leucine-rich repeat-containing G-protein coupled receptor 5-like,31366
NC_035786.1,59,3890,59,3890,111105385,XM_022439661.1,leucine-rich repeats and immunoglobulin-like domains protein sma-10,3831
NC_035783.1,32186011,32192928,32186011,32192928,111128561,XM_022474240.1,telomere repeats-binding bouquet formation protein 2-like,6917
NC_035780.1,8891942,8916867,8891942,8916867,111126395,XM_022470996.1,serine/arginine repetitive matrix protein 2-like,24925
NC_035783.1,2890063,2898732,2890063,2898732,111131693,XM_022479336.1,DNA replication licensing factor mcm5-like,8669
NC_035783.1,19802394,19807779,19802394,19807778,111127973,XM_022473302.1,transcriptional repressor protein YY1-like,5384
NC_035783.1,53328002,53345614,53328002,53345614,111130021,XM_022476622.1,Golgi resident protein GCP60-like,17612
NC_035780.1,24611969,24638942,24611969,24638942,111105249,XM_022439427.1,oxidation resistance protein 1-like,26973
NC_035780.1,48316470,48329599,48316470,48329599,111099678,XM_022431089.1,natural resistance-associated macrophage protein 2-like,13129
NC_035782.1,6761858,6777601,6761858,6777601,111125050,XM_022468498.1,nose resistant to fluoxetine protein 6-like,15743
NC_035781.1,4787481,4789253,4787481,4789253,111120825,XM_022461811.1,stress response protein nst1-like,1772
NC_035781.1,12695851,12704252,12695851,12704252,111119779,XM_022460262.1,endoplasmic reticulum metallopeptidase 1-like,8401
NC_035780.1,9301979,9310666,9301979,9310666,111132171,XM_022479935.1,endoplasmic reticulum-Golgi intermediate compartment protein 2-like,8687
NC_035784.1,10236041,10266876,10236041,10266876,111134300,XM_022483200.1,protein retinal degeneration B-like,30835
NC_035785.1,17089075,17106832,17089075,17106832,111101972,XM_022434627.1,X-linked retinitis pigmentosa GTPase regulator-like,17757
NC_035781.1,17833200,17848201,17833200,17848201,111120075,XM_022460734.1,all-trans retinoic acid-induced differentiation factor-like,15001
NC_035780.1,36239788,36249353,36239788,36249353,111138494,XM_022490500.1,epidermal retinol dehydrogenase 2-like,9565
NC_035782.1,46270492,46283756,46270492,46283756,111125755,XM_022469838.1,telomerase reverse transcriptase-like,13264
NC_035782.1,46246474,46259090,46246474,46259090,111123099,XM_022465200.1,probable rhodanese domain-containing dual specificity protein phosphatase,12616
NC_035781.1,15755082,15771501,15755082,15771501,111121375,XM_022462639.1,inactive rhomboid protein 1-like,16419
NC_035784.1,82132754,82139347,82132754,82139347,111136973,XM_022488176.1,presenilins-associated rhomboid-like protein,6593
NC_035781.1,47061144,47069929,47061144,47065940,111121855,XM_022463318.1,protein rhomboid-like,4796
NC_035781.1,50838852,50847635,50842801,50847635,111121921,XM_022463411.1,protein rhomboid-like,4834
NC_035781.1,47061144,47069929,47061144,47065999,111121855,XM_022463321.1,protein rhomboid-like,4855
NC_035781.1,50838852,50847635,50842749,50847635,111121921,XM_022463413.1,protein rhomboid-like,4886
NC_035781.1,47061144,47069929,47061144,47066031,111121855,XM_022463320.1,protein rhomboid-like,4887
NC_035781.1,50838852,50847635,50842715,50847635,111121921,XM_022463414.1,protein rhomboid-like,4920
NC_035781.1,50838852,50847635,50838852,50847635,111121921,XM_022463412.1,protein rhomboid-like,8783
NC_035781.1,47061144,47069929,47061144,47069929,111121855,XM_022463319.1,protein rhomboid-like,8785
NC_035781.1,17710099,17724264,17710099,17724264,111121165,XM_022462316.1,poly(A)-specific ribonuclease PARN-like,14165
NC_035786.1,27567197,27568054,27567197,27568054,111102640,XM_022435462.1,putative ribonuclease,857
NC_035782.1,13233910,13237642,13233910,13237642,111125693,XM_022469751.1,2-5A-dependent ribonuclease-like,3732
NC_035782.1,12711882,12715623,12711882,12715623,111126729,XM_022471563.1,2-5A-dependent ribonuclease-like,3741
NC_035781.1,10862280,10870350,10862280,10870350,111118140,XM_022457460.1,H/ACA ribonucleoprotein complex non-core subunit NAF1-like,8070
NC_035780.1,6409665,6416204,6409665,6416204,111135077,XM_022484792.1,40S ribosomal protein S8-like,6539
NC_035781.1,41806780,41844462,41806780,41844462,111120302,XM_022461031.1,unhealthy ribosome biogenesis protein 2 homolog,37682
NC_035784.1,50204047,50208011,50204047,50208011,111137173,XM_022488496.1,mitochondrial ribosome-associated GTPase 2-like,3964
NC_035784.1,22573508,22588246,22573508,22588246,111137449,XM_022488911.1,retinal rod rhodopsin-sensitive cGMP 3',14738
NC_035781.1,36226953,36231388,36226953,36231388,111121553,XM_022462877.1,protein rolling stone-like,4435
NC_035783.1,4290948,4291929,4290948,4291929,111131829,XM_022479553.1,basic salivary proline-rich protein 2-like,981
NC_035780.1,56449991,56460458,56449991,56460458,111127583,XM_022472814.1,bile salt sulfotransferase-like,10467
NC_035783.1,56245668,56250607,56245668,56250607,111130119,XM_022476841.1,peroxisomal sarcosine oxidase-like,4939
NC_035785.1,24070473,24080221,24070473,24080221,111102043,XM_022434697.1,protein sax-3-like,9748
NC_035786.1,15430651,15444088,15430651,15444088,111102911,XM_022435852.1,protein scabrous-like,13437
NC_035784.1,51602196,51611368,51602196,51611368,111132438,XM_022480245.1,protein scabrous-like,9172
NC_035784.1,69401325,69407577,69401325,69407577,111135591,XM_022485802.1,UV-stimulated scaffold protein A-like,6252
NC_035782.1,52691535,52697385,52691535,52697385,111125985,XM_022470310.1,soluble scavenger receptor cysteine-rich domain-containing protein SSC5D-like,5850
NC_035782.1,56722389,56730988,56722389,56730988,111125142,XM_022468644.1,phospholipid scramblase 2-like,8599
NC_035780.1,26659273,26696606,26659273,26696606,111113238,XM_022451526.1,protein scribble homolog,37333
NC_035782.1,38202029,38223208,38202029,38223208,111126161,XM_022470597.1,probable secreted beta-glucosidase adg3,21179
NC_035787.1,1976657,2011284,1976657,2011284,111108189,XM_022443855.1,calcium-dependent secretion activator 1-like,34627
NC_035780.1,18196539,18199827,18196539,18199827,111120932,XM_022461991.1,pancreatic secretory granule membrane major glycoprotein GP2-like,3288
NC_035781.1,27090519,27095659,27090519,27095659,111118726,XM_022458323.1,vicilin-like seed storage protein At2g18540,5140
NC_035784.1,95771255,95782536,95771255,95782536,111137816,XM_022489476.1,vacuolar segregation protein PEP7-like,11281
NC_035782.1,29662566,29671480,29662566,29671480,111123597,XM_022466030.1,protein sel-1 homolog 3-like,8914
NC_035784.1,77657096,77664870,77657096,77664870,111133774,XM_022482416.1,O-phosphoseryl-tRNA(Sec) selenium transferase-like,7774
NC_035781.1,42003011,42011600,42003011,42011600,111120696,XM_022461616.1,tRNA selenocysteine 1-associated protein 1-like,8589
NC_035783.1,785552,796807,785552,796807,111131063,XM_022478397.1,alpha-aminoadipic semialdehyde dehydrogenase-like,11255
NC_035780.1,31875301,31883902,31875301,31883902,111122330,XM_022464051.1,kunitz-type serine protease inhibitor BmKTT-2-like,8601
NC_035782.1,30495682,30503855,30495682,30503854,111126670,XM_022471462.1,probable serine-O-acetyltransferase,8172
NC_035782.1,30495682,30503855,30495682,30503855,111126670,XM_022471461.1,probable serine-O-acetyltransferase,8173
NC_035780.1,63172636,63178135,63172636,63178135,111111425,XM_022448429.1,uncharacterized serine-rich protein C215.13-like,5499
NC_035783.1,24757762,24773733,24757762,24773733,111130108,XM_022476813.1,CLK4-associating serine/arginine rich protein-like,15971
NC_035781.1,53315457,53324988,53315457,53324988,111120943,XM_022462001.1,extracellular serine/threonine protein kinase FAM20C-like,9531
NC_035780.1,5504736,5508280,5504736,5508280,111130710,XM_022477921.1,probable serine/threonine-protein kinase fhkB,3544
NC_035784.1,16498760,16509900,16498760,16509900,111134674,XM_022483926.1,sodium-dependent serotonin transporter-like,11140
NC_035784.1,41336245,41338798,41336245,41338798,111132813,XM_022480658.1,protein serrate-like,2553
NC_035780.1,20518219,20531757,20518219,20531757,111120760,XM_022461712.1,fibrous sheath-interacting protein 2-like,13538
NC_035782.1,33081226,33084077,33081226,33084077,111126931,XM_022471878.1,uncharacterized shell protein 1-like,2851
NC_035787.1,50148068,50150383,50148068,50150383,111108634,XM_022444635.1,protein shisa-4-like,2315
NC_035785.1,35337792,35340178,35337792,35340178,111099863,XM_022431335.1,protein shisa-4-like,2386
NC_035783.1,57748609,57750796,57748609,57750796,111131703,XM_022479350.1,protein shisa-5-like,2187
NC_035787.1,19688429,19690837,19688429,19690837,111109570,XM_022445745.1,protein shisa-5-like,2408
NC_035787.1,20969177,20973449,20969177,20973449,111106443,XM_022441118.1,protein shisa-5-like,4272
NC_035787.1,19738600,19743072,19738600,19743072,111106376,XM_022441028.1,protein shisa-5-like,4472
NC_035787.1,19699085,19704687,19699085,19704687,111106050,XM_022440572.1,protein shisa-5-like,5602
NC_035787.1,19666225,19674560,19666225,19674557,111110507,XM_022447037.1,protein shisa-5-like,8332
NC_035787.1,19666225,19674560,19666225,19674559,111110507,XM_022447036.1,protein shisa-5-like,8334
NC_035787.1,19666225,19674560,19666225,19674560,111110507,XM_022447034.1,protein shisa-5-like,8335
NC_035780.1,23490987,23500513,23490987,23500513,111115176,XM_022453839.1,heat shock 70 kDa protein 12B-like,9526
NC_035788.1,90298776,90310167,90298776,90310167,111111263,XM_022448130.1,dentin sialophosphoprotein-like,11391
NC_035784.1,39585244,39601769,39585244,39601767,111134953,XM_022484562.1,dentin sialophosphoprotein-like,16523
NC_035784.1,39585244,39601769,39585244,39601769,111134953,XM_022484561.1,dentin sialophosphoprotein-like,16525
NC_035782.1,36533915,36557954,36533915,36557954,111123970,XM_022466739.1,dentin sialophosphoprotein-like,24039
NC_035783.1,6004362,6007511,6004362,6007511,111130671,XM_022477850.1,dentin sialophosphoprotein-like,3149
NC_035780.1,35845313,35849676,35845313,35849676,111099088,XM_022430458.1,dentin sialophosphoprotein-like,4363
NC_035786.1,53212458,53222591,53218097,53222591,111102459,XM_022435207.1,dentin sialophosphoprotein-like,4494
NC_035788.1,90298776,90310167,90298776,90303353,111111263,XM_022448131.1,dentin sialophosphoprotein-like,4577
NC_035786.1,53212458,53222591,53212458,53218431,111102459,XM_022435209.1,dentin sialophosphoprotein-like,5973
NC_035788.1,70104808,70113718,70104808,70113718,111110786,XM_022447400.1,dentin sialophosphoprotein-like,8910
NC_035783.1,5059346,5068817,5059346,5068817,111128414,XM_022474010.1,dentin sialophosphoprotein-like,9471
NC_035787.1,53446847,53456561,53446848,53456561,111108341,XM_022444150.1,dentin sialophosphoprotein-like,9713
NC_035787.1,53446847,53456561,53446847,53456561,111108341,XM_022444149.1,dentin sialophosphoprotein-like,9714
NC_035781.1,47306102,47308563,47306102,47308563,111121495,XM_022462800.1,protein sidekick-1-like,2461
NC_035781.1,47285474,47306209,47285474,47306048,111121492,XM_022462794.1,protein sidekick-like,20574
NC_035781.1,47285474,47306209,47285474,47306209,111121492,XM_022462795.1,protein sidekick-like,20735
NC_035781.1,47321473,47343589,47321473,47343589,111121490,XM_022462793.1,protein sidekick-like,22116
NC_035781.1,50615582,50639196,50615582,50639196,111118892,XM_022458583.1,protein sidekick-like,23614
NC_035782.1,50245351,50261309,50245351,50261309,111124613,XM_022467639.1,activating signal cointegrator 1 complex subunit 2-like,15958
NC_035781.1,41222821,41236135,41222821,41236135,111119375,XM_022459475.1,extracellular signal-regulated kinase 2-like,13314
NC_035784.1,76999247,77013420,76999247,77013420,111135340,XM_022485307.1,lateral signaling target protein 2 homolog,14173
NC_035781.1,5806581,5810710,5806581,5810710,111120745,XM_022461682.1,COP9 signalosome complex subunit 5,4129
NC_035788.1,3560149,3561863,3560149,3561863,111110764,XM_022447380.1,protein singed-like,1714
NC_035788.1,73859012,73860753,73859012,73860753,111110717,XM_022447308.1,protein singed-like,1741
NC_035788.1,73855319,73857608,73855319,73857608,111115593,XM_022454381.1,protein singed-like,2289
NC_035788.1,3563319,3565696,3563319,3565696,111115798,XM_022454659.1,protein singed-like,2377
NC_035780.1,61176587,61197355,61176587,61197355,111102665,XM_022435514.1,D site-binding protein-like,20768
NC_035784.1,78106222,78109120,78106222,78109120,111138071,XM_022489870.1,uncharacterized skeletal organic matrix protein 8-like,2898
NC_035788.1,24726140,24747669,24726140,24747669,111110724,XM_022447318.1,protein slit-like,21529
NC_035786.1,1731491,1733990,1731491,1733990,111103616,XM_022437004.1,protein slit-like,2499
NC_035788.1,88142743,88150972,88142743,88150972,111114687,XM_022453109.1,random slug protein 5-like,8229
NC_035780.1,3930723,3933945,3930723,3933945,111106561,XM_022441287.1,U11/U12 small nuclear ribonucleoprotein 25 kDa protein-like,3222
NC_035784.1,14492332,14511149,14492332,14511149,111136887,XM_022488037.1,protein smg8-like,18817
NC_035782.1,29657878,29661919,29657878,29661919,111126688,XM_022471501.1,U6 snRNA phosphodiesterase-like,4041
NC_035781.1,10858845,10861313,10858845,10861313,111121361,XM_022462614.1,U7 snRNA-associated Sm-like protein LSm11,2468
NC_035784.1,63856992,63868118,63856992,63868118,111135374,XM_022485382.1,U2 snRNP-associated SURP motif-containing protein-like,11126
NC_035784.1,34497336,34511972,34497336,34511972,111133562,XM_022482037.1,protein snail-like,14636
NC_035784.1,34326124,34328748,34326124,34328748,111133717,XM_022482336.1,protein snail-like,2624
NC_035784.1,41096646,41105543,41096646,41105543,111135938,XM_022486425.1,U8 snoRNA-decapping enzyme-like,8897
NC_035781.1,14437418,14449329,14437418,14449329,111120535,XM_022461329.1,amiloride-sensitive sodium channel subunit alpha-like,11911
NC_035781.1,33958721,33970627,33958721,33970627,111119420,XM_022459563.1,putative sodium-coupled neutral amino acid transporter 10,11906
NC_035784.1,53909380,53926398,53909380,53926398,111137550,XM_022489034.1,putative sodium-dependent excitatory amino acid transporter glt-6,17018
NC_035783.1,22766228,22769532,22766228,22769532,111129552,XM_022476006.1,ileal sodium/bile acid cotransporter-like,3304
NC_035784.1,54137237,54152837,54137237,54152837,111136021,XM_022486589.1,mitochondrial sodium/calcium exchanger protein-like,15600
NC_035785.1,32461151,32467795,32461151,32467795,111100630,XM_022432705.1,probable sodium/potassium-transporting ATPase subunit beta-3,6644
NC_035784.1,78948595,78968703,78948595,78968703,111132104,XM_022479786.1,probable sodium/potassium/calcium exchanger CG1090,20108
NC_035780.1,57793216,57798033,57793216,57798033,111135638,XM_022485891.1,organic solute transporter subunit alpha-like,4817
NC_035781.1,41306549,41312847,41306549,41312847,111119921,XM_022460499.1,protein spalten-like,6298
NC_035783.1,6794749,6795603,6794749,6795603,111131614,XM_022479226.1,protein spalten-like,854
NC_035780.1,56848904,56867328,56848904,56867328,111108184,XM_022443835.1,long-chain specific acyl-CoA dehydrogenase,18424
NC_035780.1,625970,662443,625970,662443,111138321,XM_022490233.1,dual specificity tyrosine-phosphorylation-regulated kinase 4-like,36473
NC_035784.1,20893505,20903247,20893505,20903247,111135927,XM_022486412.1,nuclear speckle splicing regulatory protein 1-like,9742
NC_035780.1,3833913,3850572,3833913,3850572,111125333,XM_022469019.1,calmodulin-regulated spectrin-associated protein 1-like,16659
NC_035782.1,61195838,61209507,61195838,61209507,111124916,XM_022468219.1,motile sperm domain-containing protein 2-like,13669
NC_035786.1,26921929,26924054,26921929,26924054,111104973,XM_022439150.1,prostatic spermine-binding protein-like,2125
NC_035781.1,10696088,10700925,10696088,10700925,111119870,XM_022460432.1,acid sphingomyelinase-like phosphodiesterase 3b,4837
NC_035781.1,20518276,20521904,20518276,20521904,111118915,XM_022458627.1,mitotic spindle assembly checkpoint protein MAD1-like,3628
NC_035784.1,45147052,45150913,45147052,45150913,111136205,XM_022486880.1,mitotic spindle-associated MMXD complex subunit MIP18-like,3861
NC_035782.1,22928613,22945075,22928613,22945075,111125839,XM_022470020.1,abnormal spindle-like microcephaly-associated protein homolog,16462
NC_035782.1,31298981,31311374,31298981,31311374,111126478,XM_022471162.1,protein spinster homolog 1-like,12393
NC_035784.1,4418773,4442847,4418773,4442847,111134950,XM_022484553.1,protein spire homolog 1-like,24074
NC_035780.1,2931744,2936496,2931744,2936496,111137770,XM_022489415.1,serine/arginine-rich splicing factor 7-like,4752
NC_035782.1,29548581,29573654,29548581,29573654,111125710,XM_022469766.1,protein split ends-like,25073
NC_035781.1,22102783,22146201,22102783,22146198,111119162,XM_022459038.1,radial spoke head 10 homolog B-like,43415
NC_035782.1,29052318,29054346,29052318,29054346,111125649,XM_022469657.1,protein sprouty homolog 2-like,2028
NC_035789.1,7041196,7045316,7041196,7045316,111116785,XM_022455787.1,xylosyltransferase sqv-6-like,4120
NC_035780.1,52803555,52815056,52803558,52815056,111132299,XM_022480111.1,protein starmaker-like,11498
NC_035780.1,52803555,52815056,52803557,52815056,111132299,XM_022480099.1,protein starmaker-like,11499
NC_035780.1,52803555,52815056,52803555,52815056,111132299,XM_022480127.1,protein starmaker-like,11501
NC_035784.1,37755305,37757508,37755305,37757508,111132342,XM_022480145.1,protein starmaker-like,2203
NC_035786.1,49884689,49891460,49887420,49891460,111102679,XM_022435519.1,protein starmaker-like,4040
NC_035786.1,49884689,49891460,49887049,49891460,111102679,XM_022435521.1,protein starmaker-like,4411
NC_035786.1,49884689,49891460,49884689,49891460,111102679,XM_022435520.1,protein starmaker-like,6771
NC_035784.1,63325555,63337106,63325555,63337106,111138281,XM_022490159.1,short stature homeobox protein 2-like,11551
NC_035781.1,24222557,24245651,24222557,24245651,111117744,XM_022456960.1,prostate stem cell antigen-like,23094
NC_035787.1,10497512,10512091,10497512,10512091,111107409,XM_022442599.1,orphan steroid hormone receptor 2-like,14579
NC_035785.1,10614921,10628917,10614921,10628917,111100346,XM_022432109.1,protein still life,13996
NC_035782.1,26698261,26704434,26698261,26704434,111126090,XM_022470493.1,cleavage stimulation factor subunit 1-like,6173
NC_035782.1,54940121,54951809,54940121,54951809,111125664,XM_022469702.1,upstream stimulatory factor 2-like,11688
NC_035780.1,18792050,18798051,18792050,18798051,111110520,XM_022447065.1,ribonuclease-like storage protein,6001
NC_035784.1,39531861,39553217,39531861,39553217,111134305,XM_022483215.1,protein strawberry notch homolog 1-like,21356
NC_035783.1,15368481,15370770,15368481,15370770,111128798,XM_022474653.1,universal stress protein Sll1388-like,2289
NC_035784.1,15751678,15762099,15751678,15762099,111134372,XM_022483330.1,oxidative stress-induced growth inhibitor 2-like,10421
NC_035788.1,46481365,46482960,46481365,46482960,111113193,XM_022451284.1,thymic stromal cotransporter homolog,1595
NC_035783.1,11773436,11781748,11773436,11781748,111127896,XM_022473196.1,protein stum homolog,8312
NC_035780.1,40024848,40036849,40024848,40036849,111111773,XM_022448917.1,golgin subfamily A member 6-like protein 4,12001
NC_035783.1,14013831,14019180,14013831,14019180,111130945,XM_022478244.1,mitochondrial substrate carrier family protein ucpB-like,5349
NC_035780.1,573630,585444,573630,585444,111114212,XM_022452506.1,coatomer subunit alpha-like,11814
NC_035780.1,32816711,32835969,32816711,32835969,111132815,XM_022480664.1,N-acetylglucosamine-1-phosphotransferase subunits alpha/beta-like,19258
NC_035784.1,74121454,74124466,74121454,74124466,111132318,XM_022480116.1,putative succinate dehydrogenase [ubiquinone] cytochrome b small subunit,3012
NC_035783.1,44684300,44694194,44684300,44694194,111131212,XM_022478632.1,dihydrolipoyllysine-residue succinyltransferase component of 2-oxoglutarate dehydrogenase complex,9894
NC_035780.1,58563422,58565810,58563422,58565810,111108254,XM_022444021.1,proton-associated sugar transporter A-like,2388
NC_035780.1,57902806,57921241,57902806,57921241,111135504,XM_022485640.1,extracellular sulfatase Sulf-1-like,18435
NC_035781.1,14247336,14264230,14247336,14264230,111120537,XM_022461333.1,sodium-independent sulfate anion transporter-like,16894
NC_035781.1,20282018,20289198,20282018,20289198,111118461,XM_022457954.1,FAD-linked sulfhydryl oxidase ALR-like,7180
NC_035780.1,29568222,29580004,29568222,29580004,111135375,XM_022485387.1,cysteine sulfinic acid decarboxylase-like,11782
NC_035780.1,16226215,16233903,16226215,16233903,111103184,XM_022436258.1,carbohydrate sulfotransferase 1-like,7688
NC_035783.1,23947914,23965899,23953926,23965899,111130175,XM_022476934.1,estrogen sulfotransferase-like,11973
NC_035783.1,23947914,23965899,23952177,23965899,111130175,XM_022476933.1,estrogen sulfotransferase-like,13722
NC_035783.1,23947914,23965899,23951989,23965899,111130175,XM_022476932.1,estrogen sulfotransferase-like,13910
NC_035783.1,36560896,36562331,36560896,36562331,111128948,XM_022474924.1,galactosylceramide sulfotransferase-like,1435
NC_035783.1,23947914,23965899,23947914,23965899,111130175,XM_022476935.1,estrogen sulfotransferase-like,17985
NC_035788.1,48495747,48497689,48495747,48497689,111112101,XM_022449428.1,galactosylceramide sulfotransferase-like,1942
NC_035788.1,71042718,71045994,71042718,71045994,111111566,XM_022448612.1,galactosylceramide sulfotransferase-like,3276
NC_035789.1,675605,680753,675605,680753,111117769,XM_022457015.1,estrogen sulfotransferase-like,5148
NC_035780.1,19999823,20005618,19999823,20005618,111134291,XM_022483195.1,estrogen sulfotransferase-like,5795
NC_035780.1,794545,800915,794545,800915,111131060,XM_022478407.1,hercynylcysteine sulfoxide lyase-like,6370
NC_035783.1,29326161,29336724,29326161,29336724,111129409,XM_022475782.1,thiosulfate sulfurtransferase-like,10563
NC_035783.1,28751267,28762170,28751267,28762170,111129408,XM_022475781.1,thiosulfate sulfurtransferase-like,10903
NC_035781.1,18501960,18504981,18501960,18504981,111118153,XM_022457478.1,3-mercaptopyruvate sulfurtransferase-like,3021
NC_035781.1,17472730,17476488,17472730,17476488,111118224,XM_022457563.1,3-mercaptopyruvate sulfurtransferase-like,3758
NC_035784.1,1979138,1983446,1979138,1983446,111137690,XM_022489276.1,thiosulfate sulfurtransferase-like,4308
NC_035781.1,14238994,14247351,14238994,14247351,111120539,XM_022461337.1,N-sulphoglucosamine sulphohydrolase-like,8357
NC_035784.1,90404044,90405914,90404044,90405914,111135207,XM_022485054.1,immunoglobulin superfamily member 10-like,1870
NC_035788.1,90865705,90867967,90865705,90867967,111113330,XM_022451523.1,extracellular superoxide dismutase [Cu-Zn]-like,2262
NC_035780.1,43776910,43783247,43776910,43783247,111127185,XM_022472294.1,ras suppressor protein 1-like,6337
NC_035780.1,7331788,7343936,7331788,7343936,111128774,XM_022474622.1,cell surface hyaluronidase-like,12148
NC_035784.1,78650903,78661034,78650903,78661034,111137244,XM_022488624.1,major surface-labeled trophozoite antigen 417-like,10131
NC_035782.1,42016982,42019342,42017019,42019342,111123769,XM_022466330.1,pulmonary surfactant-associated protein A2-like,2323
NC_035784.1,12711747,12742674,12711747,12742674,111134426,XM_022483425.1,autism susceptibility gene 2 protein-like,30927
NC_035780.1,55819226,55822026,55819226,55822026,111100498,XM_022432449.1,palmitoyltransferase swf1-like,2800
NC_035780.1,38052872,38070098,38052874,38066130,111101232,XM_022433668.1,protein sym-1-like,13256
NC_035780.1,38052872,38070098,38052872,38067307,111101232,XM_022433676.1,protein sym-1-like,14435
NC_035780.1,38052872,38070098,38052872,38070098,111101232,XM_022433660.1,protein sym-1-like,17226
NC_035782.1,63182010,63191509,63182010,63191509,111126564,XM_022471297.1,urea-proton symporter DUR3-like,9499
NC_035780.1,30709759,30748068,30709759,30748068,111129693,XM_022476158.1,regulating synaptic membrane exocytosis protein 2-like,38309
NC_035780.1,25414813,25443408,25414814,25443408,111126007,XM_022470372.1,extended synaptotagmin-2-like,28594
NC_035780.1,25414813,25443408,25414813,25443408,111126007,XM_022470364.1,extended synaptotagmin-2-like,28595
NC_035780.1,29645269,29655828,29645269,29655828,111127110,XM_022472141.1,probable syndecan,10559
NC_035780.1,36438642,36445796,36438642,36445796,111107188,XM_022442247.1,Bardet-Biedl syndrome 12 protein homolog,7154
NC_035783.1,30226263,30230604,30226263,30230604,111130944,XM_022478243.1,Sjoegren syndrome/scleroderma autoantigen 1 homolog,4341
NC_035783.1,30384605,30399684,30384605,30399684,111130072,XM_022476759.1,McKusick-Kaufman/Bardet-Biedl syndromes putative chaperonin-like,15079
NC_035780.1,29659422,29662155,29659422,29662155,111138187,XM_022490044.1,ATP synthase lipid-binding protein,2733
NC_035787.1,64362893,64386662,64362893,64373036,111108307,XM_022444096.1,5-aminolevulinate synthase,10143
NC_035780.1,54760203,54770565,54760203,54770565,111104633,XM_022438699.1,alkyldihydroxyacetonephosphate synthase,10362
NC_035788.1,48256623,48267042,48256623,48267042,111111213,XM_022448040.1,citrate synthase,10419
NC_035787.1,64362893,64386662,64362893,64378489,111108307,XM_022444097.1,5-aminolevulinate synthase,15596
NC_035787.1,64362893,64386662,64362893,64381296,111108307,XM_022444095.1,5-aminolevulinate synthase,18403
NC_035787.1,64362893,64386662,64362893,64386662,111108307,XM_022444098.1,5-aminolevulinate synthase,23769
NC_035783.1,44710731,44740012,44710731,44740012,111128337,XM_022473910.1,C-1-tetrahydrofolate synthase,29281
NC_035784.1,24519066,24522269,24519066,24522269,111133858,XM_022482564.1,3-oxoacyl-[acyl-carrier-protein] synthase,3203
NC_035782.1,66790064,66793702,66790064,66793702,111124389,XM_022467240.1,folylpolyglutamate synthase,3638
NC_035788.1,48256623,48267042,48256623,48263062,111111213,XM_022448039.1,citrate synthase,6439
NC_035782.1,60645080,60652037,60645080,60652037,111125202,XM_022468744.1,lipoyl synthase,6957
NC_035787.1,64325516,64333978,64325518,64333977,111108232,XM_022443980.1,5-aminolevulinate synthase,8459
NC_035787.1,64325516,64333978,64325516,64333978,111108232,XM_022443979.1,5-aminolevulinate synthase,8462
NC_035782.1,66972324,66981945,66972326,66981945,111123976,XM_022466759.1,folylpolyglutamate synthase,9619
NC_035782.1,66972324,66981945,66972324,66981945,111123976,XM_022466757.1,folylpolyglutamate synthase,9621
NC_035780.1,22257717,22269458,22257717,22269458,111124236,XM_022467095.1,acetolactate synthase-like protein,11741
NC_035780.1,46772050,46782096,46772050,46782096,111113301,XM_022451505.1,FAD synthase-like,10046
NC_035787.1,66686448,66696517,66686448,66696517,111105937,XM_022440438.1,spermine synthase-like,10069
NC_035784.1,96689985,96700070,96689985,96700070,111132779,XM_022480596.1,delta-1-pyrroline-5-carboxylate synthase-like,10085
NC_035787.1,65378512,65389785,65378512,65388598,111108222,XM_022443959.1,spermine synthase-like,10086
NC_035780.1,43254718,43265362,43254718,43265362,111119670,XM_022460084.1,FAD synthase-like,10644
NC_035787.1,65378512,65389785,65378512,65389785,111108222,XM_022443960.1,spermine synthase-like,11273
NC_035784.1,52449141,52460551,52449141,52460551,111132445,XM_022480253.1,delta-1-pyrroline-5-carboxylate synthase-like,11410
NC_035782.1,22558708,22571865,22558708,22571865,111124120,XM_022466983.1,phosphoribosylformylglycinamidine synthase-like,13157
NC_035784.1,96610071,96625281,96611399,96625281,111136221,XM_022486923.1,delta-1-pyrroline-5-carboxylate synthase-like,13882
NC_035783.1,44787005,44801311,44787005,44801311,111130865,XM_022478124.1,methionine synthase-like,14306
NC_035787.1,66757325,66772524,66757325,66772524,111105933,XM_022440434.1,spermine synthase-like,15199
NC_035784.1,96610071,96625281,96610076,96625281,111136221,XM_022486922.1,delta-1-pyrroline-5-carboxylate synthase-like,15205
NC_035784.1,96610071,96625281,96610075,96625281,111136221,XM_022486926.1,delta-1-pyrroline-5-carboxylate synthase-like,15206
NC_035784.1,96610071,96625281,96610071,96625281,111136221,XM_022486921.1,delta-1-pyrroline-5-carboxylate synthase-like,15210
NC_035781.1,51510574,51529312,51510574,51529312,111121023,XM_022462113.1,S-adenosylmethionine synthase-like,18738
NC_035782.1,62633535,62656869,62633535,62656869,111124359,XM_022467209.1,malate synthase-like,23334
NC_035784.1,90921279,90948496,90921279,90948496,111135676,XM_022485945.1,uroporphyrinogen-III synthase-like,27217
NC_035787.1,66775160,66806223,66775160,66806223,111105934,XM_022440435.1,spermine synthase-like,31063
NC_035781.1,51698357,51702465,51698357,51702465,111121024,XM_022462114.1,S-adenosylmethionine synthase-like,4108
NC_035781.1,51510574,51529312,51525186,51529312,111121023,XM_022462112.1,S-adenosylmethionine synthase-like,4126
NC_035786.1,38638177,38679437,38638177,38679437,111103886,XM_022437468.1,ATP-citrate synthase-like,41260
NC_035785.1,4275133,4280539,4275133,4280539,111099454,XM_022430734.1,GDP-L-fucose synthase-like,5406
NC_035786.1,40132464,40140293,40134099,40140293,111104244,XM_022438086.1,thymidylate synthase-like,6194
NC_035787.1,50984272,50992369,50984272,50990967,111105882,XM_022440341.1,argininosuccinate synthase-like,6695
NC_035787.1,65450159,65456976,65450159,65456976,111109303,XM_022445383.1,spermine synthase-like,6817
NC_035786.1,40132464,40140293,40132464,40140293,111104244,XM_022438087.1,thymidylate synthase-like,7829
NC_035787.1,50984272,50992369,50984273,50992105,111105882,XM_022440340.1,argininosuccinate synthase-like,7832
NC_035787.1,50984272,50992369,50984273,50992368,111105882,XM_022440337.1,argininosuccinate synthase-like,8095
NC_035787.1,50984272,50992369,50984273,50992369,111105882,XM_022440338.1,argininosuccinate synthase-like,8096
NC_035785.1,5033769,5041919,5033769,5041919,111099690,XM_022431088.1,GDP-L-fucose synthase-like,8150
NC_035787.1,66686448,66696517,66686448,66694833,111105937,XM_022440437.1,spermine synthase-like,8385
NC_035787.1,66686448,66696517,66686448,66694837,111105937,XM_022440441.1,spermine synthase-like,8389
NC_035787.1,65461991,65471518,65461991,65470508,111110622,XM_022447195.1,spermine synthase-like,8517
NC_035781.1,35499163,35508108,35499163,35508108,111120522,XM_022461301.1,trimethylguanosine synthase-like,8945
NC_035784.1,4138193,4147638,4138193,4147638,111136821,XM_022487945.1,spermidine synthase-like,9445
NC_035784.1,38179362,38188831,38179362,38188831,111137622,XM_022489161.1,spermidine synthase-like,9469
NC_035787.1,66686448,66696517,66686448,66695972,111105937,XM_022440439.1,spermine synthase-like,9524
NC_035787.1,65461991,65471518,65461991,65471518,111110622,XM_022447193.1,spermine synthase-like,9527
NC_035787.1,65378512,65389785,65378512,65388262,111108222,XM_022443961.1,spermine synthase-like,9750
NC_035787.1,65378512,65389785,65378512,65388421,111108222,XM_022443958.1,spermine synthase-like,9909
NC_035784.1,96812989,96822947,96812989,96822947,111132780,XM_022480597.1,delta-1-pyrroline-5-carboxylate synthase-like,9958
NC_035781.1,14799608,14805148,14799608,14805148,111119916,XM_022460494.1,sphingomyelin synthase-related protein 1-like,5540
NC_035783.1,49316029,49335937,49316029,49335937,111129324,XM_022475621.1,phthiocerol/phenolphthiocerol synthesis polyketide synthase type I PpsB-like,19908
NC_035781.1,42352595,42356475,42352595,42356475,111120304,XM_022461033.1,ribosomally synthesized cyclic peptide ustiloxin B precursosr-like,3880
NC_035780.1,2743875,2762522,2743875,2762522,111100566,XM_022432572.1,acyl-CoA synthetase short-chain family member 3,18647
NC_035784.1,45484372,45496433,45484372,45496433,111138068,XM_022489864.1,glutathione synthetase-like,12061
NC_035786.1,5840681,5854158,5840681,5854158,111104822,XM_022438963.1,glutamine synthetase-like,13477
NC_035783.1,40100334,40118485,40100334,40118485,111130166,XM_022476918.1,adenylosuccinate synthetase-like,18151
NC_035783.1,41620258,41638508,41620258,41638508,111130741,XM_022477959.1,adenylosuccinate synthetase-like,18250
NC_035787.1,9351112,9371148,9351139,9371148,111109449,XM_022445559.1,acetoacetyl-CoA synthetase-like,20009
NC_035787.1,9351112,9371148,9351112,9371148,111109449,XM_022445561.1,acetoacetyl-CoA synthetase-like,20036
NC_035784.1,28798317,28803605,28801040,28803605,111134252,XM_022483141.1,glutamine synthetase-like,2565
NC_035786.1,3848683,3853641,3848683,3853641,111102529,XM_022435321.1,glutamine synthetase-like,4958
NC_035784.1,28798317,28803605,28798317,28803604,111134252,XM_022483140.1,glutamine synthetase-like,5287
NC_035782.1,30568345,30573820,30568345,30573820,111126492,XM_022471177.1,glutamine synthetase-like,5475
NC_035782.1,30768009,30773499,30768009,30773499,111123929,XM_022466657.1,glutamine synthetase-like,5490
NC_035787.1,11678614,11688134,11679016,11688134,111106209,XM_022440778.1,acetoacetyl-CoA synthetase-like,9118
NC_035787.1,11678614,11688134,11678614,11688114,111106209,XM_022440779.1,acetoacetyl-CoA synthetase-like,9500
NC_035783.1,44880355,44890186,44880355,44890186,111131561,XM_022479157.1,visual system homeobox 2-like,9831
NC_035783.1,1681530,1699227,1681530,1699227,111130062,XM_022476740.1,limbic system-associated membrane protein-like,17697
NC_035780.1,30144543,30146964,30144543,30146964,111128345,XM_022473923.1,S-adenosyl-L-methionine-dependent tRNA 4-demethylwyosine synthase-like,2421
NC_035785.1,33950233,33961185,33950235,33961185,111102241,XM_022434902.1,probable tRNA(His) guanylyltransferase,10950
NC_035782.1,52847584,52856639,52847584,52856639,111125966,XM_022470279.1,queuine tRNA-ribosyltransferase accessory subunit 2-like,9055
NC_035787.1,60434559,60443327,60434559,60443327,111108698,XM_022444732.1,mitochondrial tRNA-specific 2-thiouridylase 1-like,8768
NC_035788.1,19974976,19983439,19974976,19983439,111114486,XM_022452804.1,chromatin target of PRMT1 protein-like,8463
NC_035780.1,24543719,24556232,24543719,24556232,111120493,XM_022461237.1,speckle targeted PIP5K1A-regulated poly(A) polymerase-like,12513
NC_035784.1,5610675,5619863,5610675,5619863,111135419,XM_022485468.1,peroxisomal targeting signal 1 receptor-like,9188
NC_035780.1,28547319,28551154,28547319,28551154,111127822,XM_022473095.1,PIN2/TERF1-interacting telomerase inhibitor 1-like,3835
NC_035781.1,30690118,30693833,30690118,30693833,111120897,XM_022461917.1,deoxynucleotidyltransferase terminal-interacting protein 2-like,3715
NC_035780.1,38039364,38049440,38039364,38049440,111117033,XM_022456099.1,transcription termination factor 3,10076
NC_035783.1,10966475,10969206,10966475,10969206,111131580,XM_022479181.1,T-complex-associated testis-expressed protein 1-like,2731
NC_035783.1,39842875,39852363,39842875,39852363,111130403,XM_022477454.1,6-pyruvoyl tetrahydrobiopterin synthase-like,9488
NC_035780.1,38156977,38175841,38156977,38175841,111115549,XM_022454338.1,putative thiamine transporter SLC35F3,18864
NC_035780.1,46820519,46825866,46820519,46825866,111114559,XM_022452925.1,ubiquitin thioesterase otulin-like,5347
NC_035788.1,57796276,57805328,57796276,57805328,111115744,XM_022454586.1,3-ketoacyl-CoA thiolase A,9052
NC_035780.1,54196238,54201161,54196238,54201161,111127947,XM_022473280.1,3-ketoacyl-CoA thiolase,4923
NC_035781.1,16541252,16542690,16541252,16542690,111119129,XM_022458985.1,probable thiopurine S-methyltransferase,1438
NC_035780.1,31387152,31409327,31387152,31409327,111127150,XM_022472212.1,uncharacterized threonine-rich GPI-anchored glycoprotein PJ4664.02-like,22175
NC_035781.1,24413226,24416278,24413226,24416278,111119578,XM_022459872.1,protein tilB homolog,3052
NC_035780.1,57313370,57338228,57313370,57338228,111135160,XM_022484960.1,protein timeless homolog,24858
NC_035785.1,32529826,32565231,32529826,32549199,111100380,XM_022432172.1,protein timeless-like,19373
NC_035785.1,32529826,32565231,32529826,32554007,111100380,XM_022432169.1,protein timeless-like,24181
NC_035785.1,32529826,32565231,32532443,32565231,111100380,XM_022432171.1,protein timeless-like,32788
NC_035785.1,32529826,32565231,32529827,32565226,111100380,XM_022432170.1,protein timeless-like,35399
NC_035785.1,32529826,32565231,32529826,32565228,111100380,XM_022432168.1,protein timeless-like,35402
NC_035784.1,50099365,50138241,50099365,50127245,111134394,XM_022483359.1,protein tiptop-like,27880
NC_035784.1,50099365,50138241,50099365,50138108,111134394,XM_022483360.1,protein tiptop-like,38743
NC_035784.1,50099365,50138241,50099365,50138241,111134394,XM_022483357.1,protein tiptop-like,38876
NC_035784.1,50099365,50138241,50099365,50105841,111134394,XM_022483356.1,protein tiptop-like,6476
NC_035784.1,50099365,50138241,50099365,50106128,111134394,XM_022483361.1,protein tiptop-like,6763
NC_035784.1,50099365,50138241,50099365,50106817,111134394,XM_022483358.1,protein tiptop-like,7452
NC_035784.1,50099365,50138241,50099365,50109112,111134394,XM_022483362.1,protein tiptop-like,9747
NC_035782.1,73082298,73094803,73082298,73094803,111126681,XM_022471489.1,connective tissue growth factor-like,12505
NC_035780.1,48196674,48200654,48196674,48200654,111112042,XM_022449345.1,resistance to inhibitors of cholinesterase protein 3-like,3980
NC_035784.1,42653928,42661076,42653928,42661076,111138064,XM_022489855.1,metal tolerance protein 9-like,7148
NC_035784.1,90209401,90211736,90209401,90211736,111136269,XM_022487010.1,protein toll-like,2335
NC_035782.1,56357196,56359540,56357196,56359540,111126630,XM_022471404.1,protein toll-like,2344
NC_035782.1,57397878,57400224,57397878,57400224,111125874,XM_022470081.1,protein toll-like,2346
NC_035784.1,2611223,2613628,2611223,2613628,111136174,XM_022486825.1,protein toll-like,2405
NC_035783.1,17740178,17742664,17740178,17742664,111130329,XM_022477241.1,protein toll-like,2486
NC_035784.1,90226499,90229089,90226499,90229089,111136268,XM_022487009.1,protein toll-like,2590
NC_035783.1,16227694,16244878,16227694,16230406,111129086,XM_022475173.1,protein toll-like,2712
NC_035782.1,68567183,68570788,68567183,68570788,111123823,XM_022466439.1,protein toll-like,3605
NC_035784.1,90263653,90269897,90263653,90269182,111136267,XM_022487008.1,protein toll-like,5529
NC_035784.1,90238050,90244967,90238050,90243783,111136266,XM_022487005.1,protein toll-like,5733
NC_035784.1,90263653,90269897,90263653,90269897,111136267,XM_022487007.1,protein toll-like,6244
NC_035784.1,90238050,90244967,90238050,90244967,111136266,XM_022487004.1,protein toll-like,6917
NC_035780.1,32697475,32718987,32697475,32718987,111133500,XM_022481965.1,DNA topoisomerase 2-binding protein 1-like,21512
NC_035783.1,29124442,29160869,29140004,29160869,111129369,XM_022475714.1,protein trachealess-like,20865
NC_035783.1,29697413,29736153,29713880,29736153,111130750,XM_022477974.1,protein trachealess-like,22273
NC_035783.1,29697413,29736153,29712922,29736153,111130750,XM_022477976.1,protein trachealess-like,23231
NC_035783.1,29124442,29160869,29132298,29160869,111129369,XM_022475716.1,protein trachealess-like,28571
NC_035783.1,29697413,29736153,29706434,29736153,111130750,XM_022477977.1,protein trachealess-like,29719
NC_035783.1,29124442,29160869,29124442,29160869,111129369,XM_022475715.1,protein trachealess-like,36427
NC_035783.1,29697413,29736153,29697413,29736153,111130750,XM_022477975.1,protein trachealess-like,38740
NC_035781.1,16211102,16236288,16211102,16236288,111118367,XM_022457777.1,polypyrimidine tract-binding protein 1-like,25186
NC_035780.1,10731656,10738621,10731656,10738621,111131135,XM_022478518.1,peroxisomal trans-2-enoyl-CoA reductase-like,6965
NC_035784.1,57162759,57168910,57162759,57168910,111099115,XM_022430483.1,GPI transamidase component PIG-T-like,6151
NC_035782.1,5592613,5598154,5592613,5598154,111125613,XM_022469590.1,GPI-anchor transamidase-like,5541
NC_035782.1,2124191,2130272,2124191,2130272,111123351,XM_022465632.1,GPI-anchor transamidase-like,6081
NC_035780.1,39980063,40000107,39980063,40000107,111119804,XM_022460307.1,kynurenine--oxoglutarate transaminase 3-like,20044
NC_035783.1,36703696,36737143,36703696,36737143,111131085,XM_022478433.1,2-aminoethylphosphonate--pyruvate transaminase-like,33447
NC_035780.1,17967464,17970536,17967464,17970536,111116812,XM_022455834.1,oncoprotein-induced transcript 3 protein-like,3072
NC_035780.1,10467394,10475230,10467394,10475230,111122680,XM_022464551.1,nuclear transcription factor Y subunit A-1-like,7836
NC_035782.1,20475220,20480808,20475220,20480808,111126950,XM_022471903.1,probable transcription-associated protein 1,5588
NC_035781.1,1589181,1592009,1589181,1592009,111119363,XM_022459452.1,DNA-binding transcriptional regulator BolA-like,2828
NC_035780.1,48330714,48380767,48330714,48380767,111128718,XM_022474529.1,signal transducer and activator of transcription 5B-like,50053
NC_035780.1,30695012,30703287,30695012,30703287,111133388,XM_022481745.1,signal transducing adapter molecule 2-like,8275
NC_035780.1,29795707,29806339,29795707,29806339,111102815,XM_022435697.1,alpha-tocopherol transfer protein-like,10632
NC_035781.1,10128699,10137868,10128699,10137868,111120960,XM_022462024.1,UDP-N-acetylglucosamine transferase subunit ALG14 homolog,9169
NC_035780.1,56189078,56201430,56189078,56201430,111134424,XM_022483426.1,hydroxyacid-oxoacid transhydrogenase,12352
NC_035780.1,43023506,43032422,43023506,43032422,111133136,XM_022481239.1,NAD(P) transhydrogenase,8916
NC_035781.1,38393448,38433868,38393448,38433868,111122008,XM_022463524.1,short transient receptor potential channel 3-like,40420
NC_035780.1,297131,311654,297131,311654,111101262,XM_022433705.1,eukaryotic translation initiation factor 4 gamma 2-like,14523
NC_035780.1,16422877,16439122,16422877,16439122,111119734,XM_022460189.1,ETS translocation variant 1-like,16245
NC_035787.1,63512737,63520189,63512737,63520189,111107356,XM_022442529.1,UDP-galactose translocator-like,7452
NC_035780.1,4790897,4793704,4790897,4793704,111121657,XM_022463024.1,proline-rich transmembrane protein 1-like,2807
NC_035781.1,35400362,35414247,35400362,35414247,111118262,XM_022457632.1,chromosome transmission fidelity protein 18 homolog,13885
NC_035780.1,5797011,5805118,5797011,5805118,111103418,XM_022436699.1,vesicle transport protein GOT1B-like,8107
NC_035780.1,2478727,2492972,2478727,2492972,111131752,XM_022479428.1,zinc transporter 1-like,14245
NC_035781.1,30013268,30023815,30013268,30023815,111119334,XM_022459404.1,choline transporter-like protein 1,10547
NC_035787.1,63520391,63533367,63520391,63533367,111107351,XM_022442524.1,UDP-N-acetylglucosamine transporter-like,12976
NC_035787.1,57599896,57617153,57600160,57617153,111109429,XM_022445531.1,molybdate-anion transporter-like,16993
NC_035787.1,57599896,57617153,57599896,57617153,111109429,XM_022445530.1,molybdate-anion transporter-like,17257
NC_035780.1,43168826,43171243,43168826,43171243,111107594,XM_022442866.1,sulfate transporter-like,2417
NC_035780.1,7537699,7540588,7537699,7540479,111129292,XM_022475703.1,molybdate-anion transporter-like,2780
NC_035780.1,7537699,7540588,7537699,7540588,111129292,XM_022475616.1,molybdate-anion transporter-like,2889
NC_035780.1,51512981,51516815,51512981,51516815,111113939,XM_022452235.1,sulfate transporter-like,3834
NC_035787.1,63520391,63533367,63527680,63533367,111107351,XM_022442525.1,UDP-N-acetylglucosamine transporter-like,5687
NC_035780.1,51796366,51802642,51796366,51802642,111137243,XM_022488627.1,sulfate transporter-like,6276
NC_035780.1,16098899,16101404,16098899,16101404,111100177,XM_022431831.1,piggyBac transposable element-derived protein 4-like,2505
NC_035780.1,63197128,63198120,63197128,63198120,111108487,XM_022444416.1,protein trapped in endoderm-1-like,992
NC_035781.1,49034521,49041695,49034521,49041695,111122128,XM_022463712.1,U4/U6.U5 tri-snRNP-associated protein 2-like,7174
NC_035781.1,471712,477224,471712,477224,111118134,XM_022457451.1,pancreatic triacylglycerol lipase-like,5512
NC_035781.1,41646976,41662942,41646976,41662942,111119139,XM_022458995.1,histidine triad nucleotide-binding protein 3-like,15966
NC_035781.1,2310561,2318167,2310561,2318167,111119707,XM_022460136.1,microsomal triglyceride transfer protein large subunit-like,7606
NC_035781.1,38726883,38733801,38726883,38733801,111118714,XM_022458299.1,inosine triphosphate pyrophosphatase-like,6918
NC_035782.1,63576135,63586744,63576135,63586744,111123620,XM_022466075.1,periodic tryptophan protein 2 homolog,10609
NC_035780.1,30130366,30143563,30130366,30143563,111128351,XM_022473935.1,probable tubulin polyglutamylase TTLL1,13197
NC_035780.1,29848237,29850651,29848237,29850651,111099109,XM_022430482.1,lipopolysaccharide-induced tumor necrosis factor-alpha factor homolog,2414
NC_035782.1,36363309,36379685,36363309,36379685,111127075,XM_022472081.1,protein tumorous imaginal discs,16376
NC_035780.1,45048967,45055649,45048967,45055649,111118739,XM_022458349.1,mRNA turnover protein 4 homolog,6682
NC_035782.1,59555347,59598272,59555347,59598272,111124168,XM_022467031.1,protein turtle-like,42925
NC_035781.1,52850063,52862446,52850063,52862446,111122177,XM_022463796.1,protein tweety homolog 1-like,12383
NC_035781.1,35457497,35478382,35457497,35478382,111121346,XM_022462580.1,gastrin/cholecystokinin type B receptor-like,20885
NC_035780.1,57150012,57191331,57150012,57191331,111137053,XM_022488291.1,thrombospondin type-1 domain-containing protein 7B-like,41319
NC_035784.1,30822212,30866544,30822212,30866544,111134043,XM_022482820.1,ephrin type-B receptor 1-B-like,44332
NC_035784.1,68846840,68892245,68846840,68892245,111132865,XM_022480770.1,fibronectin type-III domain-containing protein 3A-like,45405
NC_035782.1,40652480,40654147,40652480,40654147,111126077,XM_022470472.1,putative tyramine receptor 2,1667
NC_035784.1,12690399,12692568,12690399,12692568,111134567,XM_022483697.1,putative tyrosinase-like protein tyr-3,2169
NC_035780.1,42030972,42068836,42030972,42068836,111125773,XM_022469896.1,protein tyrosine phosphatase type IVA 2-like,37864
NC_035781.1,1905257,1921018,1905257,1921018,111121708,XM_022463080.1,receptor-type tyrosine-protein phosphatase kappa-like,15761
NC_035780.1,28500480,28505602,28500480,28505602,111136729,XM_022487818.1,proteasomal ubiquitin receptor ADRM1-B-like,5122
NC_035784.1,12977206,12986738,12977206,12986738,111135319,XM_022485269.1,probable ubiquitin-conjugating enzyme E2 7,9532
NC_035780.1,4035331,4046467,4035331,4046467,111132898,XM_022480830.1,E3 ubiquitin-protein ligase SIAH1-like,11136
NC_035782.1,60215692,60229587,60215692,60229587,111125573,XM_022469527.1,small ubiquitin-related modifier 3-like,13895
NC_035787.1,44687242,44689588,44687242,44689588,111106821,XM_022441647.1,E3 ubiquitin/ISG15 ligase TRIM25-like,2346
NC_035785.1,32872234,32879828,32872234,32879828,111101400,XM_022433869.1,ancient ubiquitous protein 1-like,7594
NC_035782.1,60183237,60192977,60183237,60192977,111123102,XM_022465207.1,NEDD8 ultimate buster 1-like,9740
NC_035784.1,59855582,59863228,59855582,59863228,111136432,XM_022487279.1,protein unc-119 homolog B-like,7646
NC_035783.1,30681594,30779854,30681594,30779836,111131099,XM_022478450.1,protein unc-13 homolog A-like,98242
NC_035780.1,33429345,33442150,33429345,33442150,111125946,XM_022470233.1,protein unc-45 homolog B-like,12805
NC_035782.1,60714795,60719389,60714795,60719389,111124759,XM_022467928.1,protein unc-50 homolog,4594
NC_035783.1,8603502,8633451,8603502,8633451,111129873,XM_022476366.1,protein unc-79 homolog,29949
NC_035782.1,69889589,69920186,69889589,69920186,111123997,XM_022466826.1,protein unc-80 homolog,30597
NC_035782.1,70017602,70028611,70017602,70028611,111123954,XM_022466698.1,innexin unc-9-like,11009
NC_035782.1,32344129,32403226,32388013,32403226,111124985,XM_022468354.1,innexin unc-9-like,15213
NC_035782.1,67539105,67540931,67539105,67540931,111126442,XM_022471098.1,innexin unc-9-like,1826
NC_035782.1,67505133,67513205,67511022,67513205,111125629,XM_022469617.1,innexin unc-9-like,2183
NC_035782.1,32344129,32403226,32379875,32403226,111124985,XM_022468358.1,innexin unc-9-like,23351
NC_035782.1,19390918,19394407,19390918,19393369,111123794,XM_022466365.1,innexin unc-9-like,2451
NC_035782.1,32344129,32403226,32378707,32403226,111124985,XM_022468353.1,innexin unc-9-like,24519
NC_035782.1,32344129,32403226,32376642,32403226,111124985,XM_022468360.1,innexin unc-9-like,26584
NC_035782.1,27461044,27464589,27461047,27463965,111126490,XM_022471173.1,innexin unc-9-like,2918
NC_035782.1,19390918,19394407,19390918,19394407,111123794,XM_022466366.1,innexin unc-9-like,3489
NC_035782.1,67505133,67513205,67509705,67513205,111125629,XM_022469616.1,innexin unc-9-like,3500
NC_035782.1,67500093,67503614,67500093,67503614,111125636,XM_022469632.1,innexin unc-9-like,3521
NC_035782.1,27461044,27464589,27461044,27464589,111126490,XM_022471174.1,innexin unc-9-like,3545
NC_035782.1,19386406,19390353,19386406,19390353,111125278,XM_022468884.1,innexin unc-9-like,3947
NC_035782.1,67505133,67513205,67509214,67513205,111125629,XM_022469613.1,innexin unc-9-like,3991
NC_035782.1,70017602,70028611,70023837,70028611,111123954,XM_022466696.1,innexin unc-9-like,4774
NC_035782.1,67533218,67538043,67533218,67538043,111125145,XM_022468647.1,innexin unc-9-like,4825
NC_035782.1,8470468,8476502,8471537,8476502,111126549,XM_022471269.1,innexin unc-9-like,4965
NC_035782.1,32344129,32403226,32350947,32403226,111124985,XM_022468359.1,innexin unc-9-like,52279
NC_035782.1,32344129,32403226,32350946,32403226,111124985,XM_022468356.1,innexin unc-9-like,52280
NC_035782.1,8470468,8476502,8470896,8476502,111126549,XM_022471268.1,innexin unc-9-like,5606
NC_035782.1,8470468,8476502,8470893,8476502,111126549,XM_022471266.1,innexin unc-9-like,5609
NC_035782.1,32344129,32403226,32344129,32403226,111124985,XM_022468355.1,innexin unc-9-like,59097
NC_035782.1,8470468,8476502,8470468,8476502,111126549,XM_022471267.1,innexin unc-9-like,6034
NC_035782.1,6937762,6944168,6937762,6944168,111125561,XM_022469498.1,innexin unc-9-like,6406
NC_035782.1,67505133,67513205,67505134,67513205,111125629,XM_022469614.1,innexin unc-9-like,8071
NC_035782.1,67505133,67513205,67505133,67513205,111125629,XM_022469610.1,innexin unc-9-like,8072
NC_035782.1,71978462,71980982,71978462,71980982,111123595,XM_022466027.1,protein unc-93 homolog A-like,2520
NC_035780.1,190449,193594,190449,193594,111133554,XM_022482070.1,putative uncharacterized protein DDB_G0277407,3145
NC_035781.1,5143088,5153204,5143088,5153204,111122366,XM_022464114.1,mitochondrial uncoupling protein 4-like,10116
NC_035781.1,33660172,33679834,33660172,33679834,111118666,XM_022458232.1,calcium uniporter protein,19662
NC_035783.1,28639903,28642026,28639903,28642026,111129438,XM_022475823.1,putative universal stress protein SAS1637,2123
NC_035782.1,54927436,54938072,54927436,54938072,111125576,XM_022469531.1,hypoxia up-regulated protein 1-like,10636
NC_035782.1,26248676,26265100,26248676,26265100,111123127,XM_022465244.1,far upstream element-binding protein 1-like,16424
NC_035781.1,7486383,7500319,7486383,7500319,111119636,XM_022460017.1,calcium uptake protein 1,13936
NC_035782.1,63079543,63084823,63079543,63084823,111125509,XM_022469421.1,probable uridine nucleosidase 2,5280
NC_035781.1,16397729,16416449,16397729,16416449,111119159,XM_022459034.1,terminal uridylyltransferase 4-like,18720
NC_035783.1,19483567,19496960,19483567,19496960,111130500,XM_022477643.1,UTP--glucose-1-phosphate uridylyltransferase-like,13393
NC_035783.1,58047141,58052168,58047141,58051731,111128700,XM_022474482.1,galactose-1-phosphate uridylyltransferase-like,4590
NC_035783.1,58047141,58052168,58047141,58052168,111128700,XM_022474480.1,galactose-1-phosphate uridylyltransferase-like,5027
NC_035783.1,756150,763395,756150,763395,111128748,XM_022474576.1,galactose-1-phosphate uridylyltransferase-like,7245
NC_035783.1,19483567,19496960,19483567,19491389,111130500,XM_022477642.1,UTP--glucose-1-phosphate uridylyltransferase-like,7822
NC_035783.1,19483567,19496960,19483567,19493279,111130500,XM_022477641.1,UTP--glucose-1-phosphate uridylyltransferase-like,9712
NC_035784.1,67379263,67383707,67379263,67383707,111136098,XM_022486703.1,mannose-P-dolichol utilization defect 1 protein-like,4444
NC_035783.1,42383376,42404502,42383376,42404502,111130461,XM_022477550.1,nuclear valosin-containing protein-like,21126
NC_035784.1,2003282,2010848,2003282,2010848,111136296,XM_022487048.1,major vault protein-like,7566
NC_035780.1,16698505,16704434,16698505,16704434,111116013,XM_022454984.1,cysteine-rich venom protein LEI1-like,5929
NC_035784.1,73008880,73011654,73008880,73011654,111137274,XM_022488671.1,interferon-induced very large GTPase 1-like,2774
NC_035781.1,42262887,42268273,42262887,42268273,111118456,XM_022457948.1,probable very-long-chain enoyl-CoA reductase art-1,5386
NC_035780.1,15460840,15472694,15460840,15472694,111110943,XM_022447626.1,synaptic vesicle 2-related protein-like,11854
NC_035781.1,23174959,23188139,23174959,23188139,111121436,XM_022462725.1,general vesicular transport factor p115-like,13180
NC_035785.1,16554550,16565036,16554550,16565036,111101552,XM_022434089.1,blood vessel epicardial substance-like,10486
NC_035782.1,16553073,16596900,16553073,16596900,111124942,XM_022468278.1,ecotropic viral integration site 5 ortholog-like,43827
NC_035781.1,57755566,57779893,57755566,57779893,111121481,XM_022462781.1,superkiller viralicidic activity 2-like 2,24327
NC_035784.1,8530381,8547920,8530381,8547920,111138303,XM_022490182.1,protein virilizer homolog,17539
NC_035782.1,32812458,32821900,32812458,32821900,111126740,XM_022471575.1,influenza virus NS1A-binding protein homolog,9442
NC_035780.1,502147,508829,502147,508829,111112773,XM_022450550.1,potassium voltage-gated channel protein Shaw-like,6682
NC_035780.1,6841095,6849512,6841095,6849512,111132637,XM_022480466.1,cell wall protein DAN4-like,8417
NC_035788.1,13052740,13055046,13052740,13055046,111111650,XM_022448748.1,protein wech-like,2306
NC_035782.1,5038432,5040784,5038432,5040784,111124505,XM_022467420.1,protein wech-like,2352
NC_035782.1,5748099,5750632,5748099,5750632,111125602,XM_022469580.1,protein wech-like,2533
NC_035782.1,106783,109570,106783,109570,111125259,XM_022468853.1,protein wech-like,2787
NC_035782.1,3217170,3220174,3217170,3220174,111123166,XM_022465324.1,protein wech-like,3004
NC_035782.1,5030307,5033504,5030307,5033504,111124506,XM_022467421.1,protein wech-like,3197
NC_035788.1,71248723,71264447,71248723,71261876,111112791,XM_022450590.1,protein white-like,13153
NC_035788.1,83522742,83537225,83523878,83537225,111114692,XM_022453119.1,protein white-like,13347
NC_035788.1,81812789,81826776,81812789,81826776,111114786,XM_022453256.1,protein white-like,13987
NC_035788.1,83522742,83537225,83522742,83537225,111114692,XM_022453118.1,protein white-like,14483
NC_035788.1,71248723,71264447,71248723,71264447,111112791,XM_022450589.1,protein white-like,15724
NC_035788.1,71329022,71345141,71329022,71345141,111115947,XM_022454873.1,protein white-like,16119
NC_035788.1,71271225,71288070,71271225,71288065,111112790,XM_022450587.1,protein white-like,16840
NC_035788.1,71271225,71288070,71271225,71288067,111112790,XM_022450586.1,protein white-like,16842
NC_035788.1,71271225,71288070,71271225,71288070,111112790,XM_022450585.1,protein white-like,16845
NC_035788.1,71373555,71392784,71373555,71390730,111114779,XM_022453250.1,protein white-like,17175
NC_035788.1,71289319,71306771,71289319,71306771,111111181,XM_022448008.1,protein white-like,17452
NC_035788.1,71373555,71392784,71373555,71392784,111114779,XM_022453249.1,protein white-like,19229
NC_035788.1,71205825,71226371,71205825,71226371,111112809,XM_022450615.1,protein white-like,20546
NC_035780.1,2636102,2650036,2636102,2650036,111103238,XM_022436332.1,protocadherin-like wing polarity protein stan,13934
NC_035780.1,9834892,9841621,9834892,9841621,111122554,XM_022464347.1,cysteine-rich with EGF-like domain protein 1,6729
NC_035781.1,47760899,47772989,47760899,47772989,111120842,XM_022461838.1,protein wntless homolog,12090
NC_035788.1,65813734,65834110,65813734,65834110,111113446,XM_022451736.1,protein wos2-like,20376
NC_035780.1,15774578,15779402,15774578,15779402,111131527,XM_022479118.1,tRNA wybutosine-synthesizing protein 2 homolog,4824
NC_035780.1,40266431,40270740,40266431,40270740,111126792,XM_022471663.1,integrase/recombinase xerD homolog,4309
NC_035780.1,13224106,13235180,13224106,13235180,111117993,XM_022457257.1,LARGE xylosyl- and glucuronyltransferase 1-like,11074
NC_035782.1,31174283,31192828,31174283,31189650,111126356,XM_022470920.1,glycosaminoglycan xylosylkinase-like,15367
NC_035782.1,31174283,31192828,31174283,31189657,111126356,XM_022470919.1,glycosaminoglycan xylosylkinase-like,15374
NC_035782.1,31174283,31192828,31174283,31192828,111126356,XM_022470921.1,glycosaminoglycan xylosylkinase-like,18545
NC_035780.1,30666594,30670565,30666594,30670565,111119515,XM_022459728.1,glucoside xylosyltransferase 2-like,3971
NC_035783.1,12681002,12699465,12681002,12699465,111131031,XM_022478358.1,protein yippee-like 5,18463
NC_035782.1,26824140,26836609,26824140,26836609,111127376,XM_022472531.1,protein zer-1 homolog,12469
NC_035780.1,151859,157536,151859,157536,111128953,XM_022474931.1,GATA zinc finger domain-containing protein 14-like,5677
NC_035782.1,39032669,39035241,39032669,39035241,111126997,XM_022471964.1,leucine zipper protein 1-like,2572
NC_035781.1,31235192,31237431,31235192,31237431,111120716,XM_022461641.1,marginal zone B- and B1-cell-specific protein-like,2239
NC_035784.1,53615964,53629936,53615964,53629936,111137893,XM_022489592.1,ventricular zone-expressed PH domain-containing protein homolog 1-like,13972
NC_035782.1,47390761,47393907,47390761,47393907,111124911,XM_022468212.1,protein zwilch homolog,3146
NC_035781.1,39056833,39071036,39056833,39071036,111121423,XM_022462709.1,protein zyg-11 homolog B-like,14203
